,RdeltaB,Bpre,Bpost,itemideology,itemnum,partideology,ide_ms,ide_abs,partnum
0,0,100,100,1,0,0.0,1.0,100.0,0
1,0,81,81,1,1,0.0,1.0,100.0,0
2,15,31,46,2,2,0.0,1.0,100.0,0
3,32,12,44,2,3,0.0,1.0,100.0,0
4,8,49,57,3,4,0.0,1.0,100.0,0
5,52,5,57,3,5,0.0,1.0,100.0,0
6,33,50,83,3,6,0.0,1.0,100.0,0
7,4,50,54,3,7,0.0,1.0,100.0,0
8,14,75,89,1,0,0.0,1.0,100.0,1
9,28,72,100,1,1,0.0,1.0,100.0,1
10,65,23,88,2,2,0.0,1.0,100.0,1
11,43,50,93,2,3,0.0,1.0,100.0,1
12,31,66,97,3,4,0.0,1.0,100.0,1
13,27,50,77,3,5,0.0,1.0,100.0,1
14,20,80,100,3,6,0.0,1.0,100.0,1
15,51,24,75,3,7,0.0,1.0,100.0,1
16,18,82,100,1,0,0.0,1.0,100.0,2
17,23,77,100,1,1,0.0,1.0,100.0,2
18,100,0,100,2,2,0.0,1.0,100.0,2
19,100,0,100,2,3,0.0,1.0,100.0,2
20,79,21,100,3,4,0.0,1.0,100.0,2
21,77,23,100,3,5,0.0,1.0,100.0,2
22,66,34,100,3,6,0.0,1.0,100.0,2
23,64,36,100,3,7,0.0,1.0,100.0,2
24,0,0,0,1,0,0.0,1.0,100.0,3
25,0,0,0,1,1,0.0,1.0,100.0,3
26,0,0,0,2,2,0.0,1.0,100.0,3
27,0,0,0,2,3,0.0,1.0,100.0,3
28,-2,2,0,3,4,0.0,1.0,100.0,3
29,0,0,0,3,5,0.0,1.0,100.0,3
30,100,0,100,3,6,0.0,1.0,100.0,3
31,0,0,0,3,7,0.0,1.0,100.0,3
32,0,100,100,1,0,0.0,1.0,100.0,4
33,0,100,100,1,1,0.0,1.0,100.0,4
34,100,0,100,2,2,0.0,1.0,100.0,4
35,100,0,100,2,3,0.0,1.0,100.0,4
36,50,50,100,3,4,0.0,1.0,100.0,4
37,50,50,100,3,5,0.0,1.0,100.0,4
38,50,50,100,3,6,0.0,1.0,100.0,4
39,100,0,100,3,7,0.0,1.0,100.0,4
40,0,100,100,1,0,0.0,1.0,100.0,5
41,0,100,100,1,1,0.0,1.0,100.0,5
42,100,0,100,2,2,0.0,1.0,100.0,5
43,100,0,100,2,3,0.0,1.0,100.0,5
44,39,61,100,3,4,0.0,1.0,100.0,5
45,23,77,100,3,5,0.0,1.0,100.0,5
46,69,31,100,3,6,0.0,1.0,100.0,5
47,100,0,100,3,7,0.0,1.0,100.0,5
48,10,70,80,1,0,0.0,1.0,100.0,6
49,-21,97,76,1,1,0.0,1.0,100.0,6
50,41,0,41,2,2,0.0,1.0,100.0,6
51,53,8,61,2,3,0.0,1.0,100.0,6
52,17,47,64,3,4,0.0,1.0,100.0,6
53,8,53,61,3,5,0.0,1.0,100.0,6
54,18,82,100,3,6,0.0,1.0,100.0,6
55,66,0,66,3,7,0.0,1.0,100.0,6
56,20,80,100,1,0,0.0,1.0,100.0,7
57,24,76,100,1,1,0.0,1.0,100.0,7
58,75,0,75,2,2,0.0,1.0,100.0,7
59,25,0,25,2,3,0.0,1.0,100.0,7
60,76,0,76,3,4,0.0,1.0,100.0,7
61,50,0,50,3,5,0.0,1.0,100.0,7
62,0,100,100,3,6,0.0,1.0,100.0,7
63,24,1,25,3,7,0.0,1.0,100.0,7
64,5,74,79,1,0,0.0,1.0,100.0,8
65,50,0,50,1,1,0.0,1.0,100.0,8
66,-2,52,50,2,2,0.0,1.0,100.0,8
67,-51,100,49,2,3,0.0,1.0,100.0,8
68,-15,36,21,3,4,0.0,1.0,100.0,8
69,0,50,50,3,5,0.0,1.0,100.0,8
70,0,0,0,3,6,0.0,1.0,100.0,8
71,31,67,98,3,7,0.0,1.0,100.0,8
72,0,100,100,1,0,0.0,1.0,100.0,9
73,0,100,100,1,1,0.0,1.0,100.0,9
74,36,0,36,2,2,0.0,1.0,100.0,9
75,35,14,49,2,3,0.0,1.0,100.0,9
76,2,49,51,3,4,0.0,1.0,100.0,9
77,50,50,100,3,5,0.0,1.0,100.0,9
78,0,100,100,3,6,0.0,1.0,100.0,9
79,41,12,53,3,7,0.0,1.0,100.0,9
80,25,75,100,1,0,0.0,1.0,100.0,10
81,15,75,90,1,1,0.0,1.0,100.0,10
82,75,10,85,2,2,0.0,1.0,100.0,10
83,45,30,75,2,3,0.0,1.0,100.0,10
84,50,30,80,3,4,0.0,1.0,100.0,10
85,40,50,90,3,5,0.0,1.0,100.0,10
86,40,60,100,3,6,0.0,1.0,100.0,10
87,40,50,90,3,7,0.0,1.0,100.0,10
88,26,55,81,1,0,0.0,1.0,100.0,11
89,1,70,71,1,1,0.0,1.0,100.0,11
90,58,27,85,2,2,0.0,1.0,100.0,11
91,52,26,78,2,3,0.0,1.0,100.0,11
92,19,58,77,3,4,0.0,1.0,100.0,11
93,2,63,65,3,5,0.0,1.0,100.0,11
94,23,77,100,3,6,0.0,1.0,100.0,11
95,89,0,89,3,7,0.0,1.0,100.0,11
96,44,56,100,1,0,0.0,1.0,100.0,12
97,-70,70,0,1,1,0.0,1.0,100.0,12
98,62,0,62,2,2,0.0,1.0,100.0,12
99,100,0,100,2,3,0.0,1.0,100.0,12
100,85,15,100,3,4,0.0,1.0,100.0,12
101,97,1,98,3,5,0.0,1.0,100.0,12
102,64,36,100,3,6,0.0,1.0,100.0,12
103,100,0,100,3,7,0.0,1.0,100.0,12
104,24,76,100,1,0,0.0,1.0,100.0,13
105,0,100,100,1,1,0.0,1.0,100.0,13
106,73,0,73,2,2,0.0,1.0,100.0,13
107,2,0,2,2,3,0.0,1.0,100.0,13
108,50,50,100,3,4,0.0,1.0,100.0,13
109,87,0,87,3,5,0.0,1.0,100.0,13
110,10,90,100,3,6,0.0,1.0,100.0,13
111,80,0,80,3,7,0.0,1.0,100.0,13
112,-19,100,81,1,0,0.0,1.0,100.0,14
113,10,90,100,1,1,0.0,1.0,100.0,14
114,50,0,50,2,2,0.0,1.0,100.0,14
115,100,0,100,2,3,0.0,1.0,100.0,14
116,-82,88,6,3,4,0.0,1.0,100.0,14
117,90,10,100,3,5,0.0,1.0,100.0,14
118,11,89,100,3,6,0.0,1.0,100.0,14
119,100,0,100,3,7,0.0,1.0,100.0,14
120,5,95,100,1,0,0.0,1.0,100.0,15
121,0,100,100,1,1,0.0,1.0,100.0,15
122,-14,17,3,2,2,0.0,1.0,100.0,15
123,0,0,0,2,3,0.0,1.0,100.0,15
124,23,68,91,3,4,0.0,1.0,100.0,15
125,50,23,73,3,5,0.0,1.0,100.0,15
126,0,5,5,3,6,0.0,1.0,100.0,15
127,50,50,100,3,7,0.0,1.0,100.0,15
128,7,90,97,1,0,0.0,1.0,100.0,16
129,0,100,100,1,1,0.0,1.0,100.0,16
130,-9,12,3,2,2,0.0,1.0,100.0,16
131,-38,50,12,2,3,0.0,1.0,100.0,16
132,7,90,97,3,4,0.0,1.0,100.0,16
133,70,15,85,3,5,0.0,1.0,100.0,16
134,5,90,95,3,6,0.0,1.0,100.0,16
135,9,0,9,3,7,0.0,1.0,100.0,16
136,44,56,100,1,0,0.0,1.0,100.0,17
137,94,0,94,1,1,0.0,1.0,100.0,17
138,91,0,91,2,2,0.0,1.0,100.0,17
139,64,36,100,2,3,0.0,1.0,100.0,17
140,58,36,94,3,4,0.0,1.0,100.0,17
141,67,32,99,3,5,0.0,1.0,100.0,17
142,100,0,100,3,6,0.0,1.0,100.0,17
143,98,0,98,3,7,0.0,1.0,100.0,17
144,-11,100,89,1,0,0.0,1.0,100.0,18
145,-17,86,69,1,1,0.0,1.0,100.0,18
146,7,0,7,2,2,0.0,1.0,100.0,18
147,-18,35,17,2,3,0.0,1.0,100.0,18
148,16,58,74,3,4,0.0,1.0,100.0,18
149,15,10,25,3,5,0.0,1.0,100.0,18
150,9,30,39,3,6,0.0,1.0,100.0,18
151,7,55,62,3,7,0.0,1.0,100.0,18
152,-10,17,7,1,0,0.0,1.0,100.0,19
153,11,79,90,1,1,0.0,1.0,100.0,19
154,-2,79,77,2,2,0.0,1.0,100.0,19
155,-7,22,15,2,3,0.0,1.0,100.0,19
156,-17,18,1,3,4,0.0,1.0,100.0,19
157,14,79,93,3,5,0.0,1.0,100.0,19
158,-20,31,11,3,6,0.0,1.0,100.0,19
159,3,66,69,3,7,0.0,1.0,100.0,19
160,0,100,100,1,0,0.0,1.0,100.0,20
161,0,100,100,1,1,0.0,1.0,100.0,20
162,29,0,29,2,2,0.0,1.0,100.0,20
163,20,3,23,2,3,0.0,1.0,100.0,20
164,14,86,100,3,4,0.0,1.0,100.0,20
165,55,25,80,3,5,0.0,1.0,100.0,20
166,-1,41,40,3,6,0.0,1.0,100.0,20
167,41,0,41,3,7,0.0,1.0,100.0,20
168,5,95,100,1,0,0.0,1.0,100.0,21
169,0,100,100,1,1,0.0,1.0,100.0,21
170,6,0,6,2,2,0.0,1.0,100.0,21
171,-13,13,0,2,3,0.0,1.0,100.0,21
172,0,100,100,3,4,0.0,1.0,100.0,21
173,-2,55,53,3,5,0.0,1.0,100.0,21
174,0,100,100,3,6,0.0,1.0,100.0,21
175,2,62,64,3,7,0.0,1.0,100.0,21
176,-10,43,33,1,0,0.0,1.0,100.0,22
177,-29,33,4,1,1,0.0,1.0,100.0,22
178,-3,45,42,2,2,0.0,1.0,100.0,22
179,-6,42,36,2,3,0.0,1.0,100.0,22
180,-12,39,27,3,4,0.0,1.0,100.0,22
181,6,56,62,3,5,0.0,1.0,100.0,22
182,13,54,67,3,6,0.0,1.0,100.0,22
183,-9,47,38,3,7,0.0,1.0,100.0,22
184,0,100,100,1,0,0.0,1.0,100.0,23
185,0,100,100,1,1,0.0,1.0,100.0,23
186,50,0,50,2,2,0.0,1.0,100.0,23
187,0,100,100,2,3,0.0,1.0,100.0,23
188,12,78,90,3,4,0.0,1.0,100.0,23
189,66,0,66,3,5,0.0,1.0,100.0,23
190,24,76,100,3,6,0.0,1.0,100.0,23
191,90,10,100,3,7,0.0,1.0,100.0,23
192,10,90,100,1,0,0.0,1.0,100.0,24
193,0,100,100,1,1,0.0,1.0,100.0,24
194,86,14,100,2,2,0.0,1.0,100.0,24
195,77,7,84,2,3,0.0,1.0,100.0,24
196,27,73,100,3,4,0.0,1.0,100.0,24
197,54,46,100,3,5,0.0,1.0,100.0,24
198,6,94,100,3,6,0.0,1.0,100.0,24
199,80,13,93,3,7,0.0,1.0,100.0,24
200,0,100,100,1,0,0.0,1.0,100.0,25
201,-100,100,0,1,1,0.0,1.0,100.0,25
202,77,4,81,2,2,0.0,1.0,100.0,25
203,64,25,89,2,3,0.0,1.0,100.0,25
204,18,82,100,3,4,0.0,1.0,100.0,25
205,56,29,85,3,5,0.0,1.0,100.0,25
206,81,19,100,3,6,0.0,1.0,100.0,25
207,61,24,85,3,7,0.0,1.0,100.0,25
208,2,90,92,1,0,0.0,1.0,100.0,26
209,-2,96,94,1,1,0.0,1.0,100.0,26
210,-53,77,24,2,2,0.0,1.0,100.0,26
211,-6,82,76,2,3,0.0,1.0,100.0,26
212,-2,83,81,3,4,0.0,1.0,100.0,26
213,-1,21,20,3,5,0.0,1.0,100.0,26
214,58,21,79,3,6,0.0,1.0,100.0,26
215,3,72,75,3,7,0.0,1.0,100.0,26
216,14,69,83,1,0,0.0,1.0,100.0,27
217,14,86,100,1,1,0.0,1.0,100.0,27
218,16,0,16,2,2,0.0,1.0,100.0,27
219,22,9,31,2,3,0.0,1.0,100.0,27
220,9,48,57,3,4,0.0,1.0,100.0,27
221,30,28,58,3,5,0.0,1.0,100.0,27
222,7,70,77,3,6,0.0,1.0,100.0,27
223,16,73,89,3,7,0.0,1.0,100.0,27
224,0,100,100,1,0,0.0,1.0,100.0,28
225,0,100,100,1,1,0.0,1.0,100.0,28
226,75,0,75,2,2,0.0,1.0,100.0,28
227,75,0,75,2,3,0.0,1.0,100.0,28
228,61,39,100,3,4,0.0,1.0,100.0,28
229,76,24,100,3,5,0.0,1.0,100.0,28
230,100,0,100,3,6,0.0,1.0,100.0,28
231,30,70,100,3,7,0.0,1.0,100.0,28
232,0,50,50,1,0,0.0,1.0,100.0,29
233,0,50,50,1,1,0.0,1.0,100.0,29
234,0,50,50,2,2,0.0,1.0,100.0,29
235,0,50,50,2,3,0.0,1.0,100.0,29
236,0,50,50,3,4,0.0,1.0,100.0,29
237,0,50,50,3,5,0.0,1.0,100.0,29
238,0,50,50,3,6,0.0,1.0,100.0,29
239,0,50,50,3,7,0.0,1.0,100.0,29
240,0,100,100,1,0,0.0,1.0,100.0,30
241,0,100,100,1,1,0.0,1.0,100.0,30
242,100,0,100,2,2,0.0,1.0,100.0,30
243,25,75,100,2,3,0.0,1.0,100.0,30
244,25,75,100,3,4,0.0,1.0,100.0,30
245,99,1,100,3,5,0.0,1.0,100.0,30
246,45,55,100,3,6,0.0,1.0,100.0,30
247,100,0,100,3,7,0.0,1.0,100.0,30
248,-1,88,87,1,0,0.0,1.0,100.0,31
249,0,98,98,1,1,0.0,1.0,100.0,31
250,0,0,0,2,2,0.0,1.0,100.0,31
251,1,97,98,2,3,0.0,1.0,100.0,31
252,0,48,48,3,4,0.0,1.0,100.0,31
253,1,42,43,3,5,0.0,1.0,100.0,31
254,0,50,50,3,6,0.0,1.0,100.0,31
255,-13,13,0,3,7,0.0,1.0,100.0,31
256,0,100,100,1,0,0.0,1.0,100.0,32
257,0,100,100,1,1,0.0,1.0,100.0,32
258,100,0,100,2,2,0.0,1.0,100.0,32
259,100,0,100,2,3,0.0,1.0,100.0,32
260,17,83,100,3,4,0.0,1.0,100.0,32
261,100,0,100,3,5,0.0,1.0,100.0,32
262,50,50,100,3,6,0.0,1.0,100.0,32
263,96,0,96,3,7,0.0,1.0,100.0,32
264,7,90,97,1,0,0.0,1.0,100.0,33
265,0,100,100,1,1,0.0,1.0,100.0,33
266,62,12,74,2,2,0.0,1.0,100.0,33
267,47,37,84,2,3,0.0,1.0,100.0,33
268,47,37,84,3,4,0.0,1.0,100.0,33
269,62,12,74,3,5,0.0,1.0,100.0,33
270,44,56,100,3,6,0.0,1.0,100.0,33
271,38,46,84,3,7,0.0,1.0,100.0,33
272,-5,55,50,1,0,0.0,1.0,100.0,34
273,-48,63,15,1,1,0.0,1.0,100.0,34
274,18,55,73,2,2,0.0,1.0,100.0,34
275,4,39,43,2,3,0.0,1.0,100.0,34
276,-10,60,50,3,4,0.0,1.0,100.0,34
277,0,50,50,3,5,0.0,1.0,100.0,34
278,-6,55,49,3,6,0.0,1.0,100.0,34
279,-19,69,50,3,7,0.0,1.0,100.0,34
280,0,0,0,1,0,0.0,1.0,100.0,35
281,0,0,0,1,1,0.0,1.0,100.0,35
282,0,0,0,2,2,0.0,1.0,100.0,35
283,0,0,0,2,3,0.0,1.0,100.0,35
284,0,0,0,3,4,0.0,1.0,100.0,35
285,0,0,0,3,5,0.0,1.0,100.0,35
286,0,0,0,3,6,0.0,1.0,100.0,35
287,0,0,0,3,7,0.0,1.0,100.0,35
288,-1,100,99,1,0,0.0,1.0,100.0,36
289,2,70,72,1,1,0.0,1.0,100.0,36
290,-14,96,82,2,2,0.0,1.0,100.0,36
291,0,100,100,2,3,0.0,1.0,100.0,36
292,0,100,100,3,4,0.0,1.0,100.0,36
293,6,94,100,3,5,0.0,1.0,100.0,36
294,-8,97,89,3,6,0.0,1.0,100.0,36
295,40,31,71,3,7,0.0,1.0,100.0,36
296,51,49,100,1,0,0.0,1.0,100.0,37
297,100,0,100,1,1,0.0,1.0,100.0,37
298,100,0,100,2,2,0.0,1.0,100.0,37
299,48,52,100,2,3,0.0,1.0,100.0,37
300,43,57,100,3,4,0.0,1.0,100.0,37
301,100,0,100,3,5,0.0,1.0,100.0,37
302,37,63,100,3,6,0.0,1.0,100.0,37
303,70,30,100,3,7,0.0,1.0,100.0,37
304,0,100,100,1,0,0.0,1.0,100.0,38
305,0,100,100,1,1,0.0,1.0,100.0,38
306,0,0,0,2,2,0.0,1.0,100.0,38
307,0,0,0,2,3,0.0,1.0,100.0,38
308,0,50,50,3,4,0.0,1.0,100.0,38
309,0,100,100,3,5,0.0,1.0,100.0,38
310,0,0,0,3,6,0.0,1.0,100.0,38
311,0,100,100,3,7,0.0,1.0,100.0,38
312,0,0,0,1,0,0.0,1.0,100.0,39
313,-1,100,99,1,1,0.0,1.0,100.0,39
314,31,4,35,2,2,0.0,1.0,100.0,39
315,11,4,15,2,3,0.0,1.0,100.0,39
316,-1,36,35,3,4,0.0,1.0,100.0,39
317,98,2,100,3,5,0.0,1.0,100.0,39
318,56,24,80,3,6,0.0,1.0,100.0,39
319,-7,12,5,3,7,0.0,1.0,100.0,39
320,50,50,100,1,0,0.0,1.0,100.0,40
321,86,14,100,1,1,0.0,1.0,100.0,40
322,-26,29,3,2,2,0.0,1.0,100.0,40
323,11,89,100,2,3,0.0,1.0,100.0,40
324,15,85,100,3,4,0.0,1.0,100.0,40
325,75,25,100,3,5,0.0,1.0,100.0,40
326,57,43,100,3,6,0.0,1.0,100.0,40
327,94,6,100,3,7,0.0,1.0,100.0,40
328,-96,100,4,1,0,0.0,1.0,100.0,41
329,-23,100,77,1,1,0.0,1.0,100.0,41
330,-20,100,80,2,2,0.0,1.0,100.0,41
331,-2,100,98,2,3,0.0,1.0,100.0,41
332,-38,100,62,3,4,0.0,1.0,100.0,41
333,-97,100,3,3,5,0.0,1.0,100.0,41
334,0,100,100,3,6,0.0,1.0,100.0,41
335,-98,100,2,3,7,0.0,1.0,100.0,41
336,2,98,100,1,0,0.0,1.0,100.0,42
337,0,100,100,1,1,0.0,1.0,100.0,42
338,26,25,51,2,2,0.0,1.0,100.0,42
339,4,76,80,2,3,0.0,1.0,100.0,42
340,11,38,49,3,4,0.0,1.0,100.0,42
341,33,43,76,3,5,0.0,1.0,100.0,42
342,13,24,37,3,6,0.0,1.0,100.0,42
343,27,24,51,3,7,0.0,1.0,100.0,42
344,0,50,50,1,0,0.0,1.0,100.0,43
345,-26,50,24,1,1,0.0,1.0,100.0,43
346,-50,50,0,2,2,0.0,1.0,100.0,43
347,-38,38,0,2,3,0.0,1.0,100.0,43
348,0,50,50,3,4,0.0,1.0,100.0,43
349,14,36,50,3,5,0.0,1.0,100.0,43
350,0,50,50,3,6,0.0,1.0,100.0,43
351,50,0,50,3,7,0.0,1.0,100.0,43
352,46,54,100,1,0,0.0,1.0,100.0,44
353,0,100,100,1,1,0.0,1.0,100.0,44
354,-8,8,0,2,2,0.0,1.0,100.0,44
355,-39,39,0,2,3,0.0,1.0,100.0,44
356,16,20,36,3,4,0.0,1.0,100.0,44
357,62,38,100,3,5,0.0,1.0,100.0,44
358,77,23,100,3,6,0.0,1.0,100.0,44
359,-46,46,0,3,7,0.0,1.0,100.0,44
360,0,0,0,1,0,0.0,1.0,100.0,45
361,0,0,0,1,1,0.0,1.0,100.0,45
362,0,0,0,2,2,0.0,1.0,100.0,45
363,0,0,0,2,3,0.0,1.0,100.0,45
364,0,0,0,3,4,0.0,1.0,100.0,45
365,0,50,50,3,5,0.0,1.0,100.0,45
366,0,0,0,3,6,0.0,1.0,100.0,45
367,0,0,0,3,7,0.0,1.0,100.0,45
368,20,80,100,1,0,0.0,1.0,100.0,46
369,0,100,100,1,1,0.0,1.0,100.0,46
370,4,0,4,2,2,0.0,1.0,100.0,46
371,5,0,5,2,3,0.0,1.0,100.0,46
372,27,23,50,3,4,0.0,1.0,100.0,46
373,63,0,63,3,5,0.0,1.0,100.0,46
374,16,68,84,3,6,0.0,1.0,100.0,46
375,50,50,100,3,7,0.0,1.0,100.0,46
376,-1,1,0,1,0,0.0,1.0,100.0,47
377,0,0,0,1,1,0.0,1.0,100.0,47
378,0,0,0,2,2,0.0,1.0,100.0,47
379,0,0,0,2,3,0.0,1.0,100.0,47
380,0,0,0,3,4,0.0,1.0,100.0,47
381,1,0,1,3,5,0.0,1.0,100.0,47
382,0,0,0,3,6,0.0,1.0,100.0,47
383,-1,1,0,3,7,0.0,1.0,100.0,47
384,50,50,100,1,0,0.0,1.0,100.0,48
385,0,100,100,1,1,0.0,1.0,100.0,48
386,-48,50,2,2,2,0.0,1.0,100.0,48
387,-1,16,15,2,3,0.0,1.0,100.0,48
388,50,50,100,3,4,0.0,1.0,100.0,48
389,35,15,50,3,5,0.0,1.0,100.0,48
390,80,20,100,3,6,0.0,1.0,100.0,48
391,-18,18,0,3,7,0.0,1.0,100.0,48
392,0,100,100,1,0,0.0,1.0,100.0,49
393,0,100,100,1,1,0.0,1.0,100.0,49
394,16,34,50,2,2,0.0,1.0,100.0,49
395,88,12,100,2,3,0.0,1.0,100.0,49
396,28,72,100,3,4,0.0,1.0,100.0,49
397,70,30,100,3,5,0.0,1.0,100.0,49
398,0,100,100,3,6,0.0,1.0,100.0,49
399,100,0,100,3,7,0.0,1.0,100.0,49
400,0,100,100,1,0,0.0,1.0,100.0,50
401,0,100,100,1,1,0.0,1.0,100.0,50
402,100,0,100,2,2,0.0,1.0,100.0,50
403,97,3,100,2,3,0.0,1.0,100.0,50
404,10,90,100,3,4,0.0,1.0,100.0,50
405,100,0,100,3,5,0.0,1.0,100.0,50
406,99,1,100,3,6,0.0,1.0,100.0,50
407,75,25,100,3,7,0.0,1.0,100.0,50
408,25,75,100,1,0,0.0,1.0,100.0,51
409,0,100,100,1,1,0.0,1.0,100.0,51
410,87,13,100,2,2,0.0,1.0,100.0,51
411,100,0,100,2,3,0.0,1.0,100.0,51
412,51,49,100,3,4,0.0,1.0,100.0,51
413,100,0,100,3,5,0.0,1.0,100.0,51
414,19,81,100,3,6,0.0,1.0,100.0,51
415,100,0,100,3,7,0.0,1.0,100.0,51
416,20,50,70,1,0,0.0,1.0,100.0,52
417,0,85,85,1,1,0.0,1.0,100.0,52
418,50,0,50,2,2,0.0,1.0,100.0,52
419,0,85,85,2,3,0.0,1.0,100.0,52
420,5,45,50,3,4,0.0,1.0,100.0,52
421,20,50,70,3,5,0.0,1.0,100.0,52
422,0,100,100,3,6,0.0,1.0,100.0,52
423,50,0,50,3,7,0.0,1.0,100.0,52
424,26,74,100,1,0,0.0,1.0,100.0,53
425,18,82,100,1,1,0.0,1.0,100.0,53
426,73,0,73,2,2,0.0,1.0,100.0,53
427,60,8,68,2,3,0.0,1.0,100.0,53
428,42,37,79,3,4,0.0,1.0,100.0,53
429,45,21,66,3,5,0.0,1.0,100.0,53
430,8,92,100,3,6,0.0,1.0,100.0,53
431,61,15,76,3,7,0.0,1.0,100.0,53
432,0,100,100,1,0,0.0,1.0,100.0,54
433,0,0,0,1,1,0.0,1.0,100.0,54
434,0,0,0,2,2,0.0,1.0,100.0,54
435,0,100,100,2,3,0.0,1.0,100.0,54
436,0,100,100,3,4,0.0,1.0,100.0,54
437,0,100,100,3,5,0.0,1.0,100.0,54
438,0,0,0,3,6,0.0,1.0,100.0,54
439,0,0,0,3,7,0.0,1.0,100.0,54
440,0,100,100,1,0,0.0,1.0,100.0,55
441,0,100,100,1,1,0.0,1.0,100.0,55
442,68,0,68,2,2,0.0,1.0,100.0,55
443,62,0,62,2,3,0.0,1.0,100.0,55
444,47,49,96,3,4,0.0,1.0,100.0,55
445,31,54,85,3,5,0.0,1.0,100.0,55
446,90,10,100,3,6,0.0,1.0,100.0,55
447,73,0,73,3,7,0.0,1.0,100.0,55
448,0,100,100,1,0,0.0,1.0,100.0,56
449,4,96,100,1,1,0.0,1.0,100.0,56
450,-1,51,50,2,2,0.0,1.0,100.0,56
451,-44,44,0,2,3,0.0,1.0,100.0,56
452,-1,51,50,3,4,0.0,1.0,100.0,56
453,-21,21,0,3,5,0.0,1.0,100.0,56
454,50,50,100,3,6,0.0,1.0,100.0,56
455,-50,50,0,3,7,0.0,1.0,100.0,56
456,-33,100,67,1,0,0.0,1.0,100.0,57
457,0,100,100,1,1,0.0,1.0,100.0,57
458,26,0,26,2,2,0.0,1.0,100.0,57
459,19,0,19,2,3,0.0,1.0,100.0,57
460,30,40,70,3,4,0.0,1.0,100.0,57
461,-14,73,59,3,5,0.0,1.0,100.0,57
462,-9,92,83,3,6,0.0,1.0,100.0,57
463,-30,100,70,3,7,0.0,1.0,100.0,57
464,56,44,100,1,0,0.0,1.0,100.0,58
465,0,100,100,1,1,0.0,1.0,100.0,58
466,75,0,75,2,2,0.0,1.0,100.0,58
467,75,0,75,2,3,0.0,1.0,100.0,58
468,12,76,88,3,4,0.0,1.0,100.0,58
469,100,0,100,3,5,0.0,1.0,100.0,58
470,37,63,100,3,6,0.0,1.0,100.0,58
471,76,0,76,3,7,0.0,1.0,100.0,58
472,9,91,100,1,0,0.0,1.0,100.0,59
473,0,100,100,1,1,0.0,1.0,100.0,59
474,100,0,100,2,2,0.0,1.0,100.0,59
475,100,0,100,2,3,0.0,1.0,100.0,59
476,6,94,100,3,4,0.0,1.0,100.0,59
477,49,51,100,3,5,0.0,1.0,100.0,59
478,60,40,100,3,6,0.0,1.0,100.0,59
479,30,70,100,3,7,0.0,1.0,100.0,59
480,13,58,71,1,0,0.0,1.0,100.0,60
481,-1,50,49,1,1,0.0,1.0,100.0,60
482,5,50,55,2,2,0.0,1.0,100.0,60
483,0,50,50,2,3,0.0,1.0,100.0,60
484,-38,68,30,3,4,0.0,1.0,100.0,60
485,18,0,18,3,5,0.0,1.0,100.0,60
486,0,100,100,3,6,0.0,1.0,100.0,60
487,0,0,0,3,7,0.0,1.0,100.0,60
488,0,100,100,1,0,0.0,1.0,100.0,61
489,100,0,100,1,1,0.0,1.0,100.0,61
490,90,10,100,2,2,0.0,1.0,100.0,61
491,86,14,100,2,3,0.0,1.0,100.0,61
492,10,90,100,3,4,0.0,1.0,100.0,61
493,100,0,100,3,5,0.0,1.0,100.0,61
494,11,89,100,3,6,0.0,1.0,100.0,61
495,100,0,100,3,7,0.0,1.0,100.0,61
496,12,88,100,1,0,0.0,1.0,100.0,62
497,0,0,0,1,1,0.0,1.0,100.0,62
498,0,0,0,2,2,0.0,1.0,100.0,62
499,0,0,0,2,3,0.0,1.0,100.0,62
500,-1,76,75,3,4,0.0,1.0,100.0,62
501,-11,11,0,3,5,0.0,1.0,100.0,62
502,0,100,100,3,6,0.0,1.0,100.0,62
503,0,0,0,3,7,0.0,1.0,100.0,62
504,0,100,100,1,0,0.0,1.0,100.0,63
505,0,100,100,1,1,0.0,1.0,100.0,63
506,100,0,100,2,2,0.0,1.0,100.0,63
507,-50,50,0,2,3,0.0,1.0,100.0,63
508,25,75,100,3,4,0.0,1.0,100.0,63
509,100,0,100,3,5,0.0,1.0,100.0,63
510,75,25,100,3,6,0.0,1.0,100.0,63
511,100,0,100,3,7,0.0,1.0,100.0,63
512,7,92,99,1,0,0.0,1.0,100.0,64
513,0,0,0,1,1,0.0,1.0,100.0,64
514,99,0,99,2,2,0.0,1.0,100.0,64
515,-19,19,0,2,3,0.0,1.0,100.0,64
516,1,90,91,3,4,0.0,1.0,100.0,64
517,34,40,74,3,5,0.0,1.0,100.0,64
518,0,0,0,3,6,0.0,1.0,100.0,64
519,1,4,5,3,7,0.0,1.0,100.0,64
520,0,64,64,1,0,0.0,1.0,100.0,65
521,47,30,77,1,1,0.0,1.0,100.0,65
522,35,4,39,2,2,0.0,1.0,100.0,65
523,50,21,71,2,3,0.0,1.0,100.0,65
524,4,38,42,3,4,0.0,1.0,100.0,65
525,32,51,83,3,5,0.0,1.0,100.0,65
526,16,84,100,3,6,0.0,1.0,100.0,65
527,20,18,38,3,7,0.0,1.0,100.0,65
528,0,0,0,1,0,0.0,1.0,100.0,66
529,0,0,0,1,1,0.0,1.0,100.0,66
530,82,0,82,2,2,0.0,1.0,100.0,66
531,0,0,0,2,3,0.0,1.0,100.0,66
532,0,0,0,3,4,0.0,1.0,100.0,66
533,0,0,0,3,5,0.0,1.0,100.0,66
534,0,0,0,3,6,0.0,1.0,100.0,66
535,-24,24,0,3,7,0.0,1.0,100.0,66
536,-4,4,0,1,0,0.0,1.0,100.0,67
537,7,91,98,1,1,0.0,1.0,100.0,67
538,97,3,100,2,2,0.0,1.0,100.0,67
539,2,96,98,2,3,0.0,1.0,100.0,67
540,23,75,98,3,4,0.0,1.0,100.0,67
541,98,1,99,3,5,0.0,1.0,100.0,67
542,95,2,97,3,6,0.0,1.0,100.0,67
543,93,3,96,3,7,0.0,1.0,100.0,67
544,-24,43,19,1,0,0.0,1.0,100.0,68
545,-93,100,7,1,1,0.0,1.0,100.0,68
546,0,0,0,2,2,0.0,1.0,100.0,68
547,0,0,0,2,3,0.0,1.0,100.0,68
548,12,76,88,3,4,0.0,1.0,100.0,68
549,24,12,36,3,5,0.0,1.0,100.0,68
550,-2,67,65,3,6,0.0,1.0,100.0,68
551,67,16,83,3,7,0.0,1.0,100.0,68
552,20,45,65,1,0,0.0,1.0,100.0,69
553,20,75,95,1,1,0.0,1.0,100.0,69
554,5,35,40,2,2,0.0,1.0,100.0,69
555,20,25,45,2,3,0.0,1.0,100.0,69
556,-10,55,45,3,4,0.0,1.0,100.0,69
557,15,65,80,3,5,0.0,1.0,100.0,69
558,0,85,85,3,6,0.0,1.0,100.0,69
559,10,65,75,3,7,0.0,1.0,100.0,69
560,50,0,50,1,0,0.0,1.0,100.0,70
561,25,75,100,1,1,0.0,1.0,100.0,70
562,50,0,50,2,2,0.0,1.0,100.0,70
563,0,0,0,2,3,0.0,1.0,100.0,70
564,25,75,100,3,4,0.0,1.0,100.0,70
565,50,0,50,3,5,0.0,1.0,100.0,70
566,75,25,100,3,6,0.0,1.0,100.0,70
567,0,0,0,3,7,0.0,1.0,100.0,70
568,10,90,100,1,0,0.0,1.0,100.0,71
569,7,93,100,1,1,0.0,1.0,100.0,71
570,16,0,16,2,2,0.0,1.0,100.0,71
571,4,0,4,2,3,0.0,1.0,100.0,71
572,18,82,100,3,4,0.0,1.0,100.0,71
573,3,51,54,3,5,0.0,1.0,100.0,71
574,30,60,90,3,6,0.0,1.0,100.0,71
575,43,45,88,3,7,0.0,1.0,100.0,71
576,100,0,100,1,0,0.0,1.0,100.0,72
577,46,54,100,1,1,0.0,1.0,100.0,72
578,50,50,100,2,2,0.0,1.0,100.0,72
579,0,100,100,2,3,0.0,1.0,100.0,72
580,29,71,100,3,4,0.0,1.0,100.0,72
581,8,92,100,3,5,0.0,1.0,100.0,72
582,50,50,100,3,6,0.0,1.0,100.0,72
583,100,0,100,3,7,0.0,1.0,100.0,72
584,27,50,77,1,0,0.0,1.0,100.0,73
585,1,98,99,1,1,0.0,1.0,100.0,73
586,45,5,50,2,2,0.0,1.0,100.0,73
587,7,0,7,2,3,0.0,1.0,100.0,73
588,0,96,96,3,4,0.0,1.0,100.0,73
589,0,50,50,3,5,0.0,1.0,100.0,73
590,72,5,77,3,6,0.0,1.0,100.0,73
591,28,2,30,3,7,0.0,1.0,100.0,73
592,49,51,100,1,0,0.0,1.0,100.0,74
593,0,100,100,1,1,0.0,1.0,100.0,74
594,50,0,50,2,2,0.0,1.0,100.0,74
595,21,79,100,2,3,0.0,1.0,100.0,74
596,64,36,100,3,4,0.0,1.0,100.0,74
597,100,0,100,3,5,0.0,1.0,100.0,74
598,0,100,100,3,6,0.0,1.0,100.0,74
599,100,0,100,3,7,0.0,1.0,100.0,74
600,31,69,100,1,0,0.0,1.0,100.0,75
601,22,78,100,1,1,0.0,1.0,100.0,75
602,60,40,100,2,2,0.0,1.0,100.0,75
603,50,50,100,2,3,0.0,1.0,100.0,75
604,31,69,100,3,4,0.0,1.0,100.0,75
605,36,64,100,3,5,0.0,1.0,100.0,75
606,0,100,100,3,6,0.0,1.0,100.0,75
607,-50,50,0,3,7,0.0,1.0,100.0,75
608,11,57,68,1,0,0.0,1.0,100.0,76
609,0,100,100,1,1,0.0,1.0,100.0,76
610,100,0,100,2,2,0.0,1.0,100.0,76
611,82,0,82,2,3,0.0,1.0,100.0,76
612,44,31,75,3,4,0.0,1.0,100.0,76
613,100,0,100,3,5,0.0,1.0,100.0,76
614,44,0,44,3,6,0.0,1.0,100.0,76
615,100,0,100,3,7,0.0,1.0,100.0,76
616,0,0,0,1,0,0.0,1.0,100.0,77
617,0,100,100,1,1,0.0,1.0,100.0,77
618,0,0,0,2,2,0.0,1.0,100.0,77
619,0,0,0,2,3,0.0,1.0,100.0,77
620,0,0,0,3,4,0.0,1.0,100.0,77
621,0,0,0,3,5,0.0,1.0,100.0,77
622,0,100,100,3,6,0.0,1.0,100.0,77
623,0,0,0,3,7,0.0,1.0,100.0,77
624,0,100,100,1,0,0.0,1.0,100.0,78
625,95,4,99,1,1,0.0,1.0,100.0,78
626,1,99,100,2,2,0.0,1.0,100.0,78
627,17,83,100,2,3,0.0,1.0,100.0,78
628,82,18,100,3,4,0.0,1.0,100.0,78
629,23,77,100,3,5,0.0,1.0,100.0,78
630,0,100,100,3,6,0.0,1.0,100.0,78
631,90,10,100,3,7,0.0,1.0,100.0,78
632,100,0,100,1,0,0.0,1.0,100.0,79
633,0,100,100,1,1,0.0,1.0,100.0,79
634,82,0,82,2,2,0.0,1.0,100.0,79
635,100,0,100,2,3,0.0,1.0,100.0,79
636,23,77,100,3,4,0.0,1.0,100.0,79
637,100,0,100,3,5,0.0,1.0,100.0,79
638,100,0,100,3,6,0.0,1.0,100.0,79
639,100,0,100,3,7,0.0,1.0,100.0,79
640,72,6,78,1,0,0.0,1.0,100.0,80
641,8,87,95,1,1,0.0,1.0,100.0,80
642,29,12,41,2,2,0.0,1.0,100.0,80
643,38,5,43,2,3,0.0,1.0,100.0,80
644,20,63,83,3,4,0.0,1.0,100.0,80
645,54,22,76,3,5,0.0,1.0,100.0,80
646,-1,69,68,3,6,0.0,1.0,100.0,80
647,27,8,35,3,7,0.0,1.0,100.0,80
648,2,76,78,1,0,0.0,1.0,100.0,81
649,100,0,100,1,1,0.0,1.0,100.0,81
650,11,0,11,2,2,0.0,1.0,100.0,81
651,-10,35,25,2,3,0.0,1.0,100.0,81
652,4,73,77,3,4,0.0,1.0,100.0,81
653,-22,49,27,3,5,0.0,1.0,100.0,81
654,-6,8,2,3,6,0.0,1.0,100.0,81
655,4,50,54,3,7,0.0,1.0,100.0,81
656,100,0,100,1,0,0.0,1.0,100.0,82
657,90,0,90,1,1,0.0,1.0,100.0,82
658,93,0,93,2,2,0.0,1.0,100.0,82
659,50,50,100,2,3,0.0,1.0,100.0,82
660,90,0,90,3,4,0.0,1.0,100.0,82
661,50,50,100,3,5,0.0,1.0,100.0,82
662,62,38,100,3,6,0.0,1.0,100.0,82
663,100,0,100,3,7,0.0,1.0,100.0,82
664,15,70,85,1,0,0.0,1.0,100.0,83
665,77,9,86,1,1,0.0,1.0,100.0,83
666,7,77,84,2,2,0.0,1.0,100.0,83
667,-1,14,13,2,3,0.0,1.0,100.0,83
668,71,6,77,3,4,0.0,1.0,100.0,83
669,17,70,87,3,5,0.0,1.0,100.0,83
670,-63,72,9,3,6,0.0,1.0,100.0,83
671,-18,95,77,3,7,0.0,1.0,100.0,83
672,-15,100,85,1,0,0.0,1.0,100.0,84
673,-8,100,92,1,1,0.0,1.0,100.0,84
674,5,0,5,2,2,0.0,1.0,100.0,84
675,24,45,69,2,3,0.0,1.0,100.0,84
676,25,49,74,3,4,0.0,1.0,100.0,84
677,78,22,100,3,5,0.0,1.0,100.0,84
678,8,42,50,3,6,0.0,1.0,100.0,84
679,0,4,4,3,7,0.0,1.0,100.0,84
680,-34,99,65,1,0,0.0,1.0,100.0,85
681,0,100,100,1,1,0.0,1.0,100.0,85
682,14,50,64,2,2,0.0,1.0,100.0,85
683,2,51,53,2,3,0.0,1.0,100.0,85
684,12,34,46,3,4,0.0,1.0,100.0,85
685,76,9,85,3,5,0.0,1.0,100.0,85
686,-9,68,59,3,6,0.0,1.0,100.0,85
687,6,59,65,3,7,0.0,1.0,100.0,85
688,17,83,100,1,0,0.0,1.0,100.0,86
689,2,98,100,1,1,0.0,1.0,100.0,86
690,73,27,100,2,2,0.0,1.0,100.0,86
691,71,29,100,2,3,0.0,1.0,100.0,86
692,11,89,100,3,4,0.0,1.0,100.0,86
693,50,50,100,3,5,0.0,1.0,100.0,86
694,61,39,100,3,6,0.0,1.0,100.0,86
695,52,39,91,3,7,0.0,1.0,100.0,86
696,5,95,100,1,0,0.0,1.0,100.0,87
697,0,100,100,1,1,0.0,1.0,100.0,87
698,-5,16,11,2,2,0.0,1.0,100.0,87
699,-7,10,3,2,3,0.0,1.0,100.0,87
700,19,56,75,3,4,0.0,1.0,100.0,87
701,14,56,70,3,5,0.0,1.0,100.0,87
702,-3,24,21,3,6,0.0,1.0,100.0,87
703,-11,18,7,3,7,0.0,1.0,100.0,87
704,65,0,65,1,0,0.0,1.0,100.0,88
705,79,0,79,1,1,0.0,1.0,100.0,88
706,75,0,75,2,2,0.0,1.0,100.0,88
707,90,0,90,2,3,0.0,1.0,100.0,88
708,11,65,76,3,4,0.0,1.0,100.0,88
709,59,25,84,3,5,0.0,1.0,100.0,88
710,77,12,89,3,6,0.0,1.0,100.0,88
711,65,24,89,3,7,0.0,1.0,100.0,88
712,18,82,100,1,0,0.0,1.0,100.0,89
713,0,100,100,1,1,0.0,1.0,100.0,89
714,69,16,85,2,2,0.0,1.0,100.0,89
715,18,0,18,2,3,0.0,1.0,100.0,89
716,31,69,100,3,4,0.0,1.0,100.0,89
717,-19,32,13,3,5,0.0,1.0,100.0,89
718,0,100,100,3,6,0.0,1.0,100.0,89
719,6,73,79,3,7,0.0,1.0,100.0,89
720,86,6,92,1,0,0.0,1.0,100.0,90
721,3,89,92,1,1,0.0,1.0,100.0,90
722,87,2,89,2,2,0.0,1.0,100.0,90
723,87,9,96,2,3,0.0,1.0,100.0,90
724,93,5,98,3,4,0.0,1.0,100.0,90
725,43,37,80,3,5,0.0,1.0,100.0,90
726,85,4,89,3,6,0.0,1.0,100.0,90
727,84,2,86,3,7,0.0,1.0,100.0,90
728,-1,90,89,1,0,0.0,1.0,100.0,91
729,-48,73,25,1,1,0.0,1.0,100.0,91
730,56,0,56,2,2,0.0,1.0,100.0,91
731,-15,29,14,2,3,0.0,1.0,100.0,91
732,7,93,100,3,4,0.0,1.0,100.0,91
733,17,15,32,3,5,0.0,1.0,100.0,91
734,50,39,89,3,6,0.0,1.0,100.0,91
735,0,0,0,3,7,0.0,1.0,100.0,91
736,-28,78,50,1,0,0.0,1.0,100.0,92
737,0,100,100,1,1,0.0,1.0,100.0,92
738,86,14,100,2,2,0.0,1.0,100.0,92
739,87,13,100,2,3,0.0,1.0,100.0,92
740,31,69,100,3,4,0.0,1.0,100.0,92
741,66,34,100,3,5,0.0,1.0,100.0,92
742,91,9,100,3,6,0.0,1.0,100.0,92
743,92,8,100,3,7,0.0,1.0,100.0,92
744,0,100,100,1,0,0.0,1.0,100.0,93
745,0,100,100,1,1,0.0,1.0,100.0,93
746,53,0,53,2,2,0.0,1.0,100.0,93
747,52,0,52,2,3,0.0,1.0,100.0,93
748,10,64,74,3,4,0.0,1.0,100.0,93
749,77,22,99,3,5,0.0,1.0,100.0,93
750,9,91,100,3,6,0.0,1.0,100.0,93
751,100,0,100,3,7,0.0,1.0,100.0,93
752,35,50,85,1,0,0.0,1.0,100.0,94
753,24,74,98,1,1,0.0,1.0,100.0,94
754,-10,11,1,2,2,0.0,1.0,100.0,94
755,21,67,88,2,3,0.0,1.0,100.0,94
756,24,72,96,3,4,0.0,1.0,100.0,94
757,-9,18,9,3,5,0.0,1.0,100.0,94
758,18,82,100,3,6,0.0,1.0,100.0,94
759,9,7,16,3,7,0.0,1.0,100.0,94
760,0,100,100,1,0,0.0,1.0,100.0,95
761,0,100,100,1,1,0.0,1.0,100.0,95
762,0,0,0,2,2,0.0,1.0,100.0,95
763,0,0,0,2,3,0.0,1.0,100.0,95
764,0,100,100,3,4,0.0,1.0,100.0,95
765,50,50,100,3,5,0.0,1.0,100.0,95
766,0,100,100,3,6,0.0,1.0,100.0,95
767,25,75,100,3,7,0.0,1.0,100.0,95
768,10,81,91,1,0,0.0,1.0,100.0,96
769,2,84,86,1,1,0.0,1.0,100.0,96
770,38,50,88,2,2,0.0,1.0,100.0,96
771,-9,88,79,2,3,0.0,1.0,100.0,96
772,15,77,92,3,4,0.0,1.0,100.0,96
773,-75,85,10,3,5,0.0,1.0,100.0,96
774,-95,95,0,3,6,0.0,1.0,100.0,96
775,2,86,88,3,7,0.0,1.0,100.0,96
776,79,0,79,1,0,0.0,1.0,100.0,97
777,49,37,86,1,1,0.0,1.0,100.0,97
778,78,0,78,2,2,0.0,1.0,100.0,97
779,71,0,71,2,3,0.0,1.0,100.0,97
780,33,47,80,3,4,0.0,1.0,100.0,97
781,83,0,83,3,5,0.0,1.0,100.0,97
782,0,100,100,3,6,0.0,1.0,100.0,97
783,64,16,80,3,7,0.0,1.0,100.0,97
784,0,0,0,1,0,0.0,1.0,100.0,98
785,0,95,95,1,1,0.0,1.0,100.0,98
786,0,0,0,2,2,0.0,1.0,100.0,98
787,0,0,0,2,3,0.0,1.0,100.0,98
788,0,50,50,3,4,0.0,1.0,100.0,98
789,0,0,0,3,5,0.0,1.0,100.0,98
790,0,100,100,3,6,0.0,1.0,100.0,98
791,0,0,0,3,7,0.0,1.0,100.0,98
792,21,75,96,1,0,0.0,1.0,100.0,99
793,-88,93,5,1,1,0.0,1.0,100.0,99
794,49,14,63,2,2,0.0,1.0,100.0,99
795,19,81,100,2,3,0.0,1.0,100.0,99
796,22,60,82,3,4,0.0,1.0,100.0,99
797,12,58,70,3,5,0.0,1.0,100.0,99
798,-21,29,8,3,6,0.0,1.0,100.0,99
799,77,3,80,3,7,0.0,1.0,100.0,99
800,25,67,92,1,0,0.0,1.0,100.0,100
801,0,100,100,1,1,0.0,1.0,100.0,100
802,44,16,60,2,2,0.0,1.0,100.0,100
803,48,18,66,2,3,0.0,1.0,100.0,100
804,51,32,83,3,4,0.0,1.0,100.0,100
805,37,36,73,3,5,0.0,1.0,100.0,100
806,23,77,100,3,6,0.0,1.0,100.0,100
807,35,37,72,3,7,0.0,1.0,100.0,100
808,0,100,100,1,0,0.0,1.0,100.0,101
809,-50,50,0,1,1,0.0,1.0,100.0,101
810,0,0,0,2,2,0.0,1.0,100.0,101
811,0,100,100,2,3,0.0,1.0,100.0,101
812,0,100,100,3,4,0.0,1.0,100.0,101
813,0,50,50,3,5,0.0,1.0,100.0,101
814,0,0,0,3,6,0.0,1.0,100.0,101
815,0,0,0,3,7,0.0,1.0,100.0,101
816,31,42,73,1,0,0.0,1.0,100.0,102
817,-1,10,9,1,1,0.0,1.0,100.0,102
818,3,10,13,2,2,0.0,1.0,100.0,102
819,23,50,73,2,3,0.0,1.0,100.0,102
820,50,35,85,3,4,0.0,1.0,100.0,102
821,-15,27,12,3,5,0.0,1.0,100.0,102
822,89,10,99,3,6,0.0,1.0,100.0,102
823,-15,30,15,3,7,0.0,1.0,100.0,102
824,73,27,100,1,0,0.0,1.0,100.0,103
825,100,0,100,1,1,0.0,1.0,100.0,103
826,50,50,100,2,2,0.0,1.0,100.0,103
827,19,81,100,2,3,0.0,1.0,100.0,103
828,64,36,100,3,4,0.0,1.0,100.0,103
829,100,0,100,3,5,0.0,1.0,100.0,103
830,0,100,100,3,6,0.0,1.0,100.0,103
831,100,0,100,3,7,0.0,1.0,100.0,103
832,-1,17,16,1,0,0.0,1.0,100.0,104
833,-1,10,9,1,1,0.0,1.0,100.0,104
834,34,17,51,2,2,0.0,1.0,100.0,104
835,0,10,10,2,3,0.0,1.0,100.0,104
836,4,7,11,3,4,0.0,1.0,100.0,104
837,20,21,41,3,5,0.0,1.0,100.0,104
838,0,100,100,3,6,0.0,1.0,100.0,104
839,-11,26,15,3,7,0.0,1.0,100.0,104
840,-86,86,0,1,0,0.0,1.0,100.0,105
841,79,21,100,1,1,0.0,1.0,100.0,105
842,90,10,100,2,2,0.0,1.0,100.0,105
843,0,100,100,2,3,0.0,1.0,100.0,105
844,8,92,100,3,4,0.0,1.0,100.0,105
845,-90,90,0,3,5,0.0,1.0,100.0,105
846,-100,100,0,3,6,0.0,1.0,100.0,105
847,0,0,0,3,7,0.0,1.0,100.0,105
848,0,0,0,1,0,0.0,1.0,100.0,106
849,100,0,100,1,1,0.0,1.0,100.0,106
850,50,50,100,2,2,0.0,1.0,100.0,106
851,0,77,77,2,3,0.0,1.0,100.0,106
852,50,50,100,3,4,0.0,1.0,100.0,106
853,0,0,0,3,5,0.0,1.0,100.0,106
854,0,0,0,3,6,0.0,1.0,100.0,106
855,0,0,0,3,7,0.0,1.0,100.0,106
856,26,74,100,1,0,0.0,1.0,100.0,107
857,0,100,100,1,1,0.0,1.0,100.0,107
858,0,0,0,2,2,0.0,1.0,100.0,107
859,0,0,0,2,3,0.0,1.0,100.0,107
860,12,65,77,3,4,0.0,1.0,100.0,107
861,0,50,50,3,5,0.0,1.0,100.0,107
862,0,100,100,3,6,0.0,1.0,100.0,107
863,0,0,0,3,7,0.0,1.0,100.0,107
864,50,50,100,1,0,0.0,1.0,100.0,108
865,45,55,100,1,1,0.0,1.0,100.0,108
866,-50,50,0,2,2,0.0,1.0,100.0,108
867,100,0,100,2,3,0.0,1.0,100.0,108
868,50,50,100,3,4,0.0,1.0,100.0,108
869,90,10,100,3,5,0.0,1.0,100.0,108
870,0,100,100,3,6,0.0,1.0,100.0,108
871,100,0,100,3,7,0.0,1.0,100.0,108
872,-4,79,75,1,0,0.0,1.0,100.0,109
873,-38,100,62,1,1,0.0,1.0,100.0,109
874,60,11,71,2,2,0.0,1.0,100.0,109
875,-13,76,63,2,3,0.0,1.0,100.0,109
876,25,36,61,3,4,0.0,1.0,100.0,109
877,-9,82,73,3,5,0.0,1.0,100.0,109
878,5,79,84,3,6,0.0,1.0,100.0,109
879,-2,71,69,3,7,0.0,1.0,100.0,109
880,25,75,100,1,0,0.0,1.0,100.0,110
881,0,0,0,1,1,0.0,1.0,100.0,110
882,0,0,0,2,2,0.0,1.0,100.0,110
883,0,0,0,2,3,0.0,1.0,100.0,110
884,37,38,75,3,4,0.0,1.0,100.0,110
885,50,50,100,3,5,0.0,1.0,100.0,110
886,10,0,10,3,6,0.0,1.0,100.0,110
887,0,0,0,3,7,0.0,1.0,100.0,110
888,23,77,100,1,0,0.0,1.0,100.0,111
889,0,100,100,1,1,0.0,1.0,100.0,111
890,0,0,0,2,2,0.0,1.0,100.0,111
891,84,16,100,2,3,0.0,1.0,100.0,111
892,0,100,100,3,4,0.0,1.0,100.0,111
893,66,34,100,3,5,0.0,1.0,100.0,111
894,86,14,100,3,6,0.0,1.0,100.0,111
895,100,0,100,3,7,0.0,1.0,100.0,111
896,0,100,100,1,0,0.0,1.0,100.0,112
897,-1,1,0,1,1,0.0,1.0,100.0,112
898,0,0,0,2,2,0.0,1.0,100.0,112
899,0,100,100,2,3,0.0,1.0,100.0,112
900,0,100,100,3,4,0.0,1.0,100.0,112
901,0,100,100,3,5,0.0,1.0,100.0,112
902,0,0,0,3,6,0.0,1.0,100.0,112
903,0,0,0,3,7,0.0,1.0,100.0,112
904,0,100,100,1,0,0.0,1.0,100.0,113
905,0,100,100,1,1,0.0,1.0,100.0,113
906,65,11,76,2,2,0.0,1.0,100.0,113
907,62,0,62,2,3,0.0,1.0,100.0,113
908,1,89,90,3,4,0.0,1.0,100.0,113
909,25,0,25,3,5,0.0,1.0,100.0,113
910,12,88,100,3,6,0.0,1.0,100.0,113
911,64,11,75,3,7,0.0,1.0,100.0,113
912,1,98,99,1,0,0.0,1.0,100.0,114
913,-1,99,98,1,1,0.0,1.0,100.0,114
914,6,66,72,2,2,0.0,1.0,100.0,114
915,-1,1,0,2,3,0.0,1.0,100.0,114
916,-6,86,80,3,4,0.0,1.0,100.0,114
917,-1,27,26,3,5,0.0,1.0,100.0,114
918,9,88,97,3,6,0.0,1.0,100.0,114
919,-2,78,76,3,7,0.0,1.0,100.0,114
920,9,91,100,1,0,0.0,1.0,100.0,115
921,-10,100,90,1,1,0.0,1.0,100.0,115
922,44,56,100,2,2,0.0,1.0,100.0,115
923,99,1,100,2,3,0.0,1.0,100.0,115
924,38,62,100,3,4,0.0,1.0,100.0,115
925,62,31,93,3,5,0.0,1.0,100.0,115
926,0,100,100,3,6,0.0,1.0,100.0,115
927,100,0,100,3,7,0.0,1.0,100.0,115
928,25,57,82,1,0,0.0,1.0,100.0,116
929,100,0,100,1,1,0.0,1.0,100.0,116
930,31,37,68,2,2,0.0,1.0,100.0,116
931,33,38,71,2,3,0.0,1.0,100.0,116
932,42,32,74,3,4,0.0,1.0,100.0,116
933,43,42,85,3,5,0.0,1.0,100.0,116
934,34,63,97,3,6,0.0,1.0,100.0,116
935,60,20,80,3,7,0.0,1.0,100.0,116
936,0,100,100,1,0,0.0,1.0,100.0,117
937,-100,100,0,1,1,0.0,1.0,100.0,117
938,0,0,0,2,2,0.0,1.0,100.0,117
939,0,100,100,2,3,0.0,1.0,100.0,117
940,59,41,100,3,4,0.0,1.0,100.0,117
941,50,50,100,3,5,0.0,1.0,100.0,117
942,0,100,100,3,6,0.0,1.0,100.0,117
943,100,0,100,3,7,0.0,1.0,100.0,117
944,4,57,61,1,0,0.0,1.0,100.0,118
945,2,98,100,1,1,0.0,1.0,100.0,118
946,40,0,40,2,2,0.0,1.0,100.0,118
947,1,10,11,2,3,0.0,1.0,100.0,118
948,23,55,78,3,4,0.0,1.0,100.0,118
949,53,4,57,3,5,0.0,1.0,100.0,118
950,5,80,85,3,6,0.0,1.0,100.0,118
951,43,3,46,3,7,0.0,1.0,100.0,118
952,10,0,10,1,0,0.0,1.0,100.0,119
953,-18,18,0,1,1,0.0,1.0,100.0,119
954,0,0,0,2,2,0.0,1.0,100.0,119
955,-97,100,3,2,3,0.0,1.0,100.0,119
956,0,0,0,3,4,0.0,1.0,100.0,119
957,0,0,0,3,5,0.0,1.0,100.0,119
958,0,11,11,3,6,0.0,1.0,100.0,119
959,0,81,81,3,7,0.0,1.0,100.0,119
960,20,70,90,1,0,0.0,1.0,100.0,120
961,95,5,100,1,1,0.0,1.0,100.0,120
962,52,39,91,2,2,0.0,1.0,100.0,120
963,42,49,91,2,3,0.0,1.0,100.0,120
964,10,90,100,3,4,0.0,1.0,100.0,120
965,66,24,90,3,5,0.0,1.0,100.0,120
966,70,20,90,3,6,0.0,1.0,100.0,120
967,60,30,90,3,7,0.0,1.0,100.0,120
968,-33,70,37,1,0,0.0,1.0,100.0,121
969,0,100,100,1,1,0.0,1.0,100.0,121
970,-2,44,42,2,2,0.0,1.0,100.0,121
971,-24,63,39,2,3,0.0,1.0,100.0,121
972,-41,78,37,3,4,0.0,1.0,100.0,121
973,25,75,100,3,5,0.0,1.0,100.0,121
974,19,47,66,3,6,0.0,1.0,100.0,121
975,-3,41,38,3,7,0.0,1.0,100.0,121
976,10,90,100,1,0,0.0,1.0,100.0,122
977,0,100,100,1,1,0.0,1.0,100.0,122
978,0,0,0,2,2,0.0,1.0,100.0,122
979,0,0,0,2,3,0.0,1.0,100.0,122
980,24,76,100,3,4,0.0,1.0,100.0,122
981,50,50,100,3,5,0.0,1.0,100.0,122
982,0,0,0,3,6,0.0,1.0,100.0,122
983,27,62,89,3,7,0.0,1.0,100.0,122
984,60,40,100,1,0,0.0,1.0,100.0,123
985,86,14,100,1,1,0.0,1.0,100.0,123
986,-5,5,0,2,2,0.0,1.0,100.0,123
987,82,12,94,2,3,0.0,1.0,100.0,123
988,-75,75,0,3,4,0.0,1.0,100.0,123
989,2,98,100,3,5,0.0,1.0,100.0,123
990,0,100,100,3,6,0.0,1.0,100.0,123
991,0,0,0,3,7,0.0,1.0,100.0,123
992,26,15,41,1,0,0.0,1.0,100.0,124
993,-13,32,19,1,1,0.0,1.0,100.0,124
994,74,6,80,2,2,0.0,1.0,100.0,124
995,73,1,74,2,3,0.0,1.0,100.0,124
996,54,18,72,3,4,0.0,1.0,100.0,124
997,36,26,62,3,5,0.0,1.0,100.0,124
998,82,4,86,3,6,0.0,1.0,100.0,124
999,6,16,22,3,7,0.0,1.0,100.0,124
1000,35,60,95,1,0,0.0,1.0,100.0,125
1001,21,75,96,1,1,0.0,1.0,100.0,125
1002,50,20,70,2,2,0.0,1.0,100.0,125
1003,55,15,70,2,3,0.0,1.0,100.0,125
1004,25,70,95,3,4,0.0,1.0,100.0,125
1005,65,25,90,3,5,0.0,1.0,100.0,125
1006,25,65,90,3,6,0.0,1.0,100.0,125
1007,35,50,85,3,7,0.0,1.0,100.0,125
1008,-25,75,50,1,0,0.0,1.0,100.0,126
1009,77,0,77,1,1,0.0,1.0,100.0,126
1010,18,0,18,2,2,0.0,1.0,100.0,126
1011,21,0,21,2,3,0.0,1.0,100.0,126
1012,72,0,72,3,4,0.0,1.0,100.0,126
1013,72,0,72,3,5,0.0,1.0,100.0,126
1014,0,100,100,3,6,0.0,1.0,100.0,126
1015,50,0,50,3,7,0.0,1.0,100.0,126
1016,78,22,100,1,0,0.0,1.0,100.0,127
1017,14,86,100,1,1,0.0,1.0,100.0,127
1018,87,13,100,2,2,0.0,1.0,100.0,127
1019,92,8,100,2,3,0.0,1.0,100.0,127
1020,63,37,100,3,4,0.0,1.0,100.0,127
1021,23,77,100,3,5,0.0,1.0,100.0,127
1022,0,100,100,3,6,0.0,1.0,100.0,127
1023,75,25,100,3,7,0.0,1.0,100.0,127
1024,27,50,77,1,0,0.0,1.0,100.0,128
1025,0,100,100,1,1,0.0,1.0,100.0,128
1026,36,0,36,2,2,0.0,1.0,100.0,128
1027,23,0,23,2,3,0.0,1.0,100.0,128
1028,8,50,58,3,4,0.0,1.0,100.0,128
1029,-11,50,39,3,5,0.0,1.0,100.0,128
1030,41,8,49,3,6,0.0,1.0,100.0,128
1031,-4,20,16,3,7,0.0,1.0,100.0,128
1032,15,59,74,1,0,0.0,1.0,100.0,129
1033,-22,85,63,1,1,0.0,1.0,100.0,129
1034,30,26,56,2,2,0.0,1.0,100.0,129
1035,-26,57,31,2,3,0.0,1.0,100.0,129
1036,-12,66,54,3,4,0.0,1.0,100.0,129
1037,-8,50,42,3,5,0.0,1.0,100.0,129
1038,-28,73,45,3,6,0.0,1.0,100.0,129
1039,61,0,61,3,7,0.0,1.0,100.0,129
1040,7,79,86,1,0,0.0,1.0,100.0,130
1041,0,100,100,1,1,0.0,1.0,100.0,130
1042,0,0,0,2,2,0.0,1.0,100.0,130
1043,19,27,46,2,3,0.0,1.0,100.0,130
1044,5,58,63,3,4,0.0,1.0,100.0,130
1045,12,51,63,3,5,0.0,1.0,100.0,130
1046,-10,75,65,3,6,0.0,1.0,100.0,130
1047,-11,57,46,3,7,0.0,1.0,100.0,130
1048,63,23,86,1,0,0.0,1.0,100.0,131
1049,35,0,35,1,1,0.0,1.0,100.0,131
1050,25,0,25,2,2,0.0,1.0,100.0,131
1051,40,36,76,2,3,0.0,1.0,100.0,131
1052,1,24,25,3,4,0.0,1.0,100.0,131
1053,58,42,100,3,5,0.0,1.0,100.0,131
1054,78,22,100,3,6,0.0,1.0,100.0,131
1055,60,15,75,3,7,0.0,1.0,100.0,131
1056,-15,56,41,1,0,0.0,1.0,100.0,132
1057,7,2,9,1,1,0.0,1.0,100.0,132
1058,-23,34,11,2,2,0.0,1.0,100.0,132
1059,-23,73,50,2,3,0.0,1.0,100.0,132
1060,16,34,50,3,4,0.0,1.0,100.0,132
1061,-6,24,18,3,5,0.0,1.0,100.0,132
1062,-4,9,5,3,6,0.0,1.0,100.0,132
1063,26,5,31,3,7,0.0,1.0,100.0,132
1064,-11,17,6,1,0,1.0,1.0,99.0,133
1065,-1,81,80,1,1,1.0,1.0,99.0,133
1066,75,10,85,2,2,1.0,1.0,99.0,133
1067,56,26,82,2,3,1.0,1.0,99.0,133
1068,71,11,82,3,4,1.0,1.0,99.0,133
1069,0,50,50,3,5,1.0,1.0,99.0,133
1070,66,34,100,3,6,1.0,1.0,99.0,133
1071,98,2,100,3,7,1.0,1.0,99.0,133
1072,2,49,51,1,0,1.0,1.0,99.0,134
1073,-6,61,55,1,1,1.0,1.0,99.0,134
1074,7,45,52,2,2,1.0,1.0,99.0,134
1075,6,47,53,2,3,1.0,1.0,99.0,134
1076,-14,67,53,3,4,1.0,1.0,99.0,134
1077,-15,80,65,3,5,1.0,1.0,99.0,134
1078,-7,51,44,3,6,1.0,1.0,99.0,134
1079,19,34,53,3,7,1.0,1.0,99.0,134
1080,-7,96,89,1,0,1.0,1.0,99.0,135
1081,0,87,87,1,1,1.0,1.0,99.0,135
1082,0,91,91,2,2,1.0,1.0,99.0,135
1083,-2,90,88,2,3,1.0,1.0,99.0,135
1084,0,87,87,3,4,1.0,1.0,99.0,135
1085,-6,95,89,3,5,1.0,1.0,99.0,135
1086,-8,90,82,3,6,1.0,1.0,99.0,135
1087,-3,94,91,3,7,1.0,1.0,99.0,135
1088,32,35,67,1,0,1.0,1.0,99.0,136
1089,3,73,76,1,1,1.0,1.0,99.0,136
1090,-11,94,83,2,2,1.0,1.0,99.0,136
1091,-20,100,80,2,3,1.0,1.0,99.0,136
1092,-28,99,71,3,4,1.0,1.0,99.0,136
1093,31,33,64,3,5,1.0,1.0,99.0,136
1094,-4,28,24,3,6,1.0,1.0,99.0,136
1095,-8,78,70,3,7,1.0,1.0,99.0,136
1096,10,83,93,1,0,2.0,1.0,98.0,137
1097,1,99,100,1,1,2.0,1.0,98.0,137
1098,-8,82,74,2,2,2.0,1.0,98.0,137
1099,36,36,72,2,3,2.0,1.0,98.0,137
1100,15,66,81,3,4,2.0,1.0,98.0,137
1101,52,14,66,3,5,2.0,1.0,98.0,137
1102,0,100,100,3,6,2.0,1.0,98.0,137
1103,7,51,58,3,7,2.0,1.0,98.0,137
1104,-29,79,50,1,0,2.0,1.0,98.0,138
1105,1,85,86,1,1,2.0,1.0,98.0,138
1106,1,0,1,2,2,2.0,1.0,98.0,138
1107,-8,8,0,2,3,2.0,1.0,98.0,138
1108,17,70,87,3,4,2.0,1.0,98.0,138
1109,4,50,54,3,5,2.0,1.0,98.0,138
1110,2,0,2,3,6,2.0,1.0,98.0,138
1111,-8,12,4,3,7,2.0,1.0,98.0,138
1112,0,100,100,1,0,2.0,1.0,98.0,139
1113,-4,99,95,1,1,2.0,1.0,98.0,139
1114,66,3,69,2,2,2.0,1.0,98.0,139
1115,62,0,62,2,3,2.0,1.0,98.0,139
1116,10,85,95,3,4,2.0,1.0,98.0,139
1117,30,50,80,3,5,2.0,1.0,98.0,139
1118,40,60,100,3,6,2.0,1.0,98.0,139
1119,6,92,98,3,7,2.0,1.0,98.0,139
1120,15,70,85,1,0,3.0,1.0,97.0,140
1121,2,70,72,1,1,3.0,1.0,97.0,140
1122,-11,48,37,2,2,3.0,1.0,97.0,140
1123,26,34,60,2,3,3.0,1.0,97.0,140
1124,20,62,82,3,4,3.0,1.0,97.0,140
1125,24,59,83,3,5,3.0,1.0,97.0,140
1126,37,38,75,3,6,3.0,1.0,97.0,140
1127,20,0,20,3,7,3.0,1.0,97.0,140
1128,8,63,71,1,0,3.0,1.0,97.0,141
1129,16,69,85,1,1,3.0,1.0,97.0,141
1130,-7,39,32,2,2,3.0,1.0,97.0,141
1131,3,76,79,2,3,3.0,1.0,97.0,141
1132,13,73,86,3,4,3.0,1.0,97.0,141
1133,5,72,77,3,5,3.0,1.0,97.0,141
1134,-7,98,91,3,6,3.0,1.0,97.0,141
1135,15,18,33,3,7,3.0,1.0,97.0,141
1136,-13,96,83,1,0,3.0,1.0,97.0,142
1137,0,100,100,1,1,3.0,1.0,97.0,142
1138,20,13,33,2,2,3.0,1.0,97.0,142
1139,6,12,18,2,3,3.0,1.0,97.0,142
1140,-9,38,29,3,4,3.0,1.0,97.0,142
1141,33,33,66,3,5,3.0,1.0,97.0,142
1142,32,28,60,3,6,3.0,1.0,97.0,142
1143,0,63,63,3,7,3.0,1.0,97.0,142
1144,40,60,100,1,0,3.0,1.0,97.0,143
1145,100,0,100,1,1,3.0,1.0,97.0,143
1146,100,0,100,2,2,3.0,1.0,97.0,143
1147,95,5,100,2,3,3.0,1.0,97.0,143
1148,46,54,100,3,4,3.0,1.0,97.0,143
1149,100,0,100,3,5,3.0,1.0,97.0,143
1150,0,100,100,3,6,3.0,1.0,97.0,143
1151,100,0,100,3,7,3.0,1.0,97.0,143
1152,-4,91,87,1,0,4.0,1.0,96.0,144
1153,0,100,100,1,1,4.0,1.0,96.0,144
1154,-29,68,39,2,2,4.0,1.0,96.0,144
1155,-16,83,67,2,3,4.0,1.0,96.0,144
1156,40,31,71,3,4,4.0,1.0,96.0,144
1157,58,30,88,3,5,4.0,1.0,96.0,144
1158,-16,16,0,3,6,4.0,1.0,96.0,144
1159,81,1,82,3,7,4.0,1.0,96.0,144
1160,6,69,75,1,0,4.0,1.0,96.0,145
1161,47,31,78,1,1,4.0,1.0,96.0,145
1162,53,26,79,2,2,4.0,1.0,96.0,145
1163,59,14,73,2,3,4.0,1.0,96.0,145
1164,1,75,76,3,4,4.0,1.0,96.0,145
1165,16,61,77,3,5,4.0,1.0,96.0,145
1166,-2,91,89,3,6,4.0,1.0,96.0,145
1167,49,25,74,3,7,4.0,1.0,96.0,145
1168,0,50,50,1,0,4.0,1.0,96.0,146
1169,-2,93,91,1,1,4.0,1.0,96.0,146
1170,0,0,0,2,2,4.0,1.0,96.0,146
1171,0,44,44,2,3,4.0,1.0,96.0,146
1172,0,50,50,3,4,4.0,1.0,96.0,146
1173,0,50,50,3,5,4.0,1.0,96.0,146
1174,55,1,56,3,6,4.0,1.0,96.0,146
1175,-32,50,18,3,7,4.0,1.0,96.0,146
1176,12,78,90,1,0,4.0,1.0,96.0,147
1177,73,25,98,1,1,4.0,1.0,96.0,147
1178,65,22,87,2,2,4.0,1.0,96.0,147
1179,60,40,100,2,3,4.0,1.0,96.0,147
1180,48,42,90,3,4,4.0,1.0,96.0,147
1181,23,62,85,3,5,4.0,1.0,96.0,147
1182,38,55,93,3,6,4.0,1.0,96.0,147
1183,35,55,90,3,7,4.0,1.0,96.0,147
1184,20,52,72,1,0,4.0,1.0,96.0,148
1185,38,1,39,1,1,4.0,1.0,96.0,148
1186,-5,18,13,2,2,4.0,1.0,96.0,148
1187,49,20,69,2,3,4.0,1.0,96.0,148
1188,33,36,69,3,4,4.0,1.0,96.0,148
1189,41,24,65,3,5,4.0,1.0,96.0,148
1190,35,30,65,3,6,4.0,1.0,96.0,148
1191,62,0,62,3,7,4.0,1.0,96.0,148
1192,28,53,81,1,0,4.0,1.0,96.0,149
1193,-3,81,78,1,1,4.0,1.0,96.0,149
1194,-13,51,38,2,2,4.0,1.0,96.0,149
1195,42,40,82,2,3,4.0,1.0,96.0,149
1196,22,78,100,3,4,4.0,1.0,96.0,149
1197,35,35,70,3,5,4.0,1.0,96.0,149
1198,-22,60,38,3,6,4.0,1.0,96.0,149
1199,17,41,58,3,7,4.0,1.0,96.0,149
1200,54,10,64,1,0,4.0,1.0,96.0,150
1201,23,48,71,1,1,4.0,1.0,96.0,150
1202,36,31,67,2,2,4.0,1.0,96.0,150
1203,34,27,61,2,3,4.0,1.0,96.0,150
1204,18,51,69,3,4,4.0,1.0,96.0,150
1205,22,51,73,3,5,4.0,1.0,96.0,150
1206,0,100,100,3,6,4.0,1.0,96.0,150
1207,72,0,72,3,7,4.0,1.0,96.0,150
1208,5,62,67,1,0,5.0,1.0,95.0,151
1209,0,100,100,1,1,5.0,1.0,95.0,151
1210,-1,71,70,2,2,5.0,1.0,95.0,151
1211,1,66,67,2,3,5.0,1.0,95.0,151
1212,-9,70,61,3,4,5.0,1.0,95.0,151
1213,-5,19,14,3,5,5.0,1.0,95.0,151
1214,-4,27,23,3,6,5.0,1.0,95.0,151
1215,-5,27,22,3,7,5.0,1.0,95.0,151
1216,12,60,72,1,0,5.0,1.0,95.0,152
1217,20,80,100,1,1,5.0,1.0,95.0,152
1218,9,68,77,2,2,5.0,1.0,95.0,152
1219,-1,62,61,2,3,5.0,1.0,95.0,152
1220,3,60,63,3,4,5.0,1.0,95.0,152
1221,22,57,79,3,5,5.0,1.0,95.0,152
1222,0,50,50,3,6,5.0,1.0,95.0,152
1223,64,13,77,3,7,5.0,1.0,95.0,152
1224,0,100,100,1,0,5.0,1.0,95.0,153
1225,0,100,100,1,1,5.0,1.0,95.0,153
1226,100,0,100,2,2,5.0,1.0,95.0,153
1227,0,100,100,2,3,5.0,1.0,95.0,153
1228,20,80,100,3,4,5.0,1.0,95.0,153
1229,5,95,100,3,5,5.0,1.0,95.0,153
1230,100,0,100,3,6,5.0,1.0,95.0,153
1231,100,0,100,3,7,5.0,1.0,95.0,153
1232,-6,93,87,1,0,5.0,1.0,95.0,154
1233,3,81,84,1,1,5.0,1.0,95.0,154
1234,77,14,91,2,2,5.0,1.0,95.0,154
1235,10,89,99,2,3,5.0,1.0,95.0,154
1236,11,79,90,3,4,5.0,1.0,95.0,154
1237,3,80,83,3,5,5.0,1.0,95.0,154
1238,-2,81,79,3,6,5.0,1.0,95.0,154
1239,65,20,85,3,7,5.0,1.0,95.0,154
1240,12,58,70,1,0,5.0,1.0,95.0,155
1241,-6,82,76,1,1,5.0,1.0,95.0,155
1242,0,18,18,2,2,5.0,1.0,95.0,155
1243,2,69,71,2,3,5.0,1.0,95.0,155
1244,-3,44,41,3,4,5.0,1.0,95.0,155
1245,0,50,50,3,5,5.0,1.0,95.0,155
1246,-2,20,18,3,6,5.0,1.0,95.0,155
1247,11,10,21,3,7,5.0,1.0,95.0,155
1248,-7,94,87,1,0,6.0,1.0,94.0,156
1249,5,90,95,1,1,6.0,1.0,94.0,156
1250,42,16,58,2,2,6.0,1.0,94.0,156
1251,46,16,62,2,3,6.0,1.0,94.0,156
1252,5,75,80,3,4,6.0,1.0,94.0,156
1253,61,12,73,3,5,6.0,1.0,94.0,156
1254,9,81,90,3,6,6.0,1.0,94.0,156
1255,42,39,81,3,7,6.0,1.0,94.0,156
1256,-9,98,89,1,0,6.0,1.0,94.0,157
1257,67,33,100,1,1,6.0,1.0,94.0,157
1258,10,89,99,2,2,6.0,1.0,94.0,157
1259,-2,100,98,2,3,6.0,1.0,94.0,157
1260,67,33,100,3,4,6.0,1.0,94.0,157
1261,10,90,100,3,5,6.0,1.0,94.0,157
1262,61,32,93,3,6,6.0,1.0,94.0,157
1263,-6,18,12,3,7,6.0,1.0,94.0,157
1264,100,0,100,1,0,6.0,1.0,94.0,158
1265,88,10,98,1,1,6.0,1.0,94.0,158
1266,90,0,90,2,2,6.0,1.0,94.0,158
1267,21,79,100,2,3,6.0,1.0,94.0,158
1268,24,76,100,3,4,6.0,1.0,94.0,158
1269,46,54,100,3,5,6.0,1.0,94.0,158
1270,-2,100,98,3,6,6.0,1.0,94.0,158
1271,77,0,77,3,7,6.0,1.0,94.0,158
1272,0,100,100,1,0,6.0,1.0,94.0,159
1273,0,100,100,1,1,6.0,1.0,94.0,159
1274,72,0,72,2,2,6.0,1.0,94.0,159
1275,71,3,74,2,3,6.0,1.0,94.0,159
1276,21,61,82,3,4,6.0,1.0,94.0,159
1277,55,36,91,3,5,6.0,1.0,94.0,159
1278,6,94,100,3,6,6.0,1.0,94.0,159
1279,52,24,76,3,7,6.0,1.0,94.0,159
1280,7,66,73,1,0,6.0,1.0,94.0,160
1281,59,15,74,1,1,6.0,1.0,94.0,160
1282,41,27,68,2,2,6.0,1.0,94.0,160
1283,42,33,75,2,3,6.0,1.0,94.0,160
1284,14,64,78,3,4,6.0,1.0,94.0,160
1285,34,35,69,3,5,6.0,1.0,94.0,160
1286,45,34,79,3,6,6.0,1.0,94.0,160
1287,26,36,62,3,7,6.0,1.0,94.0,160
1288,10,70,80,1,0,6.0,1.0,94.0,161
1289,-6,94,88,1,1,6.0,1.0,94.0,161
1290,38,21,59,2,2,6.0,1.0,94.0,161
1291,23,34,57,2,3,6.0,1.0,94.0,161
1292,13,64,77,3,4,6.0,1.0,94.0,161
1293,-1,61,60,3,5,6.0,1.0,94.0,161
1294,25,56,81,3,6,6.0,1.0,94.0,161
1295,22,38,60,3,7,6.0,1.0,94.0,161
1296,25,50,75,1,0,6.0,1.0,94.0,162
1297,24,49,73,1,1,6.0,1.0,94.0,162
1298,17,7,24,2,2,6.0,1.0,94.0,162
1299,69,0,69,2,3,6.0,1.0,94.0,162
1300,20,60,80,3,4,6.0,1.0,94.0,162
1301,36,34,70,3,5,6.0,1.0,94.0,162
1302,47,53,100,3,6,6.0,1.0,94.0,162
1303,81,6,87,3,7,6.0,1.0,94.0,162
1304,9,73,82,1,0,7.0,1.0,93.0,163
1305,19,50,69,1,1,7.0,1.0,93.0,163
1306,0,50,50,2,2,7.0,1.0,93.0,163
1307,-8,40,32,2,3,7.0,1.0,93.0,163
1308,3,64,67,3,4,7.0,1.0,93.0,163
1309,20,30,50,3,5,7.0,1.0,93.0,163
1310,4,96,100,3,6,7.0,1.0,93.0,163
1311,-12,33,21,3,7,7.0,1.0,93.0,163
1312,0,100,100,1,0,7.0,1.0,93.0,164
1313,48,50,98,1,1,7.0,1.0,93.0,164
1314,-18,18,0,2,2,7.0,1.0,93.0,164
1315,0,0,0,2,3,7.0,1.0,93.0,164
1316,0,50,50,3,4,7.0,1.0,93.0,164
1317,48,52,100,3,5,7.0,1.0,93.0,164
1318,21,0,21,3,6,7.0,1.0,93.0,164
1319,100,0,100,3,7,7.0,1.0,93.0,164
1320,24,76,100,1,0,7.0,1.0,93.0,165
1321,0,100,100,1,1,7.0,1.0,93.0,165
1322,87,1,88,2,2,7.0,1.0,93.0,165
1323,88,12,100,2,3,7.0,1.0,93.0,165
1324,0,100,100,3,4,7.0,1.0,93.0,165
1325,-50,50,0,3,5,7.0,1.0,93.0,165
1326,0,100,100,3,6,7.0,1.0,93.0,165
1327,75,25,100,3,7,7.0,1.0,93.0,165
1328,18,82,100,1,0,7.0,1.0,93.0,166
1329,0,100,100,1,1,7.0,1.0,93.0,166
1330,-9,9,0,2,2,7.0,1.0,93.0,166
1331,-7,57,50,2,3,7.0,1.0,93.0,166
1332,12,88,100,3,4,7.0,1.0,93.0,166
1333,-2,47,45,3,5,7.0,1.0,93.0,166
1334,0,100,100,3,6,7.0,1.0,93.0,166
1335,0,0,0,3,7,7.0,1.0,93.0,166
1336,-3,97,94,1,0,8.0,1.0,92.0,167
1337,-15,100,85,1,1,8.0,1.0,92.0,167
1338,58,14,72,2,2,8.0,1.0,92.0,167
1339,41,35,76,2,3,8.0,1.0,92.0,167
1340,31,48,79,3,4,8.0,1.0,92.0,167
1341,41,42,83,3,5,8.0,1.0,92.0,167
1342,23,53,76,3,6,8.0,1.0,92.0,167
1343,0,13,13,3,7,8.0,1.0,92.0,167
1344,-8,79,71,1,0,8.0,1.0,92.0,168
1345,0,100,100,1,1,8.0,1.0,92.0,168
1346,3,29,32,2,2,8.0,1.0,92.0,168
1347,29,24,53,2,3,8.0,1.0,92.0,168
1348,-5,70,65,3,4,8.0,1.0,92.0,168
1349,41,27,68,3,5,8.0,1.0,92.0,168
1350,-2,29,27,3,6,8.0,1.0,92.0,168
1351,16,17,33,3,7,8.0,1.0,92.0,168
1352,1,97,98,1,0,8.0,1.0,92.0,169
1353,0,100,100,1,1,8.0,1.0,92.0,169
1354,-19,48,29,2,2,8.0,1.0,92.0,169
1355,-3,7,4,2,3,8.0,1.0,92.0,169
1356,12,45,57,3,4,8.0,1.0,92.0,169
1357,-7,50,43,3,5,8.0,1.0,92.0,169
1358,48,31,79,3,6,8.0,1.0,92.0,169
1359,11,54,65,3,7,8.0,1.0,92.0,169
1360,2,64,66,1,0,8.0,1.0,92.0,170
1361,5,85,90,1,1,8.0,1.0,92.0,170
1362,25,0,25,2,2,8.0,1.0,92.0,170
1363,3,64,67,2,3,8.0,1.0,92.0,170
1364,-2,64,62,3,4,8.0,1.0,92.0,170
1365,12,22,34,3,5,8.0,1.0,92.0,170
1366,-1,23,22,3,6,8.0,1.0,92.0,170
1367,0,0,0,3,7,8.0,1.0,92.0,170
1368,22,63,85,1,0,8.0,1.0,92.0,171
1369,19,75,94,1,1,8.0,1.0,92.0,171
1370,58,27,85,2,2,8.0,1.0,92.0,171
1371,12,10,22,2,3,8.0,1.0,92.0,171
1372,16,72,88,3,4,8.0,1.0,92.0,171
1373,93,0,93,3,5,8.0,1.0,92.0,171
1374,25,62,87,3,6,8.0,1.0,92.0,171
1375,43,41,84,3,7,8.0,1.0,92.0,171
1376,2,68,70,1,0,8.0,1.0,92.0,172
1377,0,100,100,1,1,8.0,1.0,92.0,172
1378,14,0,14,2,2,8.0,1.0,92.0,172
1379,-100,100,0,2,3,8.0,1.0,92.0,172
1380,6,94,100,3,4,8.0,1.0,92.0,172
1381,42,27,69,3,5,8.0,1.0,92.0,172
1382,15,85,100,3,6,8.0,1.0,92.0,172
1383,88,0,88,3,7,8.0,1.0,92.0,172
1384,0,100,100,1,0,8.0,1.0,92.0,173
1385,0,100,100,1,1,8.0,1.0,92.0,173
1386,14,10,24,2,2,8.0,1.0,92.0,173
1387,3,97,100,2,3,8.0,1.0,92.0,173
1388,24,76,100,3,4,8.0,1.0,92.0,173
1389,41,59,100,3,5,8.0,1.0,92.0,173
1390,52,24,76,3,6,8.0,1.0,92.0,173
1391,-38,63,25,3,7,8.0,1.0,92.0,173
1392,-15,85,70,1,0,8.0,1.0,92.0,174
1393,33,0,33,1,1,8.0,1.0,92.0,174
1394,76,0,76,2,2,8.0,1.0,92.0,174
1395,9,7,16,2,3,8.0,1.0,92.0,174
1396,32,68,100,3,4,8.0,1.0,92.0,174
1397,79,3,82,3,5,8.0,1.0,92.0,174
1398,-18,18,0,3,6,8.0,1.0,92.0,174
1399,-2,2,0,3,7,8.0,1.0,92.0,174
1400,-1,85,84,1,0,8.0,1.0,92.0,175
1401,5,78,83,1,1,8.0,1.0,92.0,175
1402,-2,81,79,2,2,8.0,1.0,92.0,175
1403,-5,95,90,2,3,8.0,1.0,92.0,175
1404,-8,29,21,3,4,8.0,1.0,92.0,175
1405,13,73,86,3,5,8.0,1.0,92.0,175
1406,3,79,82,3,6,8.0,1.0,92.0,175
1407,-4,26,22,3,7,8.0,1.0,92.0,175
1408,44,33,77,1,0,8.0,1.0,92.0,176
1409,0,88,88,1,1,8.0,1.0,92.0,176
1410,68,23,91,2,2,8.0,1.0,92.0,176
1411,53,27,80,2,3,8.0,1.0,92.0,176
1412,-2,77,75,3,4,8.0,1.0,92.0,176
1413,27,50,77,3,5,8.0,1.0,92.0,176
1414,56,30,86,3,6,8.0,1.0,92.0,176
1415,31,50,81,3,7,8.0,1.0,92.0,176
1416,10,57,67,1,0,8.0,1.0,92.0,177
1417,65,5,70,1,1,8.0,1.0,92.0,177
1418,51,6,57,2,2,8.0,1.0,92.0,177
1419,14,44,58,2,3,8.0,1.0,92.0,177
1420,14,61,75,3,4,8.0,1.0,92.0,177
1421,22,37,59,3,5,8.0,1.0,92.0,177
1422,-8,31,23,3,6,8.0,1.0,92.0,177
1423,30,32,62,3,7,8.0,1.0,92.0,177
1424,-7,96,89,1,0,8.0,1.0,92.0,178
1425,-9,93,84,1,1,8.0,1.0,92.0,178
1426,27,9,36,2,2,8.0,1.0,92.0,178
1427,12,65,77,2,3,8.0,1.0,92.0,178
1428,-16,87,71,3,4,8.0,1.0,92.0,178
1429,53,19,72,3,5,8.0,1.0,92.0,178
1430,-19,83,64,3,6,8.0,1.0,92.0,178
1431,1,20,21,3,7,8.0,1.0,92.0,178
1432,9,91,100,1,0,8.0,1.0,92.0,179
1433,6,94,100,1,1,8.0,1.0,92.0,179
1434,78,5,83,2,2,8.0,1.0,92.0,179
1435,74,16,90,2,3,8.0,1.0,92.0,179
1436,71,20,91,3,4,8.0,1.0,92.0,179
1437,54,46,100,3,5,8.0,1.0,92.0,179
1438,23,77,100,3,6,8.0,1.0,92.0,179
1439,85,0,85,3,7,8.0,1.0,92.0,179
1440,25,50,75,1,0,9.0,1.0,91.0,180
1441,-4,93,89,1,1,9.0,1.0,91.0,180
1442,31,4,35,2,2,9.0,1.0,91.0,180
1443,72,7,79,2,3,9.0,1.0,91.0,180
1444,0,50,50,3,4,9.0,1.0,91.0,180
1445,15,50,65,3,5,9.0,1.0,91.0,180
1446,-6,11,5,3,6,9.0,1.0,91.0,180
1447,20,4,24,3,7,9.0,1.0,91.0,180
1448,22,51,73,1,0,9.0,1.0,91.0,181
1449,25,50,75,1,1,9.0,1.0,91.0,181
1450,0,50,50,2,2,9.0,1.0,91.0,181
1451,50,0,50,2,3,9.0,1.0,91.0,181
1452,12,50,62,3,4,9.0,1.0,91.0,181
1453,3,50,53,3,5,9.0,1.0,91.0,181
1454,18,50,68,3,6,9.0,1.0,91.0,181
1455,55,0,55,3,7,9.0,1.0,91.0,181
1456,11,89,100,1,0,9.0,1.0,91.0,182
1457,0,100,100,1,1,9.0,1.0,91.0,182
1458,99,1,100,2,2,9.0,1.0,91.0,182
1459,93,7,100,2,3,9.0,1.0,91.0,182
1460,31,69,100,3,4,9.0,1.0,91.0,182
1461,37,63,100,3,5,9.0,1.0,91.0,182
1462,-38,38,0,3,6,9.0,1.0,91.0,182
1463,63,37,100,3,7,9.0,1.0,91.0,182
1464,36,64,100,1,0,9.0,1.0,91.0,183
1465,0,100,100,1,1,9.0,1.0,91.0,183
1466,100,0,100,2,2,9.0,1.0,91.0,183
1467,100,0,100,2,3,9.0,1.0,91.0,183
1468,57,43,100,3,4,9.0,1.0,91.0,183
1469,50,50,100,3,5,9.0,1.0,91.0,183
1470,50,50,100,3,6,9.0,1.0,91.0,183
1471,88,12,100,3,7,9.0,1.0,91.0,183
1472,54,42,96,1,0,9.0,1.0,91.0,184
1473,0,100,100,1,1,9.0,1.0,91.0,184
1474,55,33,88,2,2,9.0,1.0,91.0,184
1475,78,9,87,2,3,9.0,1.0,91.0,184
1476,13,87,100,3,4,9.0,1.0,91.0,184
1477,40,60,100,3,5,9.0,1.0,91.0,184
1478,5,95,100,3,6,9.0,1.0,91.0,184
1479,43,42,85,3,7,9.0,1.0,91.0,184
1480,12,88,100,1,0,9.0,1.0,91.0,185
1481,0,100,100,1,1,9.0,1.0,91.0,185
1482,92,8,100,2,2,9.0,1.0,91.0,185
1483,0,100,100,2,3,9.0,1.0,91.0,185
1484,68,32,100,3,4,9.0,1.0,91.0,185
1485,0,100,100,3,5,9.0,1.0,91.0,185
1486,81,19,100,3,6,9.0,1.0,91.0,185
1487,97,3,100,3,7,9.0,1.0,91.0,185
1488,0,100,100,1,0,9.0,1.0,91.0,186
1489,0,100,100,1,1,9.0,1.0,91.0,186
1490,100,0,100,2,2,9.0,1.0,91.0,186
1491,0,0,0,2,3,9.0,1.0,91.0,186
1492,22,78,100,3,4,9.0,1.0,91.0,186
1493,50,50,100,3,5,9.0,1.0,91.0,186
1494,5,95,100,3,6,9.0,1.0,91.0,186
1495,100,0,100,3,7,9.0,1.0,91.0,186
1496,-4,95,91,1,0,9.0,1.0,91.0,187
1497,0,0,0,1,1,9.0,1.0,91.0,187
1498,0,50,50,2,2,9.0,1.0,91.0,187
1499,0,100,100,2,3,9.0,1.0,91.0,187
1500,0,50,50,3,4,9.0,1.0,91.0,187
1501,0,38,38,3,5,9.0,1.0,91.0,187
1502,0,89,89,3,6,9.0,1.0,91.0,187
1503,14,50,64,3,7,9.0,1.0,91.0,187
1504,4,96,100,1,0,9.0,1.0,91.0,188
1505,29,71,100,1,1,9.0,1.0,91.0,188
1506,42,50,92,2,2,9.0,1.0,91.0,188
1507,66,33,99,2,3,9.0,1.0,91.0,188
1508,8,92,100,3,4,9.0,1.0,91.0,188
1509,-12,44,32,3,5,9.0,1.0,91.0,188
1510,0,0,0,3,6,9.0,1.0,91.0,188
1511,-6,6,0,3,7,9.0,1.0,91.0,188
1512,3,72,75,1,0,9.0,1.0,91.0,189
1513,100,0,100,1,1,9.0,1.0,91.0,189
1514,0,0,0,2,2,9.0,1.0,91.0,189
1515,52,0,52,2,3,9.0,1.0,91.0,189
1516,-9,60,51,3,4,9.0,1.0,91.0,189
1517,1,50,51,3,5,9.0,1.0,91.0,189
1518,41,51,92,3,6,9.0,1.0,91.0,189
1519,0,0,0,3,7,9.0,1.0,91.0,189
1520,-1,50,49,1,0,9.0,1.0,91.0,190
1521,0,0,0,1,1,9.0,1.0,91.0,190
1522,0,50,50,2,2,9.0,1.0,91.0,190
1523,-19,34,15,2,3,9.0,1.0,91.0,190
1524,11,44,55,3,4,9.0,1.0,91.0,190
1525,42,35,77,3,5,9.0,1.0,91.0,190
1526,-4,21,17,3,6,9.0,1.0,91.0,190
1527,0,0,0,3,7,9.0,1.0,91.0,190
1528,43,57,100,1,0,9.0,1.0,91.0,191
1529,0,100,100,1,1,9.0,1.0,91.0,191
1530,40,39,79,2,2,9.0,1.0,91.0,191
1531,78,0,78,2,3,9.0,1.0,91.0,191
1532,45,42,87,3,4,9.0,1.0,91.0,191
1533,66,22,88,3,5,9.0,1.0,91.0,191
1534,55,45,100,3,6,9.0,1.0,91.0,191
1535,38,62,100,3,7,9.0,1.0,91.0,191
1536,35,50,85,1,0,9.0,1.0,91.0,192
1537,45,50,95,1,1,9.0,1.0,91.0,192
1538,62,0,62,2,2,9.0,1.0,91.0,192
1539,88,0,88,2,3,9.0,1.0,91.0,192
1540,40,60,100,3,4,9.0,1.0,91.0,192
1541,97,0,97,3,5,9.0,1.0,91.0,192
1542,24,76,100,3,6,9.0,1.0,91.0,192
1543,99,0,99,3,7,9.0,1.0,91.0,192
1544,5,91,96,1,0,9.0,1.0,91.0,193
1545,97,1,98,1,1,9.0,1.0,91.0,193
1546,64,0,64,2,2,9.0,1.0,91.0,193
1547,84,11,95,2,3,9.0,1.0,91.0,193
1548,-2,87,85,3,4,9.0,1.0,91.0,193
1549,32,35,67,3,5,9.0,1.0,91.0,193
1550,90,6,96,3,6,9.0,1.0,91.0,193
1551,41,50,91,3,7,9.0,1.0,91.0,193
1552,8,65,73,1,0,9.0,1.0,91.0,194
1553,-1,3,2,1,1,9.0,1.0,91.0,194
1554,28,0,28,2,2,9.0,1.0,91.0,194
1555,8,6,14,2,3,9.0,1.0,91.0,194
1556,25,75,100,3,4,9.0,1.0,91.0,194
1557,36,64,100,3,5,9.0,1.0,91.0,194
1558,35,51,86,3,6,9.0,1.0,91.0,194
1559,-2,6,4,3,7,9.0,1.0,91.0,194
1560,100,0,100,1,0,9.0,1.0,91.0,195
1561,0,100,100,1,1,9.0,1.0,91.0,195
1562,0,0,0,2,2,9.0,1.0,91.0,195
1563,0,0,0,2,3,9.0,1.0,91.0,195
1564,0,50,50,3,4,9.0,1.0,91.0,195
1565,50,0,50,3,5,9.0,1.0,91.0,195
1566,-50,50,0,3,6,9.0,1.0,91.0,195
1567,0,0,0,3,7,9.0,1.0,91.0,195
1568,-1,2,1,1,0,9.0,1.0,91.0,196
1569,-98,98,0,1,1,9.0,1.0,91.0,196
1570,99,0,99,2,2,9.0,1.0,91.0,196
1571,0,0,0,2,3,9.0,1.0,91.0,196
1572,95,0,95,3,4,9.0,1.0,91.0,196
1573,97,2,99,3,5,9.0,1.0,91.0,196
1574,0,100,100,3,6,9.0,1.0,91.0,196
1575,-1,1,0,3,7,9.0,1.0,91.0,196
1576,36,42,78,1,0,9.0,1.0,91.0,197
1577,-1,1,0,1,1,9.0,1.0,91.0,197
1578,-17,34,17,2,2,9.0,1.0,91.0,197
1579,9,55,64,2,3,9.0,1.0,91.0,197
1580,1,42,43,3,4,9.0,1.0,91.0,197
1581,-3,47,44,3,5,9.0,1.0,91.0,197
1582,26,0,26,3,6,9.0,1.0,91.0,197
1583,-3,45,42,3,7,9.0,1.0,91.0,197
1584,1,94,95,1,0,10.0,1.0,90.0,198
1585,24,13,37,1,1,10.0,1.0,90.0,198
1586,-55,96,41,2,2,10.0,1.0,90.0,198
1587,-87,93,6,2,3,10.0,1.0,90.0,198
1588,-17,83,66,3,4,10.0,1.0,90.0,198
1589,-45,86,41,3,5,10.0,1.0,90.0,198
1590,-87,99,12,3,6,10.0,1.0,90.0,198
1591,-63,77,14,3,7,10.0,1.0,90.0,198
1592,0,50,50,1,0,10.0,1.0,90.0,199
1593,-5,30,25,1,1,10.0,1.0,90.0,199
1594,-11,25,14,2,2,10.0,1.0,90.0,199
1595,1,9,10,2,3,10.0,1.0,90.0,199
1596,1,28,29,3,4,10.0,1.0,90.0,199
1597,-1,51,50,3,5,10.0,1.0,90.0,199
1598,-7,22,15,3,6,10.0,1.0,90.0,199
1599,19,31,50,3,7,10.0,1.0,90.0,199
1600,-6,90,84,1,0,10.0,1.0,90.0,200
1601,0,100,100,1,1,10.0,1.0,90.0,200
1602,-18,54,36,2,2,10.0,1.0,90.0,200
1603,15,30,45,2,3,10.0,1.0,90.0,200
1604,14,77,91,3,4,10.0,1.0,90.0,200
1605,-11,47,36,3,5,10.0,1.0,90.0,200
1606,67,22,89,3,6,10.0,1.0,90.0,200
1607,-9,62,53,3,7,10.0,1.0,90.0,200
1608,14,76,90,1,0,10.0,1.0,90.0,201
1609,0,100,100,1,1,10.0,1.0,90.0,201
1610,61,39,100,2,2,10.0,1.0,90.0,201
1611,-12,24,12,2,3,10.0,1.0,90.0,201
1612,25,64,89,3,4,10.0,1.0,90.0,201
1613,49,50,99,3,5,10.0,1.0,90.0,201
1614,35,65,100,3,6,10.0,1.0,90.0,201
1615,77,12,89,3,7,10.0,1.0,90.0,201
1616,22,78,100,1,0,10.0,1.0,90.0,202
1617,21,79,100,1,1,10.0,1.0,90.0,202
1618,7,0,7,2,2,10.0,1.0,90.0,202
1619,-61,84,23,2,3,10.0,1.0,90.0,202
1620,0,100,100,3,4,10.0,1.0,90.0,202
1621,100,0,100,3,5,10.0,1.0,90.0,202
1622,11,89,100,3,6,10.0,1.0,90.0,202
1623,0,0,0,3,7,10.0,1.0,90.0,202
1624,0,100,100,1,0,10.0,1.0,90.0,203
1625,0,100,100,1,1,10.0,1.0,90.0,203
1626,0,0,0,2,2,10.0,1.0,90.0,203
1627,50,0,50,2,3,10.0,1.0,90.0,203
1628,0,100,100,3,4,10.0,1.0,90.0,203
1629,50,50,100,3,5,10.0,1.0,90.0,203
1630,0,100,100,3,6,10.0,1.0,90.0,203
1631,0,0,0,3,7,10.0,1.0,90.0,203
1632,13,50,63,1,0,10.0,1.0,90.0,204
1633,-11,77,66,1,1,10.0,1.0,90.0,204
1634,-17,50,33,2,2,10.0,1.0,90.0,204
1635,22,28,50,2,3,10.0,1.0,90.0,204
1636,-2,74,72,3,4,10.0,1.0,90.0,204
1637,36,32,68,3,5,10.0,1.0,90.0,204
1638,-5,67,62,3,6,10.0,1.0,90.0,204
1639,32,0,32,3,7,10.0,1.0,90.0,204
1640,-57,95,38,1,0,10.0,1.0,90.0,205
1641,-10,100,90,1,1,10.0,1.0,90.0,205
1642,-1,9,8,2,2,10.0,1.0,90.0,205
1643,19,42,61,2,3,10.0,1.0,90.0,205
1644,-6,42,36,3,4,10.0,1.0,90.0,205
1645,34,32,66,3,5,10.0,1.0,90.0,205
1646,29,68,97,3,6,10.0,1.0,90.0,205
1647,-14,27,13,3,7,10.0,1.0,90.0,205
1648,-12,84,72,1,0,10.0,1.0,90.0,206
1649,1,51,52,1,1,10.0,1.0,90.0,206
1650,4,64,68,2,2,10.0,1.0,90.0,206
1651,-13,33,20,2,3,10.0,1.0,90.0,206
1652,-3,70,67,3,4,10.0,1.0,90.0,206
1653,-5,83,78,3,5,10.0,1.0,90.0,206
1654,0,100,100,3,6,10.0,1.0,90.0,206
1655,12,18,30,3,7,10.0,1.0,90.0,206
1656,3,50,53,1,0,10.0,1.0,90.0,207
1657,0,100,100,1,1,10.0,1.0,90.0,207
1658,5,0,5,2,2,10.0,1.0,90.0,207
1659,9,5,14,2,3,10.0,1.0,90.0,207
1660,2,50,52,3,4,10.0,1.0,90.0,207
1661,6,0,6,3,5,10.0,1.0,90.0,207
1662,-6,13,7,3,6,10.0,1.0,90.0,207
1663,-91,100,9,3,7,10.0,1.0,90.0,207
1664,31,50,81,1,0,10.0,1.0,90.0,208
1665,6,75,81,1,1,10.0,1.0,90.0,208
1666,43,30,73,2,2,10.0,1.0,90.0,208
1667,9,72,81,2,3,10.0,1.0,90.0,208
1668,72,8,80,3,4,10.0,1.0,90.0,208
1669,21,49,70,3,5,10.0,1.0,90.0,208
1670,39,35,74,3,6,10.0,1.0,90.0,208
1671,18,51,69,3,7,10.0,1.0,90.0,208
1672,57,22,79,1,0,10.0,1.0,90.0,209
1673,-5,65,60,1,1,10.0,1.0,90.0,209
1674,-12,28,16,2,2,10.0,1.0,90.0,209
1675,3,66,69,2,3,10.0,1.0,90.0,209
1676,-10,19,9,3,4,10.0,1.0,90.0,209
1677,60,26,86,3,5,10.0,1.0,90.0,209
1678,7,79,86,3,6,10.0,1.0,90.0,209
1679,69,26,95,3,7,10.0,1.0,90.0,209
1680,50,50,100,1,0,10.0,1.0,90.0,210
1681,4,96,100,1,1,10.0,1.0,90.0,210
1682,99,1,100,2,2,10.0,1.0,90.0,210
1683,100,0,100,2,3,10.0,1.0,90.0,210
1684,50,50,100,3,4,10.0,1.0,90.0,210
1685,100,0,100,3,5,10.0,1.0,90.0,210
1686,98,2,100,3,6,10.0,1.0,90.0,210
1687,100,0,100,3,7,10.0,1.0,90.0,210
1688,-4,13,9,1,0,10.0,1.0,90.0,211
1689,48,22,70,1,1,10.0,1.0,90.0,211
1690,1,0,1,2,2,10.0,1.0,90.0,211
1691,0,0,0,2,3,10.0,1.0,90.0,211
1692,18,58,76,3,4,10.0,1.0,90.0,211
1693,44,6,50,3,5,10.0,1.0,90.0,211
1694,0,50,50,3,6,10.0,1.0,90.0,211
1695,2,0,2,3,7,10.0,1.0,90.0,211
1696,0,100,100,1,0,10.0,1.0,90.0,212
1697,100,0,100,1,1,10.0,1.0,90.0,212
1698,100,0,100,2,2,10.0,1.0,90.0,212
1699,-10,10,0,2,3,10.0,1.0,90.0,212
1700,25,50,75,3,4,10.0,1.0,90.0,212
1701,50,50,100,3,5,10.0,1.0,90.0,212
1702,70,30,100,3,6,10.0,1.0,90.0,212
1703,50,50,100,3,7,10.0,1.0,90.0,212
1704,3,82,85,1,0,10.0,1.0,90.0,213
1705,10,80,90,1,1,10.0,1.0,90.0,213
1706,35,5,40,2,2,10.0,1.0,90.0,213
1707,40,25,65,2,3,10.0,1.0,90.0,213
1708,25,70,95,3,4,10.0,1.0,90.0,213
1709,45,40,85,3,5,10.0,1.0,90.0,213
1710,9,90,99,3,6,10.0,1.0,90.0,213
1711,65,5,70,3,7,10.0,1.0,90.0,213
1712,47,53,100,1,0,10.0,1.0,90.0,214
1713,0,95,95,1,1,10.0,1.0,90.0,214
1714,14,10,24,2,2,10.0,1.0,90.0,214
1715,-10,25,15,2,3,10.0,1.0,90.0,214
1716,19,80,99,3,4,10.0,1.0,90.0,214
1717,80,15,95,3,5,10.0,1.0,90.0,214
1718,15,10,25,3,6,10.0,1.0,90.0,214
1719,61,10,71,3,7,10.0,1.0,90.0,214
1720,0,75,75,1,0,10.0,1.0,90.0,215
1721,-10,77,67,1,1,10.0,1.0,90.0,215
1722,0,0,0,2,2,10.0,1.0,90.0,215
1723,5,60,65,2,3,10.0,1.0,90.0,215
1724,-9,70,61,3,4,10.0,1.0,90.0,215
1725,-5,50,45,3,5,10.0,1.0,90.0,215
1726,-15,60,45,3,6,10.0,1.0,90.0,215
1727,15,25,40,3,7,10.0,1.0,90.0,215
1728,62,38,100,1,0,10.0,1.0,90.0,216
1729,47,53,100,1,1,10.0,1.0,90.0,216
1730,69,31,100,2,2,10.0,1.0,90.0,216
1731,81,19,100,2,3,10.0,1.0,90.0,216
1732,50,50,100,3,4,10.0,1.0,90.0,216
1733,77,23,100,3,5,10.0,1.0,90.0,216
1734,35,65,100,3,6,10.0,1.0,90.0,216
1735,62,38,100,3,7,10.0,1.0,90.0,216
1736,0,100,100,1,0,11.0,1.0,89.0,217
1737,0,100,100,1,1,11.0,1.0,89.0,217
1738,100,0,100,2,2,11.0,1.0,89.0,217
1739,100,0,100,2,3,11.0,1.0,89.0,217
1740,21,79,100,3,4,11.0,1.0,89.0,217
1741,62,38,100,3,5,11.0,1.0,89.0,217
1742,4,96,100,3,6,11.0,1.0,89.0,217
1743,-10,10,0,3,7,11.0,1.0,89.0,217
1744,7,93,100,1,0,11.0,1.0,89.0,218
1745,0,100,100,1,1,11.0,1.0,89.0,218
1746,51,0,51,2,2,11.0,1.0,89.0,218
1747,6,94,100,2,3,11.0,1.0,89.0,218
1748,41,59,100,3,4,11.0,1.0,89.0,218
1749,49,51,100,3,5,11.0,1.0,89.0,218
1750,34,66,100,3,6,11.0,1.0,89.0,218
1751,44,48,92,3,7,11.0,1.0,89.0,218
1752,52,48,100,1,0,11.0,1.0,89.0,219
1753,50,50,100,1,1,11.0,1.0,89.0,219
1754,-35,50,15,2,2,11.0,1.0,89.0,219
1755,66,34,100,2,3,11.0,1.0,89.0,219
1756,50,50,100,3,4,11.0,1.0,89.0,219
1757,62,38,100,3,5,11.0,1.0,89.0,219
1758,71,29,100,3,6,11.0,1.0,89.0,219
1759,96,4,100,3,7,11.0,1.0,89.0,219
1760,1,77,78,1,0,11.0,1.0,89.0,220
1761,0,100,100,1,1,11.0,1.0,89.0,220
1762,12,0,12,2,2,11.0,1.0,89.0,220
1763,-10,82,72,2,3,11.0,1.0,89.0,220
1764,36,50,86,3,4,11.0,1.0,89.0,220
1765,50,0,50,3,5,11.0,1.0,89.0,220
1766,8,92,100,3,6,11.0,1.0,89.0,220
1767,10,0,10,3,7,11.0,1.0,89.0,220
1768,-72,98,26,1,0,11.0,1.0,89.0,221
1769,-4,34,30,1,1,11.0,1.0,89.0,221
1770,-11,95,84,2,2,11.0,1.0,89.0,221
1771,0,50,50,2,3,11.0,1.0,89.0,221
1772,2,90,92,3,4,11.0,1.0,89.0,221
1773,-24,90,66,3,5,11.0,1.0,89.0,221
1774,-11,88,77,3,6,11.0,1.0,89.0,221
1775,-70,100,30,3,7,11.0,1.0,89.0,221
1776,10,90,100,1,0,11.0,1.0,89.0,222
1777,11,89,100,1,1,11.0,1.0,89.0,222
1778,1,22,23,2,2,11.0,1.0,89.0,222
1779,10,3,13,2,3,11.0,1.0,89.0,222
1780,9,91,100,3,4,11.0,1.0,89.0,222
1781,18,50,68,3,5,11.0,1.0,89.0,222
1782,-67,77,10,3,6,11.0,1.0,89.0,222
1783,50,38,88,3,7,11.0,1.0,89.0,222
1784,5,95,100,1,0,11.0,1.0,89.0,223
1785,18,78,96,1,1,11.0,1.0,89.0,223
1786,51,21,72,2,2,11.0,1.0,89.0,223
1787,73,13,86,2,3,11.0,1.0,89.0,223
1788,12,87,99,3,4,11.0,1.0,89.0,223
1789,74,18,92,3,5,11.0,1.0,89.0,223
1790,-6,19,13,3,6,11.0,1.0,89.0,223
1791,19,68,87,3,7,11.0,1.0,89.0,223
1792,13,70,83,1,0,11.0,1.0,89.0,224
1793,20,38,58,1,1,11.0,1.0,89.0,224
1794,2,14,16,2,2,11.0,1.0,89.0,224
1795,-7,40,33,2,3,11.0,1.0,89.0,224
1796,5,64,69,3,4,11.0,1.0,89.0,224
1797,2,31,33,3,5,11.0,1.0,89.0,224
1798,48,37,85,3,6,11.0,1.0,89.0,224
1799,1,27,28,3,7,11.0,1.0,89.0,224
1800,-5,100,95,1,0,11.0,1.0,89.0,225
1801,0,100,100,1,1,11.0,1.0,89.0,225
1802,40,40,80,2,2,11.0,1.0,89.0,225
1803,61,15,76,2,3,11.0,1.0,89.0,225
1804,10,76,86,3,4,11.0,1.0,89.0,225
1805,50,33,83,3,5,11.0,1.0,89.0,225
1806,15,77,92,3,6,11.0,1.0,89.0,225
1807,62,23,85,3,7,11.0,1.0,89.0,225
1808,19,73,92,1,0,11.0,1.0,89.0,226
1809,27,66,93,1,1,11.0,1.0,89.0,226
1810,11,39,50,2,2,11.0,1.0,89.0,226
1811,-1,34,33,2,3,11.0,1.0,89.0,226
1812,56,21,77,3,4,11.0,1.0,89.0,226
1813,50,50,100,3,5,11.0,1.0,89.0,226
1814,62,29,91,3,6,11.0,1.0,89.0,226
1815,49,24,73,3,7,11.0,1.0,89.0,226
1816,64,36,100,1,0,11.0,1.0,89.0,227
1817,89,11,100,1,1,11.0,1.0,89.0,227
1818,74,5,79,2,2,11.0,1.0,89.0,227
1819,12,88,100,2,3,11.0,1.0,89.0,227
1820,7,93,100,3,4,11.0,1.0,89.0,227
1821,94,6,100,3,5,11.0,1.0,89.0,227
1822,80,20,100,3,6,11.0,1.0,89.0,227
1823,92,8,100,3,7,11.0,1.0,89.0,227
1824,22,58,80,1,0,11.0,1.0,89.0,228
1825,9,81,90,1,1,11.0,1.0,89.0,228
1826,52,3,55,2,2,11.0,1.0,89.0,228
1827,12,13,25,2,3,11.0,1.0,89.0,228
1828,-1,89,88,3,4,11.0,1.0,89.0,228
1829,79,9,88,3,5,11.0,1.0,89.0,228
1830,-4,90,86,3,6,11.0,1.0,89.0,228
1831,24,56,80,3,7,11.0,1.0,89.0,228
1832,59,41,100,1,0,11.0,1.0,89.0,229
1833,20,80,100,1,1,11.0,1.0,89.0,229
1834,57,25,82,2,2,11.0,1.0,89.0,229
1835,100,0,100,2,3,11.0,1.0,89.0,229
1836,100,0,100,3,4,11.0,1.0,89.0,229
1837,23,0,23,3,5,11.0,1.0,89.0,229
1838,0,100,100,3,6,11.0,1.0,89.0,229
1839,0,0,0,3,7,11.0,1.0,89.0,229
1840,3,70,73,1,0,11.0,1.0,89.0,230
1841,42,31,73,1,1,11.0,1.0,89.0,230
1842,40,27,67,2,2,11.0,1.0,89.0,230
1843,51,17,68,2,3,11.0,1.0,89.0,230
1844,-3,74,71,3,4,11.0,1.0,89.0,230
1845,20,50,70,3,5,11.0,1.0,89.0,230
1846,52,17,69,3,6,11.0,1.0,89.0,230
1847,30,33,63,3,7,11.0,1.0,89.0,230
1848,23,0,23,1,0,11.0,1.0,89.0,231
1849,6,0,6,1,1,11.0,1.0,89.0,231
1850,-68,79,11,2,2,11.0,1.0,89.0,231
1851,-2,17,15,2,3,11.0,1.0,89.0,231
1852,1,10,11,3,4,11.0,1.0,89.0,231
1853,0,0,0,3,5,11.0,1.0,89.0,231
1854,-100,100,0,3,6,11.0,1.0,89.0,231
1855,9,0,9,3,7,11.0,1.0,89.0,231
1856,-5,98,93,1,0,12.0,1.0,88.0,232
1857,0,81,81,1,1,12.0,1.0,88.0,232
1858,46,20,66,2,2,12.0,1.0,88.0,232
1859,0,0,0,2,3,12.0,1.0,88.0,232
1860,12,65,77,3,4,12.0,1.0,88.0,232
1861,-7,38,31,3,5,12.0,1.0,88.0,232
1862,-2,92,90,3,6,12.0,1.0,88.0,232
1863,13,25,38,3,7,12.0,1.0,88.0,232
1864,-5,42,37,1,0,12.0,1.0,88.0,233
1865,52,35,87,1,1,12.0,1.0,88.0,233
1866,43,41,84,2,2,12.0,1.0,88.0,233
1867,49,27,76,2,3,12.0,1.0,88.0,233
1868,20,65,85,3,4,12.0,1.0,88.0,233
1869,75,11,86,3,5,12.0,1.0,88.0,233
1870,48,39,87,3,6,12.0,1.0,88.0,233
1871,33,42,75,3,7,12.0,1.0,88.0,233
1872,0,100,100,1,0,12.0,1.0,88.0,234
1873,0,100,100,1,1,12.0,1.0,88.0,234
1874,0,0,0,2,2,12.0,1.0,88.0,234
1875,0,0,0,2,3,12.0,1.0,88.0,234
1876,-2,95,93,3,4,12.0,1.0,88.0,234
1877,0,0,0,3,5,12.0,1.0,88.0,234
1878,0,50,50,3,6,12.0,1.0,88.0,234
1879,24,0,24,3,7,12.0,1.0,88.0,234
1880,1,99,100,1,0,12.0,1.0,88.0,235
1881,0,100,100,1,1,12.0,1.0,88.0,235
1882,0,0,0,2,2,12.0,1.0,88.0,235
1883,42,3,45,2,3,12.0,1.0,88.0,235
1884,28,64,92,3,4,12.0,1.0,88.0,235
1885,0,50,50,3,5,12.0,1.0,88.0,235
1886,8,4,12,3,6,12.0,1.0,88.0,235
1887,20,80,100,3,7,12.0,1.0,88.0,235
1888,6,77,83,1,0,12.0,1.0,88.0,236
1889,52,30,82,1,1,12.0,1.0,88.0,236
1890,7,27,34,2,2,12.0,1.0,88.0,236
1891,28,41,69,2,3,12.0,1.0,88.0,236
1892,15,50,65,3,4,12.0,1.0,88.0,236
1893,41,37,78,3,5,12.0,1.0,88.0,236
1894,24,50,74,3,6,12.0,1.0,88.0,236
1895,3,33,36,3,7,12.0,1.0,88.0,236
1896,-26,89,63,1,0,12.0,1.0,88.0,237
1897,-29,88,59,1,1,12.0,1.0,88.0,237
1898,4,35,39,2,2,12.0,1.0,88.0,237
1899,-18,57,39,2,3,12.0,1.0,88.0,237
1900,10,59,69,3,4,12.0,1.0,88.0,237
1901,15,59,74,3,5,12.0,1.0,88.0,237
1902,11,30,41,3,6,12.0,1.0,88.0,237
1903,-5,28,23,3,7,12.0,1.0,88.0,237
1904,-13,76,63,1,0,12.0,1.0,88.0,238
1905,-48,75,27,1,1,12.0,1.0,88.0,238
1906,-6,35,29,2,2,12.0,1.0,88.0,238
1907,1,28,29,2,3,12.0,1.0,88.0,238
1908,35,29,64,3,4,12.0,1.0,88.0,238
1909,35,37,72,3,5,12.0,1.0,88.0,238
1910,-19,49,30,3,6,12.0,1.0,88.0,238
1911,-1,35,34,3,7,12.0,1.0,88.0,238
1912,-32,90,58,1,0,12.0,1.0,88.0,239
1913,0,0,0,1,1,12.0,1.0,88.0,239
1914,13,11,24,2,2,12.0,1.0,88.0,239
1915,55,45,100,2,3,12.0,1.0,88.0,239
1916,34,5,39,3,4,12.0,1.0,88.0,239
1917,26,9,35,3,5,12.0,1.0,88.0,239
1918,79,11,90,3,6,12.0,1.0,88.0,239
1919,49,38,87,3,7,12.0,1.0,88.0,239
1920,11,14,25,1,0,12.0,1.0,88.0,240
1921,-61,66,5,1,1,12.0,1.0,88.0,240
1922,-14,83,69,2,2,12.0,1.0,88.0,240
1923,-1,39,38,2,3,12.0,1.0,88.0,240
1924,-2,27,25,3,4,12.0,1.0,88.0,240
1925,4,58,62,3,5,12.0,1.0,88.0,240
1926,-31,48,17,3,6,12.0,1.0,88.0,240
1927,-6,24,18,3,7,12.0,1.0,88.0,240
1928,21,79,100,1,0,13.0,1.0,87.0,241
1929,0,100,100,1,1,13.0,1.0,87.0,241
1930,-7,18,11,2,2,13.0,1.0,87.0,241
1931,14,0,14,2,3,13.0,1.0,87.0,241
1932,-2,26,24,3,4,13.0,1.0,87.0,241
1933,-23,35,12,3,5,13.0,1.0,87.0,241
1934,73,27,100,3,6,13.0,1.0,87.0,241
1935,11,75,86,3,7,13.0,1.0,87.0,241
1936,-27,92,65,1,0,13.0,1.0,87.0,242
1937,-5,100,95,1,1,13.0,1.0,87.0,242
1938,3,14,17,2,2,13.0,1.0,87.0,242
1939,-100,100,0,2,3,13.0,1.0,87.0,242
1940,0,78,78,3,4,13.0,1.0,87.0,242
1941,26,0,26,3,5,13.0,1.0,87.0,242
1942,-9,100,91,3,6,13.0,1.0,87.0,242
1943,1,0,1,3,7,13.0,1.0,87.0,242
1944,32,68,100,1,0,13.0,1.0,87.0,243
1945,22,78,100,1,1,13.0,1.0,87.0,243
1946,39,61,100,2,2,13.0,1.0,87.0,243
1947,40,60,100,2,3,13.0,1.0,87.0,243
1948,39,61,100,3,4,13.0,1.0,87.0,243
1949,38,62,100,3,5,13.0,1.0,87.0,243
1950,69,31,100,3,6,13.0,1.0,87.0,243
1951,86,14,100,3,7,13.0,1.0,87.0,243
1952,-50,100,50,1,0,13.0,1.0,87.0,244
1953,22,0,22,1,1,13.0,1.0,87.0,244
1954,50,0,50,2,2,13.0,1.0,87.0,244
1955,50,0,50,2,3,13.0,1.0,87.0,244
1956,12,38,50,3,4,13.0,1.0,87.0,244
1957,28,22,50,3,5,13.0,1.0,87.0,244
1958,-16,38,22,3,6,13.0,1.0,87.0,244
1959,43,0,43,3,7,13.0,1.0,87.0,244
1960,0,100,100,1,0,13.0,1.0,87.0,245
1961,46,42,88,1,1,13.0,1.0,87.0,245
1962,57,30,87,2,2,13.0,1.0,87.0,245
1963,68,23,91,2,3,13.0,1.0,87.0,245
1964,1,83,84,3,4,13.0,1.0,87.0,245
1965,81,19,100,3,5,13.0,1.0,87.0,245
1966,68,32,100,3,6,13.0,1.0,87.0,245
1967,33,44,77,3,7,13.0,1.0,87.0,245
1968,50,50,100,1,0,13.0,1.0,87.0,246
1969,88,12,100,1,1,13.0,1.0,87.0,246
1970,13,50,63,2,2,13.0,1.0,87.0,246
1971,-6,6,0,2,3,13.0,1.0,87.0,246
1972,25,75,100,3,4,13.0,1.0,87.0,246
1973,64,34,98,3,5,13.0,1.0,87.0,246
1974,52,35,87,3,6,13.0,1.0,87.0,246
1975,87,13,100,3,7,13.0,1.0,87.0,246
1976,26,50,76,1,0,13.0,1.0,87.0,247
1977,-10,43,33,1,1,13.0,1.0,87.0,247
1978,20,48,68,2,2,13.0,1.0,87.0,247
1979,31,12,43,2,3,13.0,1.0,87.0,247
1980,23,50,73,3,4,13.0,1.0,87.0,247
1981,0,50,50,3,5,13.0,1.0,87.0,247
1982,50,25,75,3,6,13.0,1.0,87.0,247
1983,21,50,71,3,7,13.0,1.0,87.0,247
1984,-4,57,53,1,0,13.0,1.0,87.0,248
1985,-34,66,32,1,1,13.0,1.0,87.0,248
1986,-3,20,17,2,2,13.0,1.0,87.0,248
1987,-5,5,0,2,3,13.0,1.0,87.0,248
1988,20,57,77,3,4,13.0,1.0,87.0,248
1989,22,17,39,3,5,13.0,1.0,87.0,248
1990,-10,41,31,3,6,13.0,1.0,87.0,248
1991,8,3,11,3,7,13.0,1.0,87.0,248
1992,12,50,62,1,0,13.0,1.0,87.0,249
1993,3,68,71,1,1,13.0,1.0,87.0,249
1994,3,30,33,2,2,13.0,1.0,87.0,249
1995,0,0,0,2,3,13.0,1.0,87.0,249
1996,3,55,58,3,4,13.0,1.0,87.0,249
1997,16,17,33,3,5,13.0,1.0,87.0,249
1998,5,60,65,3,6,13.0,1.0,87.0,249
1999,-3,3,0,3,7,13.0,1.0,87.0,249
2000,14,86,100,1,0,14.0,1.0,86.0,250
2001,0,100,100,1,1,14.0,1.0,86.0,250
2002,0,0,0,2,2,14.0,1.0,86.0,250
2003,7,93,100,2,3,14.0,1.0,86.0,250
2004,41,59,100,3,4,14.0,1.0,86.0,250
2005,74,26,100,3,5,14.0,1.0,86.0,250
2006,83,17,100,3,6,14.0,1.0,86.0,250
2007,100,0,100,3,7,14.0,1.0,86.0,250
2008,-27,60,33,1,0,14.0,1.0,86.0,251
2009,-9,98,89,1,1,14.0,1.0,86.0,251
2010,5,24,29,2,2,14.0,1.0,86.0,251
2011,20,3,23,2,3,14.0,1.0,86.0,251
2012,-1,72,71,3,4,14.0,1.0,86.0,251
2013,-22,28,6,3,5,14.0,1.0,86.0,251
2014,13,71,84,3,6,14.0,1.0,86.0,251
2015,41,0,41,3,7,14.0,1.0,86.0,251
2016,11,81,92,1,0,14.0,1.0,86.0,252
2017,-9,98,89,1,1,14.0,1.0,86.0,252
2018,41,0,41,2,2,14.0,1.0,86.0,252
2019,73,8,81,2,3,14.0,1.0,86.0,252
2020,37,63,100,3,4,14.0,1.0,86.0,252
2021,19,62,81,3,5,14.0,1.0,86.0,252
2022,19,81,100,3,6,14.0,1.0,86.0,252
2023,-2,41,39,3,7,14.0,1.0,86.0,252
2024,27,73,100,1,0,14.0,1.0,86.0,253
2025,0,100,100,1,1,14.0,1.0,86.0,253
2026,51,49,100,2,2,14.0,1.0,86.0,253
2027,40,60,100,2,3,14.0,1.0,86.0,253
2028,20,80,100,3,4,14.0,1.0,86.0,253
2029,63,37,100,3,5,14.0,1.0,86.0,253
2030,4,96,100,3,6,14.0,1.0,86.0,253
2031,50,50,100,3,7,14.0,1.0,86.0,253
2032,5,68,73,1,0,14.0,1.0,86.0,254
2033,7,93,100,1,1,14.0,1.0,86.0,254
2034,-6,22,16,2,2,14.0,1.0,86.0,254
2035,26,65,91,2,3,14.0,1.0,86.0,254
2036,12,88,100,3,4,14.0,1.0,86.0,254
2037,8,13,21,3,5,14.0,1.0,86.0,254
2038,10,34,44,3,6,14.0,1.0,86.0,254
2039,14,0,14,3,7,14.0,1.0,86.0,254
2040,3,81,84,1,0,14.0,1.0,86.0,255
2041,16,61,77,1,1,14.0,1.0,86.0,255
2042,-1,73,72,2,2,14.0,1.0,86.0,255
2043,15,61,76,2,3,14.0,1.0,86.0,255
2044,39,37,76,3,4,14.0,1.0,86.0,255
2045,47,41,88,3,5,14.0,1.0,86.0,255
2046,34,61,95,3,6,14.0,1.0,86.0,255
2047,13,26,39,3,7,14.0,1.0,86.0,255
2048,38,62,100,1,0,14.0,1.0,86.0,256
2049,0,100,100,1,1,14.0,1.0,86.0,256
2050,-3,3,0,2,2,14.0,1.0,86.0,256
2051,-18,18,0,2,3,14.0,1.0,86.0,256
2052,26,74,100,3,4,14.0,1.0,86.0,256
2053,57,43,100,3,5,14.0,1.0,86.0,256
2054,35,65,100,3,6,14.0,1.0,86.0,256
2055,72,28,100,3,7,14.0,1.0,86.0,256
2056,50,50,100,1,0,14.0,1.0,86.0,257
2057,-67,67,0,1,1,14.0,1.0,86.0,257
2058,50,50,100,2,2,14.0,1.0,86.0,257
2059,50,50,100,2,3,14.0,1.0,86.0,257
2060,50,50,100,3,4,14.0,1.0,86.0,257
2061,50,50,100,3,5,14.0,1.0,86.0,257
2062,50,50,100,3,6,14.0,1.0,86.0,257
2063,50,50,100,3,7,14.0,1.0,86.0,257
2064,16,59,75,1,0,14.0,1.0,86.0,258
2065,14,59,73,1,1,14.0,1.0,86.0,258
2066,16,65,81,2,2,14.0,1.0,86.0,258
2067,0,100,100,2,3,14.0,1.0,86.0,258
2068,26,70,96,3,4,14.0,1.0,86.0,258
2069,46,10,56,3,5,14.0,1.0,86.0,258
2070,0,100,100,3,6,14.0,1.0,86.0,258
2071,-4,90,86,3,7,14.0,1.0,86.0,258
2072,28,48,76,1,0,14.0,1.0,86.0,259
2073,99,0,99,1,1,14.0,1.0,86.0,259
2074,42,0,42,2,2,14.0,1.0,86.0,259
2075,8,67,75,2,3,14.0,1.0,86.0,259
2076,24,42,66,3,4,14.0,1.0,86.0,259
2077,36,45,81,3,5,14.0,1.0,86.0,259
2078,24,40,64,3,6,14.0,1.0,86.0,259
2079,27,50,77,3,7,14.0,1.0,86.0,259
2080,24,76,100,1,0,14.0,1.0,86.0,260
2081,0,100,100,1,1,14.0,1.0,86.0,260
2082,2,72,74,2,2,14.0,1.0,86.0,260
2083,58,4,62,2,3,14.0,1.0,86.0,260
2084,6,92,98,3,4,14.0,1.0,86.0,260
2085,44,38,82,3,5,14.0,1.0,86.0,260
2086,16,84,100,3,6,14.0,1.0,86.0,260
2087,48,31,79,3,7,14.0,1.0,86.0,260
2088,30,25,55,1,0,14.0,1.0,86.0,261
2089,15,60,75,1,1,14.0,1.0,86.0,261
2090,15,25,40,2,2,14.0,1.0,86.0,261
2091,5,5,10,2,3,14.0,1.0,86.0,261
2092,-5,75,70,3,4,14.0,1.0,86.0,261
2093,10,70,80,3,5,14.0,1.0,86.0,261
2094,15,40,55,3,6,14.0,1.0,86.0,261
2095,35,5,40,3,7,14.0,1.0,86.0,261
2096,0,67,67,1,0,15.0,1.0,85.0,262
2097,28,72,100,1,1,15.0,1.0,85.0,262
2098,10,0,10,2,2,15.0,1.0,85.0,262
2099,10,52,62,2,3,15.0,1.0,85.0,262
2100,0,100,100,3,4,15.0,1.0,85.0,262
2101,1,75,76,3,5,15.0,1.0,85.0,262
2102,0,0,0,3,6,15.0,1.0,85.0,262
2103,18,0,18,3,7,15.0,1.0,85.0,262
2104,-5,42,37,1,0,15.0,1.0,85.0,263
2105,29,39,68,1,1,15.0,1.0,85.0,263
2106,6,17,23,2,2,15.0,1.0,85.0,263
2107,-30,45,15,2,3,15.0,1.0,85.0,263
2108,-21,21,0,3,4,15.0,1.0,85.0,263
2109,57,43,100,3,5,15.0,1.0,85.0,263
2110,67,24,91,3,6,15.0,1.0,85.0,263
2111,16,0,16,3,7,15.0,1.0,85.0,263
2112,35,40,75,1,0,15.0,1.0,85.0,264
2113,29,38,67,1,1,15.0,1.0,85.0,264
2114,-1,69,68,2,2,15.0,1.0,85.0,264
2115,24,17,41,2,3,15.0,1.0,85.0,264
2116,48,36,84,3,4,15.0,1.0,85.0,264
2117,54,29,83,3,5,15.0,1.0,85.0,264
2118,6,39,45,3,6,15.0,1.0,85.0,264
2119,34,36,70,3,7,15.0,1.0,85.0,264
2120,0,90,90,1,0,15.0,1.0,85.0,265
2121,6,69,75,1,1,15.0,1.0,85.0,265
2122,21,3,24,2,2,15.0,1.0,85.0,265
2123,-8,50,42,2,3,15.0,1.0,85.0,265
2124,-1,75,74,3,4,15.0,1.0,85.0,265
2125,0,50,50,3,5,15.0,1.0,85.0,265
2126,0,11,11,3,6,15.0,1.0,85.0,265
2127,-11,11,0,3,7,15.0,1.0,85.0,265
2128,5,65,70,1,0,15.0,1.0,85.0,266
2129,5,65,70,1,1,15.0,1.0,85.0,266
2130,22,13,35,2,2,15.0,1.0,85.0,266
2131,25,0,25,2,3,15.0,1.0,85.0,266
2132,0,70,70,3,4,15.0,1.0,85.0,266
2133,35,0,35,3,5,15.0,1.0,85.0,266
2134,5,70,75,3,6,15.0,1.0,85.0,266
2135,35,5,40,3,7,15.0,1.0,85.0,266
2136,83,5,88,1,0,15.0,1.0,85.0,267
2137,30,50,80,1,1,15.0,1.0,85.0,267
2138,30,50,80,2,2,15.0,1.0,85.0,267
2139,-49,74,25,2,3,15.0,1.0,85.0,267
2140,-4,83,79,3,4,15.0,1.0,85.0,267
2141,26,50,76,3,5,15.0,1.0,85.0,267
2142,58,22,80,3,6,15.0,1.0,85.0,267
2143,23,3,26,3,7,15.0,1.0,85.0,267
2144,33,64,97,1,0,15.0,1.0,85.0,268
2145,1,99,100,1,1,15.0,1.0,85.0,268
2146,71,0,71,2,2,15.0,1.0,85.0,268
2147,21,77,98,2,3,15.0,1.0,85.0,268
2148,22,61,83,3,4,15.0,1.0,85.0,268
2149,59,30,89,3,5,15.0,1.0,85.0,268
2150,0,100,100,3,6,15.0,1.0,85.0,268
2151,11,11,22,3,7,15.0,1.0,85.0,268
2152,28,60,88,1,0,15.0,1.0,85.0,269
2153,20,80,100,1,1,15.0,1.0,85.0,269
2154,1,25,26,2,2,15.0,1.0,85.0,269
2155,50,23,73,2,3,15.0,1.0,85.0,269
2156,18,56,74,3,4,15.0,1.0,85.0,269
2157,30,49,79,3,5,15.0,1.0,85.0,269
2158,5,95,100,3,6,15.0,1.0,85.0,269
2159,22,0,22,3,7,15.0,1.0,85.0,269
2160,15,75,90,1,0,15.0,1.0,85.0,270
2161,0,95,95,1,1,15.0,1.0,85.0,270
2162,10,60,70,2,2,15.0,1.0,85.0,270
2163,20,15,35,2,3,15.0,1.0,85.0,270
2164,5,80,85,3,4,15.0,1.0,85.0,270
2165,25,40,65,3,5,15.0,1.0,85.0,270
2166,10,75,85,3,6,15.0,1.0,85.0,270
2167,10,20,30,3,7,15.0,1.0,85.0,270
2168,18,79,97,1,0,16.0,1.0,84.0,271
2169,3,96,99,1,1,16.0,1.0,84.0,271
2170,84,2,86,2,2,16.0,1.0,84.0,271
2171,91,4,95,2,3,16.0,1.0,84.0,271
2172,21,78,99,3,4,16.0,1.0,84.0,271
2173,54,40,94,3,5,16.0,1.0,84.0,271
2174,31,64,95,3,6,16.0,1.0,84.0,271
2175,74,11,85,3,7,16.0,1.0,84.0,271
2176,0,68,68,1,0,16.0,1.0,84.0,272
2177,-7,74,67,1,1,16.0,1.0,84.0,272
2178,34,41,75,2,2,16.0,1.0,84.0,272
2179,8,65,73,2,3,16.0,1.0,84.0,272
2180,-1,75,74,3,4,16.0,1.0,84.0,272
2181,35,63,98,3,5,16.0,1.0,84.0,272
2182,8,32,40,3,6,16.0,1.0,84.0,272
2183,28,10,38,3,7,16.0,1.0,84.0,272
2184,9,87,96,1,0,16.0,1.0,84.0,273
2185,0,100,100,1,1,16.0,1.0,84.0,273
2186,1,0,1,2,2,16.0,1.0,84.0,273
2187,0,0,0,2,3,16.0,1.0,84.0,273
2188,3,27,30,3,4,16.0,1.0,84.0,273
2189,-4,78,74,3,5,16.0,1.0,84.0,273
2190,0,0,0,3,6,16.0,1.0,84.0,273
2191,0,0,0,3,7,16.0,1.0,84.0,273
2192,51,13,64,1,0,16.0,1.0,84.0,274
2193,-35,67,32,1,1,16.0,1.0,84.0,274
2194,-30,43,13,2,2,16.0,1.0,84.0,274
2195,14,67,81,2,3,16.0,1.0,84.0,274
2196,37,45,82,3,4,16.0,1.0,84.0,274
2197,-62,76,14,3,5,16.0,1.0,84.0,274
2198,-64,87,23,3,6,16.0,1.0,84.0,274
2199,-52,72,20,3,7,16.0,1.0,84.0,274
2200,-38,87,49,1,0,16.0,1.0,84.0,275
2201,0,50,50,1,1,16.0,1.0,84.0,275
2202,97,3,100,2,2,16.0,1.0,84.0,275
2203,29,65,94,2,3,16.0,1.0,84.0,275
2204,50,0,50,3,4,16.0,1.0,84.0,275
2205,10,50,60,3,5,16.0,1.0,84.0,275
2206,11,39,50,3,6,16.0,1.0,84.0,275
2207,52,0,52,3,7,16.0,1.0,84.0,275
2208,-11,66,55,1,0,16.0,1.0,84.0,276
2209,7,85,92,1,1,16.0,1.0,84.0,276
2210,55,30,85,2,2,16.0,1.0,84.0,276
2211,57,21,78,2,3,16.0,1.0,84.0,276
2212,30,51,81,3,4,16.0,1.0,84.0,276
2213,23,40,63,3,5,16.0,1.0,84.0,276
2214,57,43,100,3,6,16.0,1.0,84.0,276
2215,51,31,82,3,7,16.0,1.0,84.0,276
2216,50,50,100,1,0,16.0,1.0,84.0,277
2217,0,100,100,1,1,16.0,1.0,84.0,277
2218,18,60,78,2,2,16.0,1.0,84.0,277
2219,41,59,100,2,3,16.0,1.0,84.0,277
2220,68,32,100,3,4,16.0,1.0,84.0,277
2221,88,12,100,3,5,16.0,1.0,84.0,277
2222,0,100,100,3,6,16.0,1.0,84.0,277
2223,98,0,98,3,7,16.0,1.0,84.0,277
2224,-33,100,67,1,0,16.0,1.0,84.0,278
2225,-39,100,61,1,1,16.0,1.0,84.0,278
2226,-9,67,58,2,2,16.0,1.0,84.0,278
2227,-14,73,59,2,3,16.0,1.0,84.0,278
2228,7,44,51,3,4,16.0,1.0,84.0,278
2229,-4,52,48,3,5,16.0,1.0,84.0,278
2230,57,13,70,3,6,16.0,1.0,84.0,278
2231,-66,100,34,3,7,16.0,1.0,84.0,278
2232,14,70,84,1,0,17.0,1.0,83.0,279
2233,0,100,100,1,1,17.0,1.0,83.0,279
2234,73,4,77,2,2,17.0,1.0,83.0,279
2235,-26,50,24,2,3,17.0,1.0,83.0,279
2236,63,37,100,3,4,17.0,1.0,83.0,279
2237,30,50,80,3,5,17.0,1.0,83.0,279
2238,81,0,81,3,6,17.0,1.0,83.0,279
2239,-9,9,0,3,7,17.0,1.0,83.0,279
2240,-5,85,80,1,0,17.0,1.0,83.0,280
2241,0,100,100,1,1,17.0,1.0,83.0,280
2242,0,0,0,2,2,17.0,1.0,83.0,280
2243,2,0,2,2,3,17.0,1.0,83.0,280
2244,6,93,99,3,4,17.0,1.0,83.0,280
2245,1,0,1,3,5,17.0,1.0,83.0,280
2246,6,6,12,3,6,17.0,1.0,83.0,280
2247,5,0,5,3,7,17.0,1.0,83.0,280
2248,6,90,96,1,0,17.0,1.0,83.0,281
2249,73,17,90,1,1,17.0,1.0,83.0,281
2250,69,18,87,2,2,17.0,1.0,83.0,281
2251,-11,29,18,2,3,17.0,1.0,83.0,281
2252,8,81,89,3,4,17.0,1.0,83.0,281
2253,15,65,80,3,5,17.0,1.0,83.0,281
2254,56,33,89,3,6,17.0,1.0,83.0,281
2255,58,29,87,3,7,17.0,1.0,83.0,281
2256,20,0,20,1,0,17.0,1.0,83.0,282
2257,70,0,70,1,1,17.0,1.0,83.0,282
2258,10,61,71,2,2,17.0,1.0,83.0,282
2259,60,32,92,2,3,17.0,1.0,83.0,282
2260,-24,96,72,3,4,17.0,1.0,83.0,282
2261,1,44,45,3,5,17.0,1.0,83.0,282
2262,4,67,71,3,6,17.0,1.0,83.0,282
2263,56,18,74,3,7,17.0,1.0,83.0,282
2264,5,71,76,1,0,17.0,1.0,83.0,283
2265,64,15,79,1,1,17.0,1.0,83.0,283
2266,73,14,87,2,2,17.0,1.0,83.0,283
2267,39,38,77,2,3,17.0,1.0,83.0,283
2268,7,63,70,3,4,17.0,1.0,83.0,283
2269,28,42,70,3,5,17.0,1.0,83.0,283
2270,46,25,71,3,6,17.0,1.0,83.0,283
2271,68,8,76,3,7,17.0,1.0,83.0,283
2272,-42,68,26,1,0,17.0,1.0,83.0,284
2273,21,42,63,1,1,17.0,1.0,83.0,284
2274,46,16,62,2,2,17.0,1.0,83.0,284
2275,-14,63,49,2,3,17.0,1.0,83.0,284
2276,-26,63,37,3,4,17.0,1.0,83.0,284
2277,20,39,59,3,5,17.0,1.0,83.0,284
2278,26,25,51,3,6,17.0,1.0,83.0,284
2279,51,6,57,3,7,17.0,1.0,83.0,284
2280,33,62,95,1,0,17.0,1.0,83.0,285
2281,-3,100,97,1,1,17.0,1.0,83.0,285
2282,75,19,94,2,2,17.0,1.0,83.0,285
2283,91,1,92,2,3,17.0,1.0,83.0,285
2284,34,63,97,3,4,17.0,1.0,83.0,285
2285,24,73,97,3,5,17.0,1.0,83.0,285
2286,96,4,100,3,6,17.0,1.0,83.0,285
2287,88,2,90,3,7,17.0,1.0,83.0,285
2288,100,0,100,1,0,17.0,1.0,83.0,286
2289,1,99,100,1,1,17.0,1.0,83.0,286
2290,50,0,50,2,2,17.0,1.0,83.0,286
2291,0,0,0,2,3,17.0,1.0,83.0,286
2292,50,0,50,3,4,17.0,1.0,83.0,286
2293,98,2,100,3,5,17.0,1.0,83.0,286
2294,50,0,50,3,6,17.0,1.0,83.0,286
2295,-2,2,0,3,7,17.0,1.0,83.0,286
2296,-29,29,0,1,0,17.0,1.0,83.0,287
2297,69,31,100,1,1,17.0,1.0,83.0,287
2298,5,95,100,2,2,17.0,1.0,83.0,287
2299,7,93,100,2,3,17.0,1.0,83.0,287
2300,24,76,100,3,4,17.0,1.0,83.0,287
2301,86,14,100,3,5,17.0,1.0,83.0,287
2302,74,26,100,3,6,17.0,1.0,83.0,287
2303,-100,100,0,3,7,17.0,1.0,83.0,287
2304,41,50,91,1,0,17.0,1.0,83.0,288
2305,26,60,86,1,1,17.0,1.0,83.0,288
2306,56,31,87,2,2,17.0,1.0,83.0,288
2307,52,34,86,2,3,17.0,1.0,83.0,288
2308,51,36,87,3,4,17.0,1.0,83.0,288
2309,41,50,91,3,5,17.0,1.0,83.0,288
2310,5,80,85,3,6,17.0,1.0,83.0,288
2311,74,13,87,3,7,17.0,1.0,83.0,288
2312,0,100,100,1,0,18.0,1.0,82.0,289
2313,0,100,100,1,1,18.0,1.0,82.0,289
2314,50,0,50,2,2,18.0,1.0,82.0,289
2315,37,0,37,2,3,18.0,1.0,82.0,289
2316,-1,91,90,3,4,18.0,1.0,82.0,289
2317,26,50,76,3,5,18.0,1.0,82.0,289
2318,5,95,100,3,6,18.0,1.0,82.0,289
2319,12,0,12,3,7,18.0,1.0,82.0,289
2320,0,94,94,1,0,18.0,1.0,82.0,290
2321,-1,100,99,1,1,18.0,1.0,82.0,290
2322,-11,12,1,2,2,18.0,1.0,82.0,290
2323,2,1,3,2,3,18.0,1.0,82.0,290
2324,30,70,100,3,4,18.0,1.0,82.0,290
2325,11,88,99,3,5,18.0,1.0,82.0,290
2326,-13,15,2,3,6,18.0,1.0,82.0,290
2327,46,35,81,3,7,18.0,1.0,82.0,290
2328,11,61,72,1,0,18.0,1.0,82.0,291
2329,-25,75,50,1,1,18.0,1.0,82.0,291
2330,-8,83,75,2,2,18.0,1.0,82.0,291
2331,-30,80,50,2,3,18.0,1.0,82.0,291
2332,-7,75,68,3,4,18.0,1.0,82.0,291
2333,0,75,75,3,5,18.0,1.0,82.0,291
2334,50,50,100,3,6,18.0,1.0,82.0,291
2335,86,14,100,3,7,18.0,1.0,82.0,291
2336,59,41,100,1,0,18.0,1.0,82.0,292
2337,69,31,100,1,1,18.0,1.0,82.0,292
2338,92,8,100,2,2,18.0,1.0,82.0,292
2339,0,100,100,2,3,18.0,1.0,82.0,292
2340,36,64,100,3,4,18.0,1.0,82.0,292
2341,82,18,100,3,5,18.0,1.0,82.0,292
2342,47,53,100,3,6,18.0,1.0,82.0,292
2343,83,0,83,3,7,18.0,1.0,82.0,292
2344,-5,90,85,1,0,18.0,1.0,82.0,293
2345,77,5,82,1,1,18.0,1.0,82.0,293
2346,-3,16,13,2,2,18.0,1.0,82.0,293
2347,5,17,22,2,3,18.0,1.0,82.0,293
2348,26,50,76,3,4,18.0,1.0,82.0,293
2349,11,70,81,3,5,18.0,1.0,82.0,293
2350,-75,85,10,3,6,18.0,1.0,82.0,293
2351,69,15,84,3,7,18.0,1.0,82.0,293
2352,-11,50,39,1,0,18.0,1.0,82.0,294
2353,62,0,62,1,1,18.0,1.0,82.0,294
2354,5,0,5,2,2,18.0,1.0,82.0,294
2355,18,50,68,2,3,18.0,1.0,82.0,294
2356,7,64,71,3,4,18.0,1.0,82.0,294
2357,0,61,61,3,5,18.0,1.0,82.0,294
2358,87,13,100,3,6,18.0,1.0,82.0,294
2359,3,66,69,3,7,18.0,1.0,82.0,294
2360,23,77,100,1,0,18.0,1.0,82.0,295
2361,35,0,35,1,1,18.0,1.0,82.0,295
2362,36,0,36,2,2,18.0,1.0,82.0,295
2363,-55,100,45,2,3,18.0,1.0,82.0,295
2364,53,30,83,3,4,18.0,1.0,82.0,295
2365,49,23,72,3,5,18.0,1.0,82.0,295
2366,70,30,100,3,6,18.0,1.0,82.0,295
2367,78,11,89,3,7,18.0,1.0,82.0,295
2368,12,50,62,1,0,18.0,1.0,82.0,296
2369,2,98,100,1,1,18.0,1.0,82.0,296
2370,-15,50,35,2,2,18.0,1.0,82.0,296
2371,4,69,73,2,3,18.0,1.0,82.0,296
2372,1,92,93,3,4,18.0,1.0,82.0,296
2373,10,50,60,3,5,18.0,1.0,82.0,296
2374,0,50,50,3,6,18.0,1.0,82.0,296
2375,14,36,50,3,7,18.0,1.0,82.0,296
2376,10,90,100,1,0,18.0,1.0,82.0,297
2377,4,96,100,1,1,18.0,1.0,82.0,297
2378,11,39,50,2,2,18.0,1.0,82.0,297
2379,-6,12,6,2,3,18.0,1.0,82.0,297
2380,13,78,91,3,4,18.0,1.0,82.0,297
2381,24,56,80,3,5,18.0,1.0,82.0,297
2382,5,45,50,3,6,18.0,1.0,82.0,297
2383,86,5,91,3,7,18.0,1.0,82.0,297
2384,-8,47,39,1,0,18.0,1.0,82.0,298
2385,-10,100,90,1,1,18.0,1.0,82.0,298
2386,8,0,8,2,2,18.0,1.0,82.0,298
2387,-3,27,24,2,3,18.0,1.0,82.0,298
2388,2,74,76,3,4,18.0,1.0,82.0,298
2389,-6,50,44,3,5,18.0,1.0,82.0,298
2390,-49,100,51,3,6,18.0,1.0,82.0,298
2391,-4,29,25,3,7,18.0,1.0,82.0,298
2392,22,78,100,1,0,18.0,1.0,82.0,299
2393,11,89,100,1,1,18.0,1.0,82.0,299
2394,36,2,38,2,2,18.0,1.0,82.0,299
2395,25,33,58,2,3,18.0,1.0,82.0,299
2396,22,54,76,3,4,18.0,1.0,82.0,299
2397,28,30,58,3,5,18.0,1.0,82.0,299
2398,13,42,55,3,6,18.0,1.0,82.0,299
2399,12,65,77,3,7,18.0,1.0,82.0,299
2400,47,25,72,1,0,18.0,1.0,82.0,300
2401,3,88,91,1,1,18.0,1.0,82.0,300
2402,70,4,74,2,2,18.0,1.0,82.0,300
2403,40,36,76,2,3,18.0,1.0,82.0,300
2404,1,74,75,3,4,18.0,1.0,82.0,300
2405,70,11,81,3,5,18.0,1.0,82.0,300
2406,83,13,96,3,6,18.0,1.0,82.0,300
2407,65,10,75,3,7,18.0,1.0,82.0,300
2408,71,29,100,1,0,18.0,1.0,82.0,301
2409,15,85,100,1,1,18.0,1.0,82.0,301
2410,90,10,100,2,2,18.0,1.0,82.0,301
2411,95,0,95,2,3,18.0,1.0,82.0,301
2412,25,75,100,3,4,18.0,1.0,82.0,301
2413,63,37,100,3,5,18.0,1.0,82.0,301
2414,63,37,100,3,6,18.0,1.0,82.0,301
2415,88,12,100,3,7,18.0,1.0,82.0,301
2416,43,57,100,1,0,18.0,1.0,82.0,302
2417,0,100,100,1,1,18.0,1.0,82.0,302
2418,0,0,0,2,2,18.0,1.0,82.0,302
2419,11,89,100,2,3,18.0,1.0,82.0,302
2420,33,67,100,3,4,18.0,1.0,82.0,302
2421,84,16,100,3,5,18.0,1.0,82.0,302
2422,58,42,100,3,6,18.0,1.0,82.0,302
2423,100,0,100,3,7,18.0,1.0,82.0,302
2424,-4,77,73,1,0,18.0,1.0,82.0,303
2425,0,0,0,1,1,18.0,1.0,82.0,303
2426,-24,35,11,2,2,18.0,1.0,82.0,303
2427,-1,36,35,2,3,18.0,1.0,82.0,303
2428,-17,50,33,3,4,18.0,1.0,82.0,303
2429,-17,50,33,3,5,18.0,1.0,82.0,303
2430,-50,50,0,3,6,18.0,1.0,82.0,303
2431,8,23,31,3,7,18.0,1.0,82.0,303
2432,24,76,100,1,0,19.0,1.0,81.0,304
2433,0,100,100,1,1,19.0,1.0,81.0,304
2434,13,10,23,2,2,19.0,1.0,81.0,304
2435,39,23,62,2,3,19.0,1.0,81.0,304
2436,7,60,67,3,4,19.0,1.0,81.0,304
2437,34,12,46,3,5,19.0,1.0,81.0,304
2438,-7,15,8,3,6,19.0,1.0,81.0,304
2439,16,59,75,3,7,19.0,1.0,81.0,304
2440,0,87,87,1,0,19.0,1.0,81.0,305
2441,-4,83,79,1,1,19.0,1.0,81.0,305
2442,57,18,75,2,2,19.0,1.0,81.0,305
2443,14,13,27,2,3,19.0,1.0,81.0,305
2444,18,65,83,3,4,19.0,1.0,81.0,305
2445,60,14,74,3,5,19.0,1.0,81.0,305
2446,12,20,32,3,6,19.0,1.0,81.0,305
2447,-27,86,59,3,7,19.0,1.0,81.0,305
2448,0,50,50,1,0,19.0,1.0,81.0,306
2449,0,100,100,1,1,19.0,1.0,81.0,306
2450,0,50,50,2,2,19.0,1.0,81.0,306
2451,0,0,0,2,3,19.0,1.0,81.0,306
2452,58,18,76,3,4,19.0,1.0,81.0,306
2453,11,50,61,3,5,19.0,1.0,81.0,306
2454,53,47,100,3,6,19.0,1.0,81.0,306
2455,16,50,66,3,7,19.0,1.0,81.0,306
2456,24,76,100,1,0,19.0,1.0,81.0,307
2457,10,90,100,1,1,19.0,1.0,81.0,307
2458,78,10,88,2,2,19.0,1.0,81.0,307
2459,79,11,90,2,3,19.0,1.0,81.0,307
2460,63,37,100,3,4,19.0,1.0,81.0,307
2461,73,24,97,3,5,19.0,1.0,81.0,307
2462,91,9,100,3,6,19.0,1.0,81.0,307
2463,75,0,75,3,7,19.0,1.0,81.0,307
2464,0,100,100,1,0,19.0,1.0,81.0,308
2465,0,100,100,1,1,19.0,1.0,81.0,308
2466,20,11,31,2,2,19.0,1.0,81.0,308
2467,12,88,100,2,3,19.0,1.0,81.0,308
2468,22,76,98,3,4,19.0,1.0,81.0,308
2469,28,46,74,3,5,19.0,1.0,81.0,308
2470,29,45,74,3,6,19.0,1.0,81.0,308
2471,41,24,65,3,7,19.0,1.0,81.0,308
2472,-9,95,86,1,0,19.0,1.0,81.0,309
2473,-24,98,74,1,1,19.0,1.0,81.0,309
2474,1,87,88,2,2,19.0,1.0,81.0,309
2475,0,91,91,2,3,19.0,1.0,81.0,309
2476,0,100,100,3,4,19.0,1.0,81.0,309
2477,11,12,23,3,5,19.0,1.0,81.0,309
2478,0,0,0,3,6,19.0,1.0,81.0,309
2479,4,21,25,3,7,19.0,1.0,81.0,309
2480,-2,91,89,1,0,19.0,1.0,81.0,310
2481,0,100,100,1,1,19.0,1.0,81.0,310
2482,23,13,36,2,2,19.0,1.0,81.0,310
2483,4,37,41,2,3,19.0,1.0,81.0,310
2484,0,45,45,3,4,19.0,1.0,81.0,310
2485,0,55,55,3,5,19.0,1.0,81.0,310
2486,27,35,62,3,6,19.0,1.0,81.0,310
2487,0,42,42,3,7,19.0,1.0,81.0,310
2488,7,82,89,1,0,19.0,1.0,81.0,311
2489,0,100,100,1,1,19.0,1.0,81.0,311
2490,17,56,73,2,2,19.0,1.0,81.0,311
2491,47,24,71,2,3,19.0,1.0,81.0,311
2492,39,37,76,3,4,19.0,1.0,81.0,311
2493,-6,77,71,3,5,19.0,1.0,81.0,311
2494,19,78,97,3,6,19.0,1.0,81.0,311
2495,15,64,79,3,7,19.0,1.0,81.0,311
2496,0,50,50,1,0,19.0,1.0,81.0,312
2497,24,13,37,1,1,19.0,1.0,81.0,312
2498,0,50,50,2,2,19.0,1.0,81.0,312
2499,0,50,50,2,3,19.0,1.0,81.0,312
2500,3,47,50,3,4,19.0,1.0,81.0,312
2501,0,50,50,3,5,19.0,1.0,81.0,312
2502,0,50,50,3,6,19.0,1.0,81.0,312
2503,50,0,50,3,7,19.0,1.0,81.0,312
2504,39,50,89,1,0,19.0,1.0,81.0,313
2505,29,50,79,1,1,19.0,1.0,81.0,313
2506,0,50,50,2,2,19.0,1.0,81.0,313
2507,12,32,44,2,3,19.0,1.0,81.0,313
2508,16,74,90,3,4,19.0,1.0,81.0,313
2509,19,50,69,3,5,19.0,1.0,81.0,313
2510,16,50,66,3,6,19.0,1.0,81.0,313
2511,21,50,71,3,7,19.0,1.0,81.0,313
2512,0,100,100,1,0,19.0,1.0,81.0,314
2513,0,100,100,1,1,19.0,1.0,81.0,314
2514,25,75,100,2,2,19.0,1.0,81.0,314
2515,60,40,100,2,3,19.0,1.0,81.0,314
2516,0,100,100,3,4,19.0,1.0,81.0,314
2517,63,37,100,3,5,19.0,1.0,81.0,314
2518,75,25,100,3,6,19.0,1.0,81.0,314
2519,32,68,100,3,7,19.0,1.0,81.0,314
2520,13,67,80,1,0,19.0,1.0,81.0,315
2521,-4,90,86,1,1,19.0,1.0,81.0,315
2522,9,60,69,2,2,19.0,1.0,81.0,315
2523,-13,43,30,2,3,19.0,1.0,81.0,315
2524,7,83,90,3,4,19.0,1.0,81.0,315
2525,-1,25,24,3,5,19.0,1.0,81.0,315
2526,-1,73,72,3,6,19.0,1.0,81.0,315
2527,7,14,21,3,7,19.0,1.0,81.0,315
2528,10,76,86,1,0,19.0,1.0,81.0,316
2529,18,71,89,1,1,19.0,1.0,81.0,316
2530,0,39,39,2,2,19.0,1.0,81.0,316
2531,-3,16,13,2,3,19.0,1.0,81.0,316
2532,9,65,74,3,4,19.0,1.0,81.0,316
2533,27,50,77,3,5,19.0,1.0,81.0,316
2534,1,98,99,3,6,19.0,1.0,81.0,316
2535,26,18,44,3,7,19.0,1.0,81.0,316
2536,2,82,84,1,0,19.0,1.0,81.0,317
2537,13,73,86,1,1,19.0,1.0,81.0,317
2538,73,15,88,2,2,19.0,1.0,81.0,317
2539,64,14,78,2,3,19.0,1.0,81.0,317
2540,10,74,84,3,4,19.0,1.0,81.0,317
2541,65,19,84,3,5,19.0,1.0,81.0,317
2542,-62,84,22,3,6,19.0,1.0,81.0,317
2543,-56,77,21,3,7,19.0,1.0,81.0,317
2544,15,0,15,1,0,19.0,1.0,81.0,318
2545,14,0,14,1,1,19.0,1.0,81.0,318
2546,91,0,91,2,2,19.0,1.0,81.0,318
2547,-10,100,90,2,3,19.0,1.0,81.0,318
2548,0,100,100,3,4,19.0,1.0,81.0,318
2549,8,0,8,3,5,19.0,1.0,81.0,318
2550,7,0,7,3,6,19.0,1.0,81.0,318
2551,13,0,13,3,7,19.0,1.0,81.0,318
2552,1,93,94,1,0,20.0,1.0,80.0,319
2553,0,100,100,1,1,20.0,1.0,80.0,319
2554,10,7,17,2,2,20.0,1.0,80.0,319
2555,34,31,65,2,3,20.0,1.0,80.0,319
2556,17,58,75,3,4,20.0,1.0,80.0,319
2557,78,2,80,3,5,20.0,1.0,80.0,319
2558,17,66,83,3,6,20.0,1.0,80.0,319
2559,33,50,83,3,7,20.0,1.0,80.0,319
2560,0,50,50,1,0,20.0,1.0,80.0,320
2561,0,100,100,1,1,20.0,1.0,80.0,320
2562,-14,49,35,2,2,20.0,1.0,80.0,320
2563,-12,50,38,2,3,20.0,1.0,80.0,320
2564,-9,9,0,3,4,20.0,1.0,80.0,320
2565,0,50,50,3,5,20.0,1.0,80.0,320
2566,7,21,28,3,6,20.0,1.0,80.0,320
2567,1,10,11,3,7,20.0,1.0,80.0,320
2568,7,76,83,1,0,20.0,1.0,80.0,321
2569,10,81,91,1,1,20.0,1.0,80.0,321
2570,71,22,93,2,2,20.0,1.0,80.0,321
2571,25,73,98,2,3,20.0,1.0,80.0,321
2572,23,64,87,3,4,20.0,1.0,80.0,321
2573,54,31,85,3,5,20.0,1.0,80.0,321
2574,74,22,96,3,6,20.0,1.0,80.0,321
2575,-4,13,9,3,7,20.0,1.0,80.0,321
2576,-14,100,86,1,0,20.0,1.0,80.0,322
2577,0,100,100,1,1,20.0,1.0,80.0,322
2578,42,3,45,2,2,20.0,1.0,80.0,322
2579,-65,89,24,2,3,20.0,1.0,80.0,322
2580,19,78,97,3,4,20.0,1.0,80.0,322
2581,26,52,78,3,5,20.0,1.0,80.0,322
2582,56,39,95,3,6,20.0,1.0,80.0,322
2583,20,3,23,3,7,20.0,1.0,80.0,322
2584,5,95,100,1,0,20.0,1.0,80.0,323
2585,0,100,100,1,1,20.0,1.0,80.0,323
2586,25,50,75,2,2,20.0,1.0,80.0,323
2587,46,30,76,2,3,20.0,1.0,80.0,323
2588,45,30,75,3,4,20.0,1.0,80.0,323
2589,60,10,70,3,5,20.0,1.0,80.0,323
2590,75,25,100,3,6,20.0,1.0,80.0,323
2591,42,40,82,3,7,20.0,1.0,80.0,323
2592,30,70,100,1,0,20.0,1.0,80.0,324
2593,0,100,100,1,1,20.0,1.0,80.0,324
2594,65,0,65,2,2,20.0,1.0,80.0,324
2595,55,15,70,2,3,20.0,1.0,80.0,324
2596,26,74,100,3,4,20.0,1.0,80.0,324
2597,100,0,100,3,5,20.0,1.0,80.0,324
2598,3,97,100,3,6,20.0,1.0,80.0,324
2599,50,50,100,3,7,20.0,1.0,80.0,324
2600,15,50,65,1,0,20.0,1.0,80.0,325
2601,0,91,91,1,1,20.0,1.0,80.0,325
2602,23,50,73,2,2,20.0,1.0,80.0,325
2603,-6,23,17,2,3,20.0,1.0,80.0,325
2604,43,35,78,3,4,20.0,1.0,80.0,325
2605,27,50,77,3,5,20.0,1.0,80.0,325
2606,14,50,64,3,6,20.0,1.0,80.0,325
2607,24,50,74,3,7,20.0,1.0,80.0,325
2608,30,42,72,1,0,20.0,1.0,80.0,326
2609,7,66,73,1,1,20.0,1.0,80.0,326
2610,29,43,72,2,2,20.0,1.0,80.0,326
2611,35,41,76,2,3,20.0,1.0,80.0,326
2612,13,64,77,3,4,20.0,1.0,80.0,326
2613,33,42,75,3,5,20.0,1.0,80.0,326
2614,29,44,73,3,6,20.0,1.0,80.0,326
2615,49,23,72,3,7,20.0,1.0,80.0,326
2616,-1,63,62,1,0,20.0,1.0,80.0,327
2617,27,64,91,1,1,20.0,1.0,80.0,327
2618,10,33,43,2,2,20.0,1.0,80.0,327
2619,17,26,43,2,3,20.0,1.0,80.0,327
2620,9,54,63,3,4,20.0,1.0,80.0,327
2621,25,40,65,3,5,20.0,1.0,80.0,327
2622,19,42,61,3,6,20.0,1.0,80.0,327
2623,15,38,53,3,7,20.0,1.0,80.0,327
2624,16,84,100,1,0,20.0,1.0,80.0,328
2625,17,83,100,1,1,20.0,1.0,80.0,328
2626,56,5,61,2,2,20.0,1.0,80.0,328
2627,53,10,63,2,3,20.0,1.0,80.0,328
2628,16,57,73,3,4,20.0,1.0,80.0,328
2629,61,0,61,3,5,20.0,1.0,80.0,328
2630,9,69,78,3,6,20.0,1.0,80.0,328
2631,59,0,59,3,7,20.0,1.0,80.0,328
2632,6,49,55,1,0,20.0,1.0,80.0,329
2633,50,50,100,1,1,20.0,1.0,80.0,329
2634,1,16,17,2,2,20.0,1.0,80.0,329
2635,40,50,90,2,3,20.0,1.0,80.0,329
2636,43,57,100,3,4,20.0,1.0,80.0,329
2637,73,17,90,3,5,20.0,1.0,80.0,329
2638,86,10,96,3,6,20.0,1.0,80.0,329
2639,74,9,83,3,7,20.0,1.0,80.0,329
2640,0,100,100,1,0,20.0,1.0,80.0,330
2641,0,100,100,1,1,20.0,1.0,80.0,330
2642,0,0,0,2,2,20.0,1.0,80.0,330
2643,0,0,0,2,3,20.0,1.0,80.0,330
2644,-3,38,35,3,4,20.0,1.0,80.0,330
2645,25,0,25,3,5,20.0,1.0,80.0,330
2646,7,17,24,3,6,20.0,1.0,80.0,330
2647,0,25,25,3,7,20.0,1.0,80.0,330
2648,28,50,78,1,0,20.0,1.0,80.0,331
2649,-100,100,0,1,1,20.0,1.0,80.0,331
2650,8,42,50,2,2,20.0,1.0,80.0,331
2651,-50,50,0,2,3,20.0,1.0,80.0,331
2652,63,37,100,3,4,20.0,1.0,80.0,331
2653,73,27,100,3,5,20.0,1.0,80.0,331
2654,14,86,100,3,6,20.0,1.0,80.0,331
2655,-29,39,10,3,7,20.0,1.0,80.0,331
2656,45,50,95,1,0,20.0,1.0,80.0,332
2657,10,90,100,1,1,20.0,1.0,80.0,332
2658,25,25,50,2,2,20.0,1.0,80.0,332
2659,45,5,50,2,3,20.0,1.0,80.0,332
2660,90,5,95,3,4,20.0,1.0,80.0,332
2661,40,50,90,3,5,20.0,1.0,80.0,332
2662,45,5,50,3,6,20.0,1.0,80.0,332
2663,65,0,65,3,7,20.0,1.0,80.0,332
2664,10,90,100,1,0,20.0,1.0,80.0,333
2665,0,100,100,1,1,20.0,1.0,80.0,333
2666,98,2,100,2,2,20.0,1.0,80.0,333
2667,75,25,100,2,3,20.0,1.0,80.0,333
2668,75,25,100,3,4,20.0,1.0,80.0,333
2669,-5,5,0,3,5,20.0,1.0,80.0,333
2670,5,95,100,3,6,20.0,1.0,80.0,333
2671,98,2,100,3,7,20.0,1.0,80.0,333
2672,14,83,97,1,0,20.0,1.0,80.0,334
2673,10,90,100,1,1,20.0,1.0,80.0,334
2674,19,71,90,2,2,20.0,1.0,80.0,334
2675,56,25,81,2,3,20.0,1.0,80.0,334
2676,35,57,92,3,4,20.0,1.0,80.0,334
2677,75,18,93,3,5,20.0,1.0,80.0,334
2678,5,88,93,3,6,20.0,1.0,80.0,334
2679,49,38,87,3,7,20.0,1.0,80.0,334
2680,3,80,83,1,0,20.0,1.0,80.0,335
2681,15,85,100,1,1,20.0,1.0,80.0,335
2682,56,18,74,2,2,20.0,1.0,80.0,335
2683,61,15,76,2,3,20.0,1.0,80.0,335
2684,-12,38,26,3,4,20.0,1.0,80.0,335
2685,34,39,73,3,5,20.0,1.0,80.0,335
2686,46,34,80,3,6,20.0,1.0,80.0,335
2687,54,18,72,3,7,20.0,1.0,80.0,335
2688,0,100,100,1,0,20.0,1.0,80.0,336
2689,0,100,100,1,1,20.0,1.0,80.0,336
2690,100,0,100,2,2,20.0,1.0,80.0,336
2691,0,100,100,2,3,20.0,1.0,80.0,336
2692,0,100,100,3,4,20.0,1.0,80.0,336
2693,80,20,100,3,5,20.0,1.0,80.0,336
2694,0,100,100,3,6,20.0,1.0,80.0,336
2695,0,0,0,3,7,20.0,1.0,80.0,336
2696,0,100,100,1,0,20.0,1.0,80.0,337
2697,30,70,100,1,1,20.0,1.0,80.0,337
2698,36,50,86,2,2,20.0,1.0,80.0,337
2699,30,70,100,2,3,20.0,1.0,80.0,337
2700,90,10,100,3,4,20.0,1.0,80.0,337
2701,-30,50,20,3,5,20.0,1.0,80.0,337
2702,-30,30,0,3,6,20.0,1.0,80.0,337
2703,90,10,100,3,7,20.0,1.0,80.0,337
2704,75,0,75,1,0,20.0,1.0,80.0,338
2705,30,70,100,1,1,20.0,1.0,80.0,338
2706,45,30,75,2,2,20.0,1.0,80.0,338
2707,75,0,75,2,3,20.0,1.0,80.0,338
2708,35,50,85,3,4,20.0,1.0,80.0,338
2709,80,0,80,3,5,20.0,1.0,80.0,338
2710,25,75,100,3,6,20.0,1.0,80.0,338
2711,75,0,75,3,7,20.0,1.0,80.0,338
2712,25,50,75,1,0,20.0,1.0,80.0,339
2713,0,25,25,1,1,20.0,1.0,80.0,339
2714,-25,25,0,2,2,20.0,1.0,80.0,339
2715,50,0,50,2,3,20.0,1.0,80.0,339
2716,-10,40,30,3,4,20.0,1.0,80.0,339
2717,50,50,100,3,5,20.0,1.0,80.0,339
2718,0,0,0,3,6,20.0,1.0,80.0,339
2719,0,0,0,3,7,20.0,1.0,80.0,339
2720,55,30,85,1,0,20.0,1.0,80.0,340
2721,25,65,90,1,1,20.0,1.0,80.0,340
2722,20,35,55,2,2,20.0,1.0,80.0,340
2723,50,0,50,2,3,20.0,1.0,80.0,340
2724,20,60,80,3,4,20.0,1.0,80.0,340
2725,40,25,65,3,5,20.0,1.0,80.0,340
2726,25,50,75,3,6,20.0,1.0,80.0,340
2727,45,0,45,3,7,20.0,1.0,80.0,340
2728,18,50,68,1,0,20.0,1.0,80.0,341
2729,0,100,100,1,1,20.0,1.0,80.0,341
2730,20,0,20,2,2,20.0,1.0,80.0,341
2731,0,0,0,2,3,20.0,1.0,80.0,341
2732,29,36,65,3,4,20.0,1.0,80.0,341
2733,81,0,81,3,5,20.0,1.0,80.0,341
2734,39,60,99,3,6,20.0,1.0,80.0,341
2735,88,0,88,3,7,20.0,1.0,80.0,341
2736,19,66,85,1,0,20.0,1.0,80.0,342
2737,16,67,83,1,1,20.0,1.0,80.0,342
2738,51,20,71,2,2,20.0,1.0,80.0,342
2739,67,22,89,2,3,20.0,1.0,80.0,342
2740,11,74,85,3,4,20.0,1.0,80.0,342
2741,28,72,100,3,5,20.0,1.0,80.0,342
2742,50,41,91,3,6,20.0,1.0,80.0,342
2743,50,23,73,3,7,20.0,1.0,80.0,342
2744,-10,25,15,1,0,20.0,1.0,80.0,343
2745,0,48,48,1,1,20.0,1.0,80.0,343
2746,5,92,97,2,2,20.0,1.0,80.0,343
2747,-27,42,15,2,3,20.0,1.0,80.0,343
2748,-9,100,91,3,4,20.0,1.0,80.0,343
2749,11,11,22,3,5,20.0,1.0,80.0,343
2750,50,24,74,3,6,20.0,1.0,80.0,343
2751,2,16,18,3,7,20.0,1.0,80.0,343
2752,14,50,64,1,0,20.0,1.0,80.0,344
2753,-3,62,59,1,1,20.0,1.0,80.0,344
2754,10,40,50,2,2,20.0,1.0,80.0,344
2755,8,6,14,2,3,20.0,1.0,80.0,344
2756,14,36,50,3,4,20.0,1.0,80.0,344
2757,12,50,62,3,5,20.0,1.0,80.0,344
2758,12,38,50,3,6,20.0,1.0,80.0,344
2759,22,20,42,3,7,20.0,1.0,80.0,344
2760,22,76,98,1,0,20.0,1.0,80.0,345
2761,16,80,96,1,1,20.0,1.0,80.0,345
2762,83,0,83,2,2,20.0,1.0,80.0,345
2763,48,40,88,2,3,20.0,1.0,80.0,345
2764,13,74,87,3,4,20.0,1.0,80.0,345
2765,90,0,90,3,5,20.0,1.0,80.0,345
2766,-3,98,95,3,6,20.0,1.0,80.0,345
2767,-14,26,12,3,7,20.0,1.0,80.0,345
2768,50,50,100,1,0,20.0,1.0,80.0,346
2769,0,100,100,1,1,20.0,1.0,80.0,346
2770,50,50,100,2,2,20.0,1.0,80.0,346
2771,50,50,100,2,3,20.0,1.0,80.0,346
2772,35,65,100,3,4,20.0,1.0,80.0,346
2773,23,77,100,3,5,20.0,1.0,80.0,346
2774,0,0,0,3,6,20.0,1.0,80.0,346
2775,100,0,100,3,7,20.0,1.0,80.0,346
2776,11,89,100,1,0,20.0,1.0,80.0,347
2777,0,100,100,1,1,20.0,1.0,80.0,347
2778,29,38,67,2,2,20.0,1.0,80.0,347
2779,-9,50,41,2,3,20.0,1.0,80.0,347
2780,100,0,100,3,4,20.0,1.0,80.0,347
2781,0,100,100,3,5,20.0,1.0,80.0,347
2782,39,61,100,3,6,20.0,1.0,80.0,347
2783,10,0,10,3,7,20.0,1.0,80.0,347
2784,15,60,75,1,0,20.0,1.0,80.0,348
2785,0,100,100,1,1,20.0,1.0,80.0,348
2786,-25,80,55,2,2,20.0,1.0,80.0,348
2787,51,0,51,2,3,20.0,1.0,80.0,348
2788,0,60,60,3,4,20.0,1.0,80.0,348
2789,40,40,80,3,5,20.0,1.0,80.0,348
2790,20,80,100,3,6,20.0,1.0,80.0,348
2791,15,60,75,3,7,20.0,1.0,80.0,348
2792,10,60,70,1,0,20.0,1.0,80.0,349
2793,70,10,80,1,1,20.0,1.0,80.0,349
2794,25,50,75,2,2,20.0,1.0,80.0,349
2795,20,50,70,2,3,20.0,1.0,80.0,349
2796,25,45,70,3,4,20.0,1.0,80.0,349
2797,30,40,70,3,5,20.0,1.0,80.0,349
2798,40,50,90,3,6,20.0,1.0,80.0,349
2799,20,45,65,3,7,20.0,1.0,80.0,349
2800,63,12,75,1,0,20.0,1.0,80.0,350
2801,10,90,100,1,1,20.0,1.0,80.0,350
2802,25,0,25,2,2,20.0,1.0,80.0,350
2803,0,0,0,2,3,20.0,1.0,80.0,350
2804,43,35,78,3,4,20.0,1.0,80.0,350
2805,67,13,80,3,5,20.0,1.0,80.0,350
2806,0,100,100,3,6,20.0,1.0,80.0,350
2807,0,0,0,3,7,20.0,1.0,80.0,350
2808,15,75,90,1,0,20.0,1.0,80.0,351
2809,25,65,90,1,1,20.0,1.0,80.0,351
2810,45,25,70,2,2,20.0,1.0,80.0,351
2811,50,25,75,2,3,20.0,1.0,80.0,351
2812,15,60,75,3,4,20.0,1.0,80.0,351
2813,30,45,75,3,5,20.0,1.0,80.0,351
2814,0,100,100,3,6,20.0,1.0,80.0,351
2815,50,30,80,3,7,20.0,1.0,80.0,351
2816,59,3,62,1,0,20.0,1.0,80.0,352
2817,0,100,100,1,1,20.0,1.0,80.0,352
2818,15,18,33,2,2,20.0,1.0,80.0,352
2819,0,0,0,2,3,20.0,1.0,80.0,352
2820,0,0,0,3,4,20.0,1.0,80.0,352
2821,17,0,17,3,5,20.0,1.0,80.0,352
2822,9,91,100,3,6,20.0,1.0,80.0,352
2823,0,0,0,3,7,20.0,1.0,80.0,352
2824,35,65,100,1,0,20.0,1.0,80.0,353
2825,0,75,75,1,1,20.0,1.0,80.0,353
2826,10,50,60,2,2,20.0,1.0,80.0,353
2827,50,25,75,2,3,20.0,1.0,80.0,353
2828,25,50,75,3,4,20.0,1.0,80.0,353
2829,0,50,50,3,5,20.0,1.0,80.0,353
2830,0,100,100,3,6,20.0,1.0,80.0,353
2831,0,0,0,3,7,20.0,1.0,80.0,353
2832,27,49,76,1,0,20.0,1.0,80.0,354
2833,0,100,100,1,1,20.0,1.0,80.0,354
2834,91,9,100,2,2,20.0,1.0,80.0,354
2835,77,23,100,2,3,20.0,1.0,80.0,354
2836,23,53,76,3,4,20.0,1.0,80.0,354
2837,29,71,100,3,5,20.0,1.0,80.0,354
2838,100,0,100,3,6,20.0,1.0,80.0,354
2839,100,0,100,3,7,20.0,1.0,80.0,354
2840,5,70,75,1,0,20.0,1.0,80.0,355
2841,-15,95,80,1,1,20.0,1.0,80.0,355
2842,60,20,80,2,2,20.0,1.0,80.0,355
2843,60,25,85,2,3,20.0,1.0,80.0,355
2844,35,50,85,3,4,20.0,1.0,80.0,355
2845,40,50,90,3,5,20.0,1.0,80.0,355
2846,0,100,100,3,6,20.0,1.0,80.0,355
2847,15,0,15,3,7,20.0,1.0,80.0,355
2848,29,50,79,1,0,20.0,1.0,80.0,356
2849,-4,90,86,1,1,20.0,1.0,80.0,356
2850,41,42,83,2,2,20.0,1.0,80.0,356
2851,41,25,66,2,3,20.0,1.0,80.0,356
2852,43,45,88,3,4,20.0,1.0,80.0,356
2853,41,46,87,3,5,20.0,1.0,80.0,356
2854,-6,89,83,3,6,20.0,1.0,80.0,356
2855,75,1,76,3,7,20.0,1.0,80.0,356
2856,34,16,50,1,0,20.0,1.0,80.0,357
2857,-18,38,20,1,1,20.0,1.0,80.0,357
2858,-6,38,32,2,2,20.0,1.0,80.0,357
2859,3,9,12,2,3,20.0,1.0,80.0,357
2860,11,35,46,3,4,20.0,1.0,80.0,357
2861,40,15,55,3,5,20.0,1.0,80.0,357
2862,0,50,50,3,6,20.0,1.0,80.0,357
2863,0,50,50,3,7,20.0,1.0,80.0,357
2864,50,0,50,1,0,20.0,1.0,80.0,358
2865,20,80,100,1,1,20.0,1.0,80.0,358
2866,0,50,50,2,2,20.0,1.0,80.0,358
2867,10,70,80,2,3,20.0,1.0,80.0,358
2868,5,70,75,3,4,20.0,1.0,80.0,358
2869,0,50,50,3,5,20.0,1.0,80.0,358
2870,0,50,50,3,6,20.0,1.0,80.0,358
2871,0,0,0,3,7,20.0,1.0,80.0,358
2872,71,25,96,1,0,20.0,1.0,80.0,359
2873,6,85,91,1,1,20.0,1.0,80.0,359
2874,-7,11,4,2,2,20.0,1.0,80.0,359
2875,-9,18,9,2,3,20.0,1.0,80.0,359
2876,47,50,97,3,4,20.0,1.0,80.0,359
2877,35,50,85,3,5,20.0,1.0,80.0,359
2878,35,64,99,3,6,20.0,1.0,80.0,359
2879,-25,25,0,3,7,20.0,1.0,80.0,359
2880,22,78,100,1,0,21.0,1.0,79.0,360
2881,0,100,100,1,1,21.0,1.0,79.0,360
2882,59,41,100,2,2,21.0,1.0,79.0,360
2883,-23,23,0,2,3,21.0,1.0,79.0,360
2884,19,81,100,3,4,21.0,1.0,79.0,360
2885,12,88,100,3,5,21.0,1.0,79.0,360
2886,65,35,100,3,6,21.0,1.0,79.0,360
2887,56,44,100,3,7,21.0,1.0,79.0,360
2888,-22,50,28,1,0,21.0,1.0,79.0,361
2889,5,31,36,1,1,21.0,1.0,79.0,361
2890,14,50,64,2,2,21.0,1.0,79.0,361
2891,5,58,63,2,3,21.0,1.0,79.0,361
2892,7,29,36,3,4,21.0,1.0,79.0,361
2893,14,50,64,3,5,21.0,1.0,79.0,361
2894,-41,67,26,3,6,21.0,1.0,79.0,361
2895,26,0,26,3,7,21.0,1.0,79.0,361
2896,-34,63,29,1,0,21.0,1.0,79.0,362
2897,10,65,75,1,1,21.0,1.0,79.0,362
2898,1,72,73,2,2,21.0,1.0,79.0,362
2899,15,57,72,2,3,21.0,1.0,79.0,362
2900,4,66,70,3,4,21.0,1.0,79.0,362
2901,40,30,70,3,5,21.0,1.0,79.0,362
2902,-10,91,81,3,6,21.0,1.0,79.0,362
2903,7,25,32,3,7,21.0,1.0,79.0,362
2904,61,18,79,1,0,21.0,1.0,79.0,363
2905,0,100,100,1,1,21.0,1.0,79.0,363
2906,60,16,76,2,2,21.0,1.0,79.0,363
2907,48,26,74,2,3,21.0,1.0,79.0,363
2908,10,76,86,3,4,21.0,1.0,79.0,363
2909,32,50,82,3,5,21.0,1.0,79.0,363
2910,57,26,83,3,6,21.0,1.0,79.0,363
2911,76,3,79,3,7,21.0,1.0,79.0,363
2912,14,57,71,1,0,21.0,1.0,79.0,364
2913,10,73,83,1,1,21.0,1.0,79.0,364
2914,8,39,47,2,2,21.0,1.0,79.0,364
2915,12,27,39,2,3,21.0,1.0,79.0,364
2916,7,59,66,3,4,21.0,1.0,79.0,364
2917,1,51,52,3,5,21.0,1.0,79.0,364
2918,8,47,55,3,6,21.0,1.0,79.0,364
2919,-5,52,47,3,7,21.0,1.0,79.0,364
2920,-19,69,50,1,0,21.0,1.0,79.0,365
2921,4,60,64,1,1,21.0,1.0,79.0,365
2922,21,0,21,2,2,21.0,1.0,79.0,365
2923,0,50,50,2,3,21.0,1.0,79.0,365
2924,-11,25,14,3,4,21.0,1.0,79.0,365
2925,0,50,50,3,5,21.0,1.0,79.0,365
2926,24,25,49,3,6,21.0,1.0,79.0,365
2927,0,0,0,3,7,21.0,1.0,79.0,365
2928,0,100,100,1,0,21.0,1.0,79.0,366
2929,10,90,100,1,1,21.0,1.0,79.0,366
2930,50,50,100,2,2,21.0,1.0,79.0,366
2931,27,73,100,2,3,21.0,1.0,79.0,366
2932,61,39,100,3,4,21.0,1.0,79.0,366
2933,100,0,100,3,5,21.0,1.0,79.0,366
2934,-26,26,0,3,6,21.0,1.0,79.0,366
2935,100,0,100,3,7,21.0,1.0,79.0,366
2936,0,100,100,1,0,21.0,1.0,79.0,367
2937,0,100,100,1,1,21.0,1.0,79.0,367
2938,100,0,100,2,2,21.0,1.0,79.0,367
2939,0,100,100,2,3,21.0,1.0,79.0,367
2940,8,92,100,3,4,21.0,1.0,79.0,367
2941,100,0,100,3,5,21.0,1.0,79.0,367
2942,75,25,100,3,6,21.0,1.0,79.0,367
2943,100,0,100,3,7,21.0,1.0,79.0,367
2944,-12,83,71,1,0,21.0,1.0,79.0,368
2945,5,1,6,1,1,21.0,1.0,79.0,368
2946,9,1,10,2,2,21.0,1.0,79.0,368
2947,14,64,78,2,3,21.0,1.0,79.0,368
2948,1,83,84,3,4,21.0,1.0,79.0,368
2949,55,19,74,3,5,21.0,1.0,79.0,368
2950,61,11,72,3,6,21.0,1.0,79.0,368
2951,1,4,5,3,7,21.0,1.0,79.0,368
2952,0,100,100,1,0,21.0,1.0,79.0,369
2953,0,100,100,1,1,21.0,1.0,79.0,369
2954,0,0,0,2,2,21.0,1.0,79.0,369
2955,100,0,100,2,3,21.0,1.0,79.0,369
2956,-1,51,50,3,4,21.0,1.0,79.0,369
2957,-9,40,31,3,5,21.0,1.0,79.0,369
2958,-11,39,28,3,6,21.0,1.0,79.0,369
2959,-11,34,23,3,7,21.0,1.0,79.0,369
2960,11,89,100,1,0,21.0,1.0,79.0,370
2961,7,93,100,1,1,21.0,1.0,79.0,370
2962,67,33,100,2,2,21.0,1.0,79.0,370
2963,100,0,100,2,3,21.0,1.0,79.0,370
2964,91,9,100,3,4,21.0,1.0,79.0,370
2965,50,50,100,3,5,21.0,1.0,79.0,370
2966,79,21,100,3,6,21.0,1.0,79.0,370
2967,93,7,100,3,7,21.0,1.0,79.0,370
2968,-2,97,95,1,0,21.0,1.0,79.0,371
2969,6,94,100,1,1,21.0,1.0,79.0,371
2970,56,21,77,2,2,21.0,1.0,79.0,371
2971,65,30,95,2,3,21.0,1.0,79.0,371
2972,-3,66,63,3,4,21.0,1.0,79.0,371
2973,66,11,77,3,5,21.0,1.0,79.0,371
2974,69,26,95,3,6,21.0,1.0,79.0,371
2975,81,16,97,3,7,21.0,1.0,79.0,371
2976,-20,49,29,1,0,21.0,1.0,79.0,372
2977,0,100,100,1,1,21.0,1.0,79.0,372
2978,-18,50,32,2,2,21.0,1.0,79.0,372
2979,41,26,67,2,3,21.0,1.0,79.0,372
2980,21,77,98,3,4,21.0,1.0,79.0,372
2981,66,21,87,3,5,21.0,1.0,79.0,372
2982,69,25,94,3,6,21.0,1.0,79.0,372
2983,43,49,92,3,7,21.0,1.0,79.0,372
2984,50,50,100,1,0,21.0,1.0,79.0,373
2985,0,100,100,1,1,21.0,1.0,79.0,373
2986,100,0,100,2,2,21.0,1.0,79.0,373
2987,100,0,100,2,3,21.0,1.0,79.0,373
2988,50,50,100,3,4,21.0,1.0,79.0,373
2989,74,26,100,3,5,21.0,1.0,79.0,373
2990,8,92,100,3,6,21.0,1.0,79.0,373
2991,100,0,100,3,7,21.0,1.0,79.0,373
2992,26,74,100,1,0,21.0,1.0,79.0,374
2993,11,89,100,1,1,21.0,1.0,79.0,374
2994,39,61,100,2,2,21.0,1.0,79.0,374
2995,36,64,100,2,3,21.0,1.0,79.0,374
2996,73,27,100,3,4,21.0,1.0,79.0,374
2997,49,51,100,3,5,21.0,1.0,79.0,374
2998,-6,6,0,3,6,21.0,1.0,79.0,374
2999,63,37,100,3,7,21.0,1.0,79.0,374
3000,-4,16,12,1,0,21.0,1.0,79.0,375
3001,17,83,100,1,1,21.0,1.0,79.0,375
3002,20,76,96,2,2,21.0,1.0,79.0,375
3003,-21,30,9,2,3,21.0,1.0,79.0,375
3004,5,58,63,3,4,21.0,1.0,79.0,375
3005,-2,13,11,3,5,21.0,1.0,79.0,375
3006,14,86,100,3,6,21.0,1.0,79.0,375
3007,10,7,17,3,7,21.0,1.0,79.0,375
3008,28,57,85,1,0,21.0,1.0,79.0,376
3009,28,53,81,1,1,21.0,1.0,79.0,376
3010,-19,47,28,2,2,21.0,1.0,79.0,376
3011,0,100,100,2,3,21.0,1.0,79.0,376
3012,21,68,89,3,4,21.0,1.0,79.0,376
3013,59,30,89,3,5,21.0,1.0,79.0,376
3014,68,27,95,3,6,21.0,1.0,79.0,376
3015,60,12,72,3,7,21.0,1.0,79.0,376
3016,11,72,83,1,0,21.0,1.0,79.0,377
3017,0,92,92,1,1,21.0,1.0,79.0,377
3018,46,25,71,2,2,21.0,1.0,79.0,377
3019,0,0,0,2,3,21.0,1.0,79.0,377
3020,57,13,70,3,4,21.0,1.0,79.0,377
3021,70,4,74,3,5,21.0,1.0,79.0,377
3022,57,22,79,3,6,21.0,1.0,79.0,377
3023,74,17,91,3,7,21.0,1.0,79.0,377
3024,-15,65,50,1,0,21.0,1.0,79.0,378
3025,-3,80,77,1,1,21.0,1.0,79.0,378
3026,0,25,25,2,2,21.0,1.0,79.0,378
3027,-4,29,25,2,3,21.0,1.0,79.0,378
3028,19,59,78,3,4,21.0,1.0,79.0,378
3029,1,50,51,3,5,21.0,1.0,79.0,378
3030,-3,26,23,3,6,21.0,1.0,79.0,378
3031,2,25,27,3,7,21.0,1.0,79.0,378
3032,50,50,100,1,0,22.0,1.0,78.0,379
3033,0,100,100,1,1,22.0,1.0,78.0,379
3034,50,0,50,2,2,22.0,1.0,78.0,379
3035,50,50,100,2,3,22.0,1.0,78.0,379
3036,0,50,50,3,4,22.0,1.0,78.0,379
3037,83,17,100,3,5,22.0,1.0,78.0,379
3038,21,79,100,3,6,22.0,1.0,78.0,379
3039,50,0,50,3,7,22.0,1.0,78.0,379
3040,16,84,100,1,0,22.0,1.0,78.0,380
3041,0,100,100,1,1,22.0,1.0,78.0,380
3042,62,0,62,2,2,22.0,1.0,78.0,380
3043,83,0,83,2,3,22.0,1.0,78.0,380
3044,10,90,100,3,4,22.0,1.0,78.0,380
3045,100,0,100,3,5,22.0,1.0,78.0,380
3046,-20,20,0,3,6,22.0,1.0,78.0,380
3047,29,0,29,3,7,22.0,1.0,78.0,380
3048,-31,100,69,1,0,22.0,1.0,78.0,381
3049,0,100,100,1,1,22.0,1.0,78.0,381
3050,5,50,55,2,2,22.0,1.0,78.0,381
3051,-23,50,27,2,3,22.0,1.0,78.0,381
3052,12,50,62,3,4,22.0,1.0,78.0,381
3053,24,50,74,3,5,22.0,1.0,78.0,381
3054,23,46,69,3,6,22.0,1.0,78.0,381
3055,14,46,60,3,7,22.0,1.0,78.0,381
3056,13,86,99,1,0,22.0,1.0,78.0,382
3057,-1,92,91,1,1,22.0,1.0,78.0,382
3058,66,28,94,2,2,22.0,1.0,78.0,382
3059,67,23,90,2,3,22.0,1.0,78.0,382
3060,68,18,86,3,4,22.0,1.0,78.0,382
3061,66,24,90,3,5,22.0,1.0,78.0,382
3062,0,84,84,3,6,22.0,1.0,78.0,382
3063,-3,20,17,3,7,22.0,1.0,78.0,382
3064,27,45,72,1,0,22.0,1.0,78.0,383
3065,14,78,92,1,1,22.0,1.0,78.0,383
3066,4,37,41,2,2,22.0,1.0,78.0,383
3067,41,9,50,2,3,22.0,1.0,78.0,383
3068,23,27,50,3,4,22.0,1.0,78.0,383
3069,12,66,78,3,5,22.0,1.0,78.0,383
3070,12,80,92,3,6,22.0,1.0,78.0,383
3071,13,26,39,3,7,22.0,1.0,78.0,383
3072,23,77,100,1,0,22.0,1.0,78.0,384
3073,0,100,100,1,1,22.0,1.0,78.0,384
3074,80,20,100,2,2,22.0,1.0,78.0,384
3075,80,20,100,2,3,22.0,1.0,78.0,384
3076,42,57,99,3,4,22.0,1.0,78.0,384
3077,54,46,100,3,5,22.0,1.0,78.0,384
3078,67,33,100,3,6,22.0,1.0,78.0,384
3079,20,80,100,3,7,22.0,1.0,78.0,384
3080,-72,100,28,1,0,22.0,1.0,78.0,385
3081,-82,100,18,1,1,22.0,1.0,78.0,385
3082,16,0,16,2,2,22.0,1.0,78.0,385
3083,76,0,76,2,3,22.0,1.0,78.0,385
3084,59,24,83,3,4,22.0,1.0,78.0,385
3085,28,50,78,3,5,22.0,1.0,78.0,385
3086,6,24,30,3,6,22.0,1.0,78.0,385
3087,81,0,81,3,7,22.0,1.0,78.0,385
3088,-16,32,16,1,0,22.0,1.0,78.0,386
3089,67,17,84,1,1,22.0,1.0,78.0,386
3090,1,20,21,2,2,22.0,1.0,78.0,386
3091,2,0,2,2,3,22.0,1.0,78.0,386
3092,-5,26,21,3,4,22.0,1.0,78.0,386
3093,72,28,100,3,5,22.0,1.0,78.0,386
3094,-14,36,22,3,6,22.0,1.0,78.0,386
3095,6,16,22,3,7,22.0,1.0,78.0,386
3096,38,62,100,1,0,22.0,1.0,78.0,387
3097,25,75,100,1,1,22.0,1.0,78.0,387
3098,100,0,100,2,2,22.0,1.0,78.0,387
3099,100,0,100,2,3,22.0,1.0,78.0,387
3100,39,61,100,3,4,22.0,1.0,78.0,387
3101,25,75,100,3,5,22.0,1.0,78.0,387
3102,82,18,100,3,6,22.0,1.0,78.0,387
3103,0,0,0,3,7,22.0,1.0,78.0,387
3104,50,50,100,1,0,22.0,1.0,78.0,388
3105,25,75,100,1,1,22.0,1.0,78.0,388
3106,100,0,100,2,2,22.0,1.0,78.0,388
3107,83,17,100,2,3,22.0,1.0,78.0,388
3108,55,45,100,3,4,22.0,1.0,78.0,388
3109,100,0,100,3,5,22.0,1.0,78.0,388
3110,45,55,100,3,6,22.0,1.0,78.0,388
3111,100,0,100,3,7,22.0,1.0,78.0,388
3112,66,6,72,1,0,22.0,1.0,78.0,389
3113,13,87,100,1,1,22.0,1.0,78.0,389
3114,70,15,85,2,2,22.0,1.0,78.0,389
3115,15,65,80,2,3,22.0,1.0,78.0,389
3116,17,83,100,3,4,22.0,1.0,78.0,389
3117,85,15,100,3,5,22.0,1.0,78.0,389
3118,11,66,77,3,6,22.0,1.0,78.0,389
3119,-4,18,14,3,7,22.0,1.0,78.0,389
3120,-3,32,29,1,0,22.0,1.0,78.0,390
3121,5,29,34,1,1,22.0,1.0,78.0,390
3122,12,17,29,2,2,22.0,1.0,78.0,390
3123,-4,29,25,2,3,22.0,1.0,78.0,390
3124,-6,15,9,3,4,22.0,1.0,78.0,390
3125,-6,28,22,3,5,22.0,1.0,78.0,390
3126,4,63,67,3,6,22.0,1.0,78.0,390
3127,2,27,29,3,7,22.0,1.0,78.0,390
3128,14,86,100,1,0,22.0,1.0,78.0,391
3129,0,0,0,1,1,22.0,1.0,78.0,391
3130,0,0,0,2,2,22.0,1.0,78.0,391
3131,0,0,0,2,3,22.0,1.0,78.0,391
3132,-1,97,96,3,4,22.0,1.0,78.0,391
3133,26,66,92,3,5,22.0,1.0,78.0,391
3134,1,0,1,3,6,22.0,1.0,78.0,391
3135,0,0,0,3,7,22.0,1.0,78.0,391
3136,36,64,100,1,0,22.0,1.0,78.0,392
3137,0,100,100,1,1,22.0,1.0,78.0,392
3138,-20,44,24,2,2,22.0,1.0,78.0,392
3139,-7,7,0,2,3,22.0,1.0,78.0,392
3140,5,70,75,3,4,22.0,1.0,78.0,392
3141,33,30,63,3,5,22.0,1.0,78.0,392
3142,26,74,100,3,6,22.0,1.0,78.0,392
3143,-13,40,27,3,7,22.0,1.0,78.0,392
3144,29,50,79,1,0,22.0,1.0,78.0,393
3145,-3,100,97,1,1,22.0,1.0,78.0,393
3146,90,0,90,2,2,22.0,1.0,78.0,393
3147,-19,100,81,2,3,22.0,1.0,78.0,393
3148,0,100,100,3,4,22.0,1.0,78.0,393
3149,19,55,74,3,5,22.0,1.0,78.0,393
3150,-12,100,88,3,6,22.0,1.0,78.0,393
3151,25,0,25,3,7,22.0,1.0,78.0,393
3152,-59,79,20,1,0,22.0,1.0,78.0,394
3153,-5,22,17,1,1,22.0,1.0,78.0,394
3154,3,19,22,2,2,22.0,1.0,78.0,394
3155,0,24,24,2,3,22.0,1.0,78.0,394
3156,27,49,76,3,4,22.0,1.0,78.0,394
3157,26,51,77,3,5,22.0,1.0,78.0,394
3158,0,73,73,3,6,22.0,1.0,78.0,394
3159,4,17,21,3,7,22.0,1.0,78.0,394
3160,-21,21,0,1,0,22.0,1.0,78.0,395
3161,12,88,100,1,1,22.0,1.0,78.0,395
3162,0,0,0,2,2,22.0,1.0,78.0,395
3163,0,0,0,2,3,22.0,1.0,78.0,395
3164,18,82,100,3,4,22.0,1.0,78.0,395
3165,0,0,0,3,5,22.0,1.0,78.0,395
3166,0,100,100,3,6,22.0,1.0,78.0,395
3167,0,0,0,3,7,22.0,1.0,78.0,395
3168,0,100,100,1,0,22.0,1.0,78.0,396
3169,99,1,100,1,1,22.0,1.0,78.0,396
3170,0,100,100,2,2,22.0,1.0,78.0,396
3171,100,0,100,2,3,22.0,1.0,78.0,396
3172,-2,4,2,3,4,22.0,1.0,78.0,396
3173,24,76,100,3,5,22.0,1.0,78.0,396
3174,0,100,100,3,6,22.0,1.0,78.0,396
3175,4,2,6,3,7,22.0,1.0,78.0,396
3176,100,0,100,1,0,22.0,1.0,78.0,397
3177,100,0,100,1,1,22.0,1.0,78.0,397
3178,50,50,100,2,2,22.0,1.0,78.0,397
3179,50,50,100,2,3,22.0,1.0,78.0,397
3180,77,23,100,3,4,22.0,1.0,78.0,397
3181,100,0,100,3,5,22.0,1.0,78.0,397
3182,50,50,100,3,6,22.0,1.0,78.0,397
3183,0,0,0,3,7,22.0,1.0,78.0,397
3184,-13,83,70,1,0,23.0,1.0,77.0,398
3185,0,100,100,1,1,23.0,1.0,77.0,398
3186,7,24,31,2,2,23.0,1.0,77.0,398
3187,43,20,63,2,3,23.0,1.0,77.0,398
3188,-1,50,49,3,4,23.0,1.0,77.0,398
3189,-6,56,50,3,5,23.0,1.0,77.0,398
3190,0,100,100,3,6,23.0,1.0,77.0,398
3191,27,0,27,3,7,23.0,1.0,77.0,398
3192,22,77,99,1,0,23.0,1.0,77.0,399
3193,60,38,98,1,1,23.0,1.0,77.0,399
3194,75,25,100,2,2,23.0,1.0,77.0,399
3195,37,60,97,2,3,23.0,1.0,77.0,399
3196,42,50,92,3,4,23.0,1.0,77.0,399
3197,27,71,98,3,5,23.0,1.0,77.0,399
3198,49,49,98,3,6,23.0,1.0,77.0,399
3199,73,20,93,3,7,23.0,1.0,77.0,399
3200,49,51,100,1,0,23.0,1.0,77.0,400
3201,1,99,100,1,1,23.0,1.0,77.0,400
3202,57,37,94,2,2,23.0,1.0,77.0,400
3203,-1,51,50,2,3,23.0,1.0,77.0,400
3204,38,62,100,3,4,23.0,1.0,77.0,400
3205,75,25,100,3,5,23.0,1.0,77.0,400
3206,1,99,100,3,6,23.0,1.0,77.0,400
3207,62,38,100,3,7,23.0,1.0,77.0,400
3208,-7,26,19,1,0,23.0,1.0,77.0,401
3209,0,100,100,1,1,23.0,1.0,77.0,401
3210,18,0,18,2,2,23.0,1.0,77.0,401
3211,30,20,50,2,3,23.0,1.0,77.0,401
3212,0,100,100,3,4,23.0,1.0,77.0,401
3213,68,12,80,3,5,23.0,1.0,77.0,401
3214,0,0,0,3,6,23.0,1.0,77.0,401
3215,0,100,100,3,7,23.0,1.0,77.0,401
3216,4,75,79,1,0,23.0,1.0,77.0,402
3217,-1,76,75,1,1,23.0,1.0,77.0,402
3218,-7,50,43,2,2,23.0,1.0,77.0,402
3219,0,11,11,2,3,23.0,1.0,77.0,402
3220,3,90,93,3,4,23.0,1.0,77.0,402
3221,25,12,37,3,5,23.0,1.0,77.0,402
3222,8,90,98,3,6,23.0,1.0,77.0,402
3223,-3,12,9,3,7,23.0,1.0,77.0,402
3224,100,0,100,1,0,23.0,1.0,77.0,403
3225,100,0,100,1,1,23.0,1.0,77.0,403
3226,70,30,100,2,2,23.0,1.0,77.0,403
3227,100,0,100,2,3,23.0,1.0,77.0,403
3228,19,65,84,3,4,23.0,1.0,77.0,403
3229,78,22,100,3,5,23.0,1.0,77.0,403
3230,-44,44,0,3,6,23.0,1.0,77.0,403
3231,-4,11,7,3,7,23.0,1.0,77.0,403
3232,4,70,74,1,0,23.0,1.0,77.0,404
3233,8,83,91,1,1,23.0,1.0,77.0,404
3234,55,27,82,2,2,23.0,1.0,77.0,404
3235,50,17,67,2,3,23.0,1.0,77.0,404
3236,19,63,82,3,4,23.0,1.0,77.0,404
3237,46,37,83,3,5,23.0,1.0,77.0,404
3238,-7,81,74,3,6,23.0,1.0,77.0,404
3239,8,27,35,3,7,23.0,1.0,77.0,404
3240,-5,35,30,1,0,23.0,1.0,77.0,405
3241,41,38,79,1,1,23.0,1.0,77.0,405
3242,11,20,31,2,2,23.0,1.0,77.0,405
3243,47,11,58,2,3,23.0,1.0,77.0,405
3244,-6,72,66,3,4,23.0,1.0,77.0,405
3245,-9,51,42,3,5,23.0,1.0,77.0,405
3246,-4,42,38,3,6,23.0,1.0,77.0,405
3247,30,13,43,3,7,23.0,1.0,77.0,405
3248,20,67,87,1,0,23.0,1.0,77.0,406
3249,88,0,88,1,1,23.0,1.0,77.0,406
3250,74,0,74,2,2,23.0,1.0,77.0,406
3251,44,36,80,2,3,23.0,1.0,77.0,406
3252,45,50,95,3,4,23.0,1.0,77.0,406
3253,40,50,90,3,5,23.0,1.0,77.0,406
3254,37,50,87,3,6,23.0,1.0,77.0,406
3255,55,33,88,3,7,23.0,1.0,77.0,406
3256,-13,76,63,1,0,23.0,1.0,77.0,407
3257,-9,79,70,1,1,23.0,1.0,77.0,407
3258,-12,70,58,2,2,23.0,1.0,77.0,407
3259,-29,79,50,2,3,23.0,1.0,77.0,407
3260,17,51,68,3,4,23.0,1.0,77.0,407
3261,1,66,67,3,5,23.0,1.0,77.0,407
3262,7,72,79,3,6,23.0,1.0,77.0,407
3263,-45,80,35,3,7,23.0,1.0,77.0,407
3264,-17,42,25,1,0,23.0,1.0,77.0,408
3265,58,21,79,1,1,23.0,1.0,77.0,408
3266,36,35,71,2,2,23.0,1.0,77.0,408
3267,20,44,64,2,3,23.0,1.0,77.0,408
3268,17,74,91,3,4,23.0,1.0,77.0,408
3269,89,10,99,3,5,23.0,1.0,77.0,408
3270,42,37,79,3,6,23.0,1.0,77.0,408
3271,59,22,81,3,7,23.0,1.0,77.0,408
3272,81,7,88,1,0,23.0,1.0,77.0,409
3273,57,29,86,1,1,23.0,1.0,77.0,409
3274,47,32,79,2,2,23.0,1.0,77.0,409
3275,63,6,69,2,3,23.0,1.0,77.0,409
3276,25,51,76,3,4,23.0,1.0,77.0,409
3277,58,13,71,3,5,23.0,1.0,77.0,409
3278,49,50,99,3,6,23.0,1.0,77.0,409
3279,-3,9,6,3,7,23.0,1.0,77.0,409
3280,6,94,100,1,0,23.0,1.0,77.0,410
3281,0,100,100,1,1,23.0,1.0,77.0,410
3282,79,21,100,2,2,23.0,1.0,77.0,410
3283,50,50,100,2,3,23.0,1.0,77.0,410
3284,23,77,100,3,4,23.0,1.0,77.0,410
3285,50,50,100,3,5,23.0,1.0,77.0,410
3286,50,50,100,3,6,23.0,1.0,77.0,410
3287,83,17,100,3,7,23.0,1.0,77.0,410
3288,-13,13,0,1,0,23.0,1.0,77.0,411
3289,0,0,0,1,1,23.0,1.0,77.0,411
3290,-3,3,0,2,2,23.0,1.0,77.0,411
3291,0,0,0,2,3,23.0,1.0,77.0,411
3292,-32,32,0,3,4,23.0,1.0,77.0,411
3293,0,0,0,3,5,23.0,1.0,77.0,411
3294,100,0,100,3,6,23.0,1.0,77.0,411
3295,0,0,0,3,7,23.0,1.0,77.0,411
3296,20,30,50,1,0,24.0,1.0,76.0,412
3297,-4,78,74,1,1,24.0,1.0,76.0,412
3298,6,17,23,2,2,24.0,1.0,76.0,412
3299,1,83,84,2,3,24.0,1.0,76.0,412
3300,-1,82,81,3,4,24.0,1.0,76.0,412
3301,2,19,21,3,5,24.0,1.0,76.0,412
3302,-3,88,85,3,6,24.0,1.0,76.0,412
3303,8,15,23,3,7,24.0,1.0,76.0,412
3304,14,86,100,1,0,24.0,1.0,76.0,413
3305,0,100,100,1,1,24.0,1.0,76.0,413
3306,49,0,49,2,2,24.0,1.0,76.0,413
3307,-22,96,74,2,3,24.0,1.0,76.0,413
3308,20,80,100,3,4,24.0,1.0,76.0,413
3309,33,50,83,3,5,24.0,1.0,76.0,413
3310,22,0,22,3,6,24.0,1.0,76.0,413
3311,46,9,55,3,7,24.0,1.0,76.0,413
3312,24,53,77,1,0,24.0,1.0,76.0,414
3313,14,86,100,1,1,24.0,1.0,76.0,414
3314,24,41,65,2,2,24.0,1.0,76.0,414
3315,30,40,70,2,3,24.0,1.0,76.0,414
3316,37,52,89,3,4,24.0,1.0,76.0,414
3317,28,48,76,3,5,24.0,1.0,76.0,414
3318,35,65,100,3,6,24.0,1.0,76.0,414
3319,35,55,90,3,7,24.0,1.0,76.0,414
3320,-48,78,30,1,0,24.0,1.0,76.0,415
3321,-23,84,61,1,1,24.0,1.0,76.0,415
3322,5,30,35,2,2,24.0,1.0,76.0,415
3323,-1,74,73,2,3,24.0,1.0,76.0,415
3324,-35,63,28,3,4,24.0,1.0,76.0,415
3325,33,34,67,3,5,24.0,1.0,76.0,415
3326,-38,74,36,3,6,24.0,1.0,76.0,415
3327,-11,50,39,3,7,24.0,1.0,76.0,415
3328,50,50,100,1,0,24.0,1.0,76.0,416
3329,-25,25,0,1,1,24.0,1.0,76.0,416
3330,-1,51,50,2,2,24.0,1.0,76.0,416
3331,50,50,100,2,3,24.0,1.0,76.0,416
3332,49,51,100,3,4,24.0,1.0,76.0,416
3333,13,87,100,3,5,24.0,1.0,76.0,416
3334,100,0,100,3,6,24.0,1.0,76.0,416
3335,49,50,99,3,7,24.0,1.0,76.0,416
3336,21,79,100,1,0,24.0,1.0,76.0,417
3337,0,100,100,1,1,24.0,1.0,76.0,417
3338,100,0,100,2,2,24.0,1.0,76.0,417
3339,-90,90,0,2,3,24.0,1.0,76.0,417
3340,27,73,100,3,4,24.0,1.0,76.0,417
3341,50,50,100,3,5,24.0,1.0,76.0,417
3342,50,50,100,3,6,24.0,1.0,76.0,417
3343,0,0,0,3,7,24.0,1.0,76.0,417
3344,-9,93,84,1,0,24.0,1.0,76.0,418
3345,3,79,82,1,1,24.0,1.0,76.0,418
3346,18,11,29,2,2,24.0,1.0,76.0,418
3347,17,0,17,2,3,24.0,1.0,76.0,418
3348,16,42,58,3,4,24.0,1.0,76.0,418
3349,72,16,88,3,5,24.0,1.0,76.0,418
3350,-3,68,65,3,6,24.0,1.0,76.0,418
3351,16,18,34,3,7,24.0,1.0,76.0,418
3352,37,36,73,1,0,24.0,1.0,76.0,419
3353,51,45,96,1,1,24.0,1.0,76.0,419
3354,59,39,98,2,2,24.0,1.0,76.0,419
3355,55,44,99,2,3,24.0,1.0,76.0,419
3356,5,95,100,3,4,24.0,1.0,76.0,419
3357,43,53,96,3,5,24.0,1.0,76.0,419
3358,-31,34,3,3,6,24.0,1.0,76.0,419
3359,89,9,98,3,7,24.0,1.0,76.0,419
3360,-22,65,43,1,0,24.0,1.0,76.0,420
3361,-1,96,95,1,1,24.0,1.0,76.0,420
3362,16,39,55,2,2,24.0,1.0,76.0,420
3363,-24,67,43,2,3,24.0,1.0,76.0,420
3364,21,68,89,3,4,24.0,1.0,76.0,420
3365,36,64,100,3,5,24.0,1.0,76.0,420
3366,31,68,99,3,6,24.0,1.0,76.0,420
3367,10,40,50,3,7,24.0,1.0,76.0,420
3368,-2,15,13,1,0,24.0,1.0,76.0,421
3369,1,92,93,1,1,24.0,1.0,76.0,421
3370,-38,73,35,2,2,24.0,1.0,76.0,421
3371,51,20,71,2,3,24.0,1.0,76.0,421
3372,-30,64,34,3,4,24.0,1.0,76.0,421
3373,20,10,30,3,5,24.0,1.0,76.0,421
3374,-1,34,33,3,6,24.0,1.0,76.0,421
3375,-19,39,20,3,7,24.0,1.0,76.0,421
3376,2,96,98,1,0,24.0,1.0,76.0,422
3377,-5,100,95,1,1,24.0,1.0,76.0,422
3378,69,12,81,2,2,24.0,1.0,76.0,422
3379,12,79,91,2,3,24.0,1.0,76.0,422
3380,85,0,85,3,4,24.0,1.0,76.0,422
3381,6,73,79,3,5,24.0,1.0,76.0,422
3382,47,28,75,3,6,24.0,1.0,76.0,422
3383,30,0,30,3,7,24.0,1.0,76.0,422
3384,-8,78,70,1,0,24.0,1.0,76.0,423
3385,7,3,10,1,1,24.0,1.0,76.0,423
3386,2,31,33,2,2,24.0,1.0,76.0,423
3387,36,32,68,2,3,24.0,1.0,76.0,423
3388,-2,67,65,3,4,24.0,1.0,76.0,423
3389,0,33,33,3,5,24.0,1.0,76.0,423
3390,-1,63,62,3,6,24.0,1.0,76.0,423
3391,3,27,30,3,7,24.0,1.0,76.0,423
3392,100,0,100,1,0,24.0,1.0,76.0,424
3393,9,85,94,1,1,24.0,1.0,76.0,424
3394,36,50,86,2,2,24.0,1.0,76.0,424
3395,91,0,91,2,3,24.0,1.0,76.0,424
3396,49,37,86,3,4,24.0,1.0,76.0,424
3397,60,33,93,3,5,24.0,1.0,76.0,424
3398,0,100,100,3,6,24.0,1.0,76.0,424
3399,98,0,98,3,7,24.0,1.0,76.0,424
3400,0,0,0,1,0,24.0,1.0,76.0,425
3401,100,0,100,1,1,24.0,1.0,76.0,425
3402,12,0,12,2,2,24.0,1.0,76.0,425
3403,0,0,0,2,3,24.0,1.0,76.0,425
3404,41,59,100,3,4,24.0,1.0,76.0,425
3405,100,0,100,3,5,24.0,1.0,76.0,425
3406,0,100,100,3,6,24.0,1.0,76.0,425
3407,14,65,79,3,7,24.0,1.0,76.0,425
3408,53,20,73,1,0,24.0,1.0,76.0,426
3409,52,21,73,1,1,24.0,1.0,76.0,426
3410,-44,74,30,2,2,24.0,1.0,76.0,426
3411,6,77,83,2,3,24.0,1.0,76.0,426
3412,7,74,81,3,4,24.0,1.0,76.0,426
3413,0,73,73,3,5,24.0,1.0,76.0,426
3414,-3,74,71,3,6,24.0,1.0,76.0,426
3415,0,73,73,3,7,24.0,1.0,76.0,426
3416,-8,50,42,1,0,24.0,1.0,76.0,427
3417,-8,65,57,1,1,24.0,1.0,76.0,427
3418,23,6,29,2,2,24.0,1.0,76.0,427
3419,4,1,5,2,3,24.0,1.0,76.0,427
3420,-16,75,59,3,4,24.0,1.0,76.0,427
3421,43,12,55,3,5,24.0,1.0,76.0,427
3422,12,27,39,3,6,24.0,1.0,76.0,427
3423,15,8,23,3,7,24.0,1.0,76.0,427
3424,0,50,50,1,0,25.0,1.0,75.0,428
3425,-1,96,95,1,1,25.0,1.0,75.0,428
3426,0,25,25,2,2,25.0,1.0,75.0,428
3427,13,12,25,2,3,25.0,1.0,75.0,428
3428,0,50,50,3,4,25.0,1.0,75.0,428
3429,0,50,50,3,5,25.0,1.0,75.0,428
3430,0,25,25,3,6,25.0,1.0,75.0,428
3431,-1,27,26,3,7,25.0,1.0,75.0,428
3432,50,50,100,1,0,25.0,1.0,75.0,429
3433,50,50,100,1,1,25.0,1.0,75.0,429
3434,50,0,50,2,2,25.0,1.0,75.0,429
3435,75,25,100,2,3,25.0,1.0,75.0,429
3436,50,50,100,3,4,25.0,1.0,75.0,429
3437,85,15,100,3,5,25.0,1.0,75.0,429
3438,90,10,100,3,6,25.0,1.0,75.0,429
3439,100,0,100,3,7,25.0,1.0,75.0,429
3440,6,94,100,1,0,25.0,1.0,75.0,430
3441,6,94,100,1,1,25.0,1.0,75.0,430
3442,93,6,99,2,2,25.0,1.0,75.0,430
3443,99,0,99,2,3,25.0,1.0,75.0,430
3444,12,88,100,3,4,25.0,1.0,75.0,430
3445,74,24,98,3,5,25.0,1.0,75.0,430
3446,2,98,100,3,6,25.0,1.0,75.0,430
3447,-6,6,0,3,7,25.0,1.0,75.0,430
3448,24,72,96,1,0,25.0,1.0,75.0,431
3449,23,77,100,1,1,25.0,1.0,75.0,431
3450,49,37,86,2,2,25.0,1.0,75.0,431
3451,45,28,73,2,3,25.0,1.0,75.0,431
3452,20,70,90,3,4,25.0,1.0,75.0,431
3453,24,50,74,3,5,25.0,1.0,75.0,431
3454,39,37,76,3,6,25.0,1.0,75.0,431
3455,-23,42,19,3,7,25.0,1.0,75.0,431
3456,80,20,100,1,0,25.0,1.0,75.0,432
3457,57,43,100,1,1,25.0,1.0,75.0,432
3458,88,12,100,2,2,25.0,1.0,75.0,432
3459,19,50,69,2,3,25.0,1.0,75.0,432
3460,47,53,100,3,4,25.0,1.0,75.0,432
3461,87,13,100,3,5,25.0,1.0,75.0,432
3462,-35,75,40,3,6,25.0,1.0,75.0,432
3463,4,0,4,3,7,25.0,1.0,75.0,432
3464,45,30,75,1,0,25.0,1.0,75.0,433
3465,25,50,75,1,1,25.0,1.0,75.0,433
3466,50,25,75,2,2,25.0,1.0,75.0,433
3467,25,25,50,2,3,25.0,1.0,75.0,433
3468,25,25,50,3,4,25.0,1.0,75.0,433
3469,0,50,50,3,5,25.0,1.0,75.0,433
3470,0,100,100,3,6,25.0,1.0,75.0,433
3471,25,50,75,3,7,25.0,1.0,75.0,433
3472,58,32,90,1,0,25.0,1.0,75.0,434
3473,-19,19,0,1,1,25.0,1.0,75.0,434
3474,20,69,89,2,2,25.0,1.0,75.0,434
3475,-11,26,15,2,3,25.0,1.0,75.0,434
3476,27,70,97,3,4,25.0,1.0,75.0,434
3477,51,28,79,3,5,25.0,1.0,75.0,434
3478,-73,88,15,3,6,25.0,1.0,75.0,434
3479,8,67,75,3,7,25.0,1.0,75.0,434
3480,-1,100,99,1,0,25.0,1.0,75.0,435
3481,0,100,100,1,1,25.0,1.0,75.0,435
3482,100,0,100,2,2,25.0,1.0,75.0,435
3483,11,89,100,2,3,25.0,1.0,75.0,435
3484,9,90,99,3,4,25.0,1.0,75.0,435
3485,100,0,100,3,5,25.0,1.0,75.0,435
3486,23,0,23,3,6,25.0,1.0,75.0,435
3487,74,13,87,3,7,25.0,1.0,75.0,435
3488,50,26,76,1,0,25.0,1.0,75.0,436
3489,6,64,70,1,1,25.0,1.0,75.0,436
3490,39,24,63,2,2,25.0,1.0,75.0,436
3491,51,12,63,2,3,25.0,1.0,75.0,436
3492,18,32,50,3,4,25.0,1.0,75.0,436
3493,0,50,50,3,5,25.0,1.0,75.0,436
3494,26,50,76,3,6,25.0,1.0,75.0,436
3495,47,16,63,3,7,25.0,1.0,75.0,436
3496,30,20,50,1,0,25.0,1.0,75.0,437
3497,0,100,100,1,1,25.0,1.0,75.0,437
3498,0,50,50,2,2,25.0,1.0,75.0,437
3499,25,25,50,2,3,25.0,1.0,75.0,437
3500,26,50,76,3,4,25.0,1.0,75.0,437
3501,79,10,89,3,5,25.0,1.0,75.0,437
3502,40,50,90,3,6,25.0,1.0,75.0,437
3503,0,0,0,3,7,25.0,1.0,75.0,437
3504,32,68,100,1,0,25.0,1.0,75.0,438
3505,15,85,100,1,1,25.0,1.0,75.0,438
3506,64,23,87,2,2,25.0,1.0,75.0,438
3507,43,34,77,2,3,25.0,1.0,75.0,438
3508,13,55,68,3,4,25.0,1.0,75.0,438
3509,31,60,91,3,5,25.0,1.0,75.0,438
3510,81,19,100,3,6,25.0,1.0,75.0,438
3511,-4,39,35,3,7,25.0,1.0,75.0,438
3512,0,100,100,1,0,25.0,1.0,75.0,439
3513,-2,100,98,1,1,25.0,1.0,75.0,439
3514,40,39,79,2,2,25.0,1.0,75.0,439
3515,25,37,62,2,3,25.0,1.0,75.0,439
3516,31,37,68,3,4,25.0,1.0,75.0,439
3517,-6,75,69,3,5,25.0,1.0,75.0,439
3518,-58,100,42,3,6,25.0,1.0,75.0,439
3519,-32,74,42,3,7,25.0,1.0,75.0,439
3520,7,75,82,1,0,25.0,1.0,75.0,440
3521,-10,35,25,1,1,25.0,1.0,75.0,440
3522,-23,50,27,2,2,25.0,1.0,75.0,440
3523,-3,80,77,2,3,25.0,1.0,75.0,440
3524,2,81,83,3,4,25.0,1.0,75.0,440
3525,-48,78,30,3,5,25.0,1.0,75.0,440
3526,-8,36,28,3,6,25.0,1.0,75.0,440
3527,4,27,31,3,7,25.0,1.0,75.0,440
3528,-4,90,86,1,0,25.0,1.0,75.0,441
3529,18,75,93,1,1,25.0,1.0,75.0,441
3530,-3,29,26,2,2,25.0,1.0,75.0,441
3531,23,50,73,2,3,25.0,1.0,75.0,441
3532,32,22,54,3,4,25.0,1.0,75.0,441
3533,35,50,85,3,5,25.0,1.0,75.0,441
3534,6,50,56,3,6,25.0,1.0,75.0,441
3535,25,50,75,3,7,25.0,1.0,75.0,441
3536,22,73,95,1,0,25.0,1.0,75.0,442
3537,9,91,100,1,1,25.0,1.0,75.0,442
3538,36,36,72,2,2,25.0,1.0,75.0,442
3539,53,16,69,2,3,25.0,1.0,75.0,442
3540,13,87,100,3,4,25.0,1.0,75.0,442
3541,8,61,69,3,5,25.0,1.0,75.0,442
3542,61,37,98,3,6,25.0,1.0,75.0,442
3543,37,37,74,3,7,25.0,1.0,75.0,442
3544,-16,81,65,1,0,25.0,1.0,75.0,443
3545,-14,80,66,1,1,25.0,1.0,75.0,443
3546,9,32,41,2,2,25.0,1.0,75.0,443
3547,-6,70,64,2,3,25.0,1.0,75.0,443
3548,17,38,55,3,4,25.0,1.0,75.0,443
3549,4,44,48,3,5,25.0,1.0,75.0,443
3550,34,34,68,3,6,25.0,1.0,75.0,443
3551,12,34,46,3,7,25.0,1.0,75.0,443
3552,5,68,73,1,0,25.0,1.0,75.0,444
3553,8,59,67,1,1,25.0,1.0,75.0,444
3554,47,14,61,2,2,25.0,1.0,75.0,444
3555,8,48,56,2,3,25.0,1.0,75.0,444
3556,31,66,97,3,4,25.0,1.0,75.0,444
3557,17,0,17,3,5,25.0,1.0,75.0,444
3558,-2,26,24,3,6,25.0,1.0,75.0,444
3559,12,13,25,3,7,25.0,1.0,75.0,444
3560,13,87,100,1,0,25.0,1.0,75.0,445
3561,0,100,100,1,1,25.0,1.0,75.0,445
3562,60,7,67,2,2,25.0,1.0,75.0,445
3563,5,0,5,2,3,25.0,1.0,75.0,445
3564,11,80,91,3,4,25.0,1.0,75.0,445
3565,73,7,80,3,5,25.0,1.0,75.0,445
3566,44,10,54,3,6,25.0,1.0,75.0,445
3567,0,0,0,3,7,25.0,1.0,75.0,445
3568,10,80,90,1,0,25.0,1.0,75.0,446
3569,10,90,100,1,1,25.0,1.0,75.0,446
3570,60,25,85,2,2,25.0,1.0,75.0,446
3571,70,0,70,2,3,25.0,1.0,75.0,446
3572,30,70,100,3,4,25.0,1.0,75.0,446
3573,50,50,100,3,5,25.0,1.0,75.0,446
3574,65,30,95,3,6,25.0,1.0,75.0,446
3575,45,45,90,3,7,25.0,1.0,75.0,446
3576,6,59,65,1,0,25.0,1.0,75.0,447
3577,6,10,16,1,1,25.0,1.0,75.0,447
3578,27,35,62,2,2,25.0,1.0,75.0,447
3579,30,50,80,2,3,25.0,1.0,75.0,447
3580,13,62,75,3,4,25.0,1.0,75.0,447
3581,6,58,64,3,5,25.0,1.0,75.0,447
3582,48,25,73,3,6,25.0,1.0,75.0,447
3583,13,53,66,3,7,25.0,1.0,75.0,447
3584,8,58,66,1,0,25.0,1.0,75.0,448
3585,24,45,69,1,1,25.0,1.0,75.0,448
3586,10,23,33,2,2,25.0,1.0,75.0,448
3587,1,63,64,2,3,25.0,1.0,75.0,448
3588,4,59,63,3,4,25.0,1.0,75.0,448
3589,6,59,65,3,5,25.0,1.0,75.0,448
3590,1,60,61,3,6,25.0,1.0,75.0,448
3591,-10,71,61,3,7,25.0,1.0,75.0,448
3592,100,0,100,1,0,25.0,1.0,75.0,449
3593,-100,100,0,1,1,25.0,1.0,75.0,449
3594,90,0,90,2,2,25.0,1.0,75.0,449
3595,80,0,80,2,3,25.0,1.0,75.0,449
3596,50,50,100,3,4,25.0,1.0,75.0,449
3597,100,0,100,3,5,25.0,1.0,75.0,449
3598,10,90,100,3,6,25.0,1.0,75.0,449
3599,100,0,100,3,7,25.0,1.0,75.0,449
3600,-1,83,82,1,0,25.0,1.0,75.0,450
3601,78,22,100,1,1,25.0,1.0,75.0,450
3602,-17,94,77,2,2,25.0,1.0,75.0,450
3603,-17,86,69,2,3,25.0,1.0,75.0,450
3604,75,8,83,3,4,25.0,1.0,75.0,450
3605,58,27,85,3,5,25.0,1.0,75.0,450
3606,11,76,87,3,6,25.0,1.0,75.0,450
3607,1,89,90,3,7,25.0,1.0,75.0,450
3608,76,24,100,1,0,25.0,1.0,75.0,451
3609,100,0,100,1,1,25.0,1.0,75.0,451
3610,58,42,100,2,2,25.0,1.0,75.0,451
3611,80,20,100,2,3,25.0,1.0,75.0,451
3612,24,76,100,3,4,25.0,1.0,75.0,451
3613,98,2,100,3,5,25.0,1.0,75.0,451
3614,-69,69,0,3,6,25.0,1.0,75.0,451
3615,100,0,100,3,7,25.0,1.0,75.0,451
3616,-16,75,59,1,0,25.0,1.0,75.0,452
3617,14,56,70,1,1,25.0,1.0,75.0,452
3618,-1,35,34,2,2,25.0,1.0,75.0,452
3619,0,70,70,2,3,25.0,1.0,75.0,452
3620,-6,40,34,3,4,25.0,1.0,75.0,452
3621,-3,48,45,3,5,25.0,1.0,75.0,452
3622,-9,40,31,3,6,25.0,1.0,75.0,452
3623,-7,78,71,3,7,25.0,1.0,75.0,452
3624,-16,93,77,1,0,25.0,1.0,75.0,453
3625,18,79,97,1,1,25.0,1.0,75.0,453
3626,-30,50,20,2,2,25.0,1.0,75.0,453
3627,-8,32,24,2,3,25.0,1.0,75.0,453
3628,-64,93,29,3,4,25.0,1.0,75.0,453
3629,5,18,23,3,5,25.0,1.0,75.0,453
3630,62,25,87,3,6,25.0,1.0,75.0,453
3631,-49,74,25,3,7,25.0,1.0,75.0,453
3632,59,41,100,1,0,26.0,1.0,74.0,454
3633,57,43,100,1,1,26.0,1.0,74.0,454
3634,65,35,100,2,2,26.0,1.0,74.0,454
3635,95,5,100,2,3,26.0,1.0,74.0,454
3636,84,16,100,3,4,26.0,1.0,74.0,454
3637,42,58,100,3,5,26.0,1.0,74.0,454
3638,22,78,100,3,6,26.0,1.0,74.0,454
3639,90,10,100,3,7,26.0,1.0,74.0,454
3640,1,99,100,1,0,26.0,1.0,74.0,455
3641,0,100,100,1,1,26.0,1.0,74.0,455
3642,11,9,20,2,2,26.0,1.0,74.0,455
3643,49,4,53,2,3,26.0,1.0,74.0,455
3644,9,91,100,3,4,26.0,1.0,74.0,455
3645,54,46,100,3,5,26.0,1.0,74.0,455
3646,58,39,97,3,6,26.0,1.0,74.0,455
3647,-40,50,10,3,7,26.0,1.0,74.0,455
3648,22,78,100,1,0,26.0,1.0,74.0,456
3649,0,100,100,1,1,26.0,1.0,74.0,456
3650,68,32,100,2,2,26.0,1.0,74.0,456
3651,42,58,100,2,3,26.0,1.0,74.0,456
3652,46,54,100,3,4,26.0,1.0,74.0,456
3653,50,50,100,3,5,26.0,1.0,74.0,456
3654,-53,53,0,3,6,26.0,1.0,74.0,456
3655,-6,6,0,3,7,26.0,1.0,74.0,456
3656,-2,68,66,1,0,26.0,1.0,74.0,457
3657,29,44,73,1,1,26.0,1.0,74.0,457
3658,2,63,65,2,2,26.0,1.0,74.0,457
3659,-41,75,34,2,3,26.0,1.0,74.0,457
3660,13,78,91,3,4,26.0,1.0,74.0,457
3661,50,18,68,3,5,26.0,1.0,74.0,457
3662,0,68,68,3,6,26.0,1.0,74.0,457
3663,38,34,72,3,7,26.0,1.0,74.0,457
3664,0,50,50,1,0,26.0,1.0,74.0,458
3665,0,50,50,1,1,26.0,1.0,74.0,458
3666,50,0,50,2,2,26.0,1.0,74.0,458
3667,50,50,100,2,3,26.0,1.0,74.0,458
3668,0,100,100,3,4,26.0,1.0,74.0,458
3669,0,50,50,3,5,26.0,1.0,74.0,458
3670,0,50,50,3,6,26.0,1.0,74.0,458
3671,0,50,50,3,7,26.0,1.0,74.0,458
3672,55,35,90,1,0,26.0,1.0,74.0,459
3673,38,39,77,1,1,26.0,1.0,74.0,459
3674,41,24,65,2,2,26.0,1.0,74.0,459
3675,40,19,59,2,3,26.0,1.0,74.0,459
3676,28,33,61,3,4,26.0,1.0,74.0,459
3677,71,13,84,3,5,26.0,1.0,74.0,459
3678,33,61,94,3,6,26.0,1.0,74.0,459
3679,55,0,55,3,7,26.0,1.0,74.0,459
3680,-11,42,31,1,0,27.0,1.0,73.0,460
3681,-1,90,89,1,1,27.0,1.0,73.0,460
3682,63,0,63,2,2,27.0,1.0,73.0,460
3683,76,0,76,2,3,27.0,1.0,73.0,460
3684,-6,91,85,3,4,27.0,1.0,73.0,460
3685,0,0,0,3,5,27.0,1.0,73.0,460
3686,-3,100,97,3,6,27.0,1.0,73.0,460
3687,0,0,0,3,7,27.0,1.0,73.0,460
3688,25,50,75,1,0,27.0,1.0,73.0,461
3689,8,68,76,1,1,27.0,1.0,73.0,461
3690,47,27,74,2,2,27.0,1.0,73.0,461
3691,50,29,79,2,3,27.0,1.0,73.0,461
3692,48,21,69,3,4,27.0,1.0,73.0,461
3693,34,39,73,3,5,27.0,1.0,73.0,461
3694,-21,55,34,3,6,27.0,1.0,73.0,461
3695,37,30,67,3,7,27.0,1.0,73.0,461
3696,30,50,80,1,0,27.0,1.0,73.0,462
3697,6,84,90,1,1,27.0,1.0,73.0,462
3698,45,20,65,2,2,27.0,1.0,73.0,462
3699,29,37,66,2,3,27.0,1.0,73.0,462
3700,2,73,75,3,4,27.0,1.0,73.0,462
3701,13,50,63,3,5,27.0,1.0,73.0,462
3702,47,27,74,3,6,27.0,1.0,73.0,462
3703,43,7,50,3,7,27.0,1.0,73.0,462
3704,63,37,100,1,0,27.0,1.0,73.0,463
3705,0,0,0,1,1,27.0,1.0,73.0,463
3706,0,0,0,2,2,27.0,1.0,73.0,463
3707,6,62,68,2,3,27.0,1.0,73.0,463
3708,-21,50,29,3,4,27.0,1.0,73.0,463
3709,1,99,100,3,5,27.0,1.0,73.0,463
3710,21,79,100,3,6,27.0,1.0,73.0,463
3711,0,0,0,3,7,27.0,1.0,73.0,463
3712,21,79,100,1,0,27.0,1.0,73.0,464
3713,25,75,100,1,1,27.0,1.0,73.0,464
3714,19,63,82,2,2,27.0,1.0,73.0,464
3715,-25,25,0,2,3,27.0,1.0,73.0,464
3716,31,66,97,3,4,27.0,1.0,73.0,464
3717,76,24,100,3,5,27.0,1.0,73.0,464
3718,29,71,100,3,6,27.0,1.0,73.0,464
3719,78,22,100,3,7,27.0,1.0,73.0,464
3720,10,50,60,1,0,27.0,1.0,73.0,465
3721,6,75,81,1,1,27.0,1.0,73.0,465
3722,30,50,80,2,2,27.0,1.0,73.0,465
3723,11,49,60,2,3,27.0,1.0,73.0,465
3724,69,17,86,3,4,27.0,1.0,73.0,465
3725,8,31,39,3,5,27.0,1.0,73.0,465
3726,55,33,88,3,6,27.0,1.0,73.0,465
3727,94,0,94,3,7,27.0,1.0,73.0,465
3728,-33,56,23,1,0,27.0,1.0,73.0,466
3729,100,0,100,1,1,27.0,1.0,73.0,466
3730,47,29,76,2,2,27.0,1.0,73.0,466
3731,0,0,0,2,3,27.0,1.0,73.0,466
3732,-42,83,41,3,4,27.0,1.0,73.0,466
3733,-11,39,28,3,5,27.0,1.0,73.0,466
3734,38,62,100,3,6,27.0,1.0,73.0,466
3735,38,1,39,3,7,27.0,1.0,73.0,466
3736,-59,78,19,1,0,27.0,1.0,73.0,467
3737,4,69,73,1,1,27.0,1.0,73.0,467
3738,-56,75,19,2,2,27.0,1.0,73.0,467
3739,3,81,84,2,3,27.0,1.0,73.0,467
3740,6,73,79,3,4,27.0,1.0,73.0,467
3741,-4,75,71,3,5,27.0,1.0,73.0,467
3742,19,68,87,3,6,27.0,1.0,73.0,467
3743,27,0,27,3,7,27.0,1.0,73.0,467
3744,35,50,85,1,0,27.0,1.0,73.0,468
3745,-78,83,5,1,1,27.0,1.0,73.0,468
3746,50,35,85,2,2,27.0,1.0,73.0,468
3747,64,36,100,2,3,27.0,1.0,73.0,468
3748,54,36,90,3,4,27.0,1.0,73.0,468
3749,1,72,73,3,5,27.0,1.0,73.0,468
3750,17,83,100,3,6,27.0,1.0,73.0,468
3751,86,0,86,3,7,27.0,1.0,73.0,468
3752,33,55,88,1,0,27.0,1.0,73.0,469
3753,100,0,100,1,1,27.0,1.0,73.0,469
3754,55,33,88,2,2,27.0,1.0,73.0,469
3755,22,78,100,2,3,27.0,1.0,73.0,469
3756,14,86,100,3,4,27.0,1.0,73.0,469
3757,31,69,100,3,5,27.0,1.0,73.0,469
3758,19,57,76,3,6,27.0,1.0,73.0,469
3759,100,0,100,3,7,27.0,1.0,73.0,469
3760,-23,50,27,1,0,27.0,1.0,73.0,470
3761,84,8,92,1,1,27.0,1.0,73.0,470
3762,82,18,100,2,2,27.0,1.0,73.0,470
3763,25,75,100,2,3,27.0,1.0,73.0,470
3764,79,21,100,3,4,27.0,1.0,73.0,470
3765,24,76,100,3,5,27.0,1.0,73.0,470
3766,54,25,79,3,6,27.0,1.0,73.0,470
3767,92,0,92,3,7,27.0,1.0,73.0,470
3768,28,72,100,1,0,27.0,1.0,73.0,471
3769,10,67,77,1,1,27.0,1.0,73.0,471
3770,53,31,84,2,2,27.0,1.0,73.0,471
3771,62,15,77,2,3,27.0,1.0,73.0,471
3772,28,72,100,3,4,27.0,1.0,73.0,471
3773,29,71,100,3,5,27.0,1.0,73.0,471
3774,37,28,65,3,6,27.0,1.0,73.0,471
3775,-4,41,37,3,7,27.0,1.0,73.0,471
3776,21,37,58,1,0,27.0,1.0,73.0,472
3777,-14,67,53,1,1,27.0,1.0,73.0,472
3778,-21,76,55,2,2,27.0,1.0,73.0,472
3779,16,57,73,2,3,27.0,1.0,73.0,472
3780,1,40,41,3,4,27.0,1.0,73.0,472
3781,17,54,71,3,5,27.0,1.0,73.0,472
3782,-8,64,56,3,6,27.0,1.0,73.0,472
3783,2,36,38,3,7,27.0,1.0,73.0,472
3784,45,31,76,1,0,27.0,1.0,73.0,473
3785,8,68,76,1,1,27.0,1.0,73.0,473
3786,48,32,80,2,2,27.0,1.0,73.0,473
3787,46,31,77,2,3,27.0,1.0,73.0,473
3788,15,74,89,3,4,27.0,1.0,73.0,473
3789,62,25,87,3,5,27.0,1.0,73.0,473
3790,22,73,95,3,6,27.0,1.0,73.0,473
3791,50,25,75,3,7,27.0,1.0,73.0,473
3792,63,37,100,1,0,27.0,1.0,73.0,474
3793,0,100,100,1,1,27.0,1.0,73.0,474
3794,67,33,100,2,2,27.0,1.0,73.0,474
3795,51,24,75,2,3,27.0,1.0,73.0,474
3796,69,31,100,3,4,27.0,1.0,73.0,474
3797,100,0,100,3,5,27.0,1.0,73.0,474
3798,16,84,100,3,6,27.0,1.0,73.0,474
3799,0,0,0,3,7,27.0,1.0,73.0,474
3800,9,69,78,1,0,27.0,1.0,73.0,475
3801,-52,69,17,1,1,27.0,1.0,73.0,475
3802,19,31,50,2,2,27.0,1.0,73.0,475
3803,15,6,21,2,3,27.0,1.0,73.0,475
3804,7,67,74,3,4,27.0,1.0,73.0,475
3805,23,50,73,3,5,27.0,1.0,73.0,475
3806,0,100,100,3,6,27.0,1.0,73.0,475
3807,-17,25,8,3,7,27.0,1.0,73.0,475
3808,-12,30,18,1,0,27.0,1.0,73.0,476
3809,33,67,100,1,1,27.0,1.0,73.0,476
3810,19,81,100,2,2,27.0,1.0,73.0,476
3811,16,69,85,2,3,27.0,1.0,73.0,476
3812,-14,56,42,3,4,27.0,1.0,73.0,476
3813,1,27,28,3,5,27.0,1.0,73.0,476
3814,4,82,86,3,6,27.0,1.0,73.0,476
3815,-6,36,30,3,7,27.0,1.0,73.0,476
3816,-23,48,25,1,0,28.0,1.0,72.0,477
3817,-14,23,9,1,1,28.0,1.0,72.0,477
3818,-33,33,0,2,2,28.0,1.0,72.0,477
3819,0,50,50,2,3,28.0,1.0,72.0,477
3820,-25,25,0,3,4,28.0,1.0,72.0,477
3821,-9,17,8,3,5,28.0,1.0,72.0,477
3822,2,81,83,3,6,28.0,1.0,72.0,477
3823,0,0,0,3,7,28.0,1.0,72.0,477
3824,25,75,100,1,0,28.0,1.0,72.0,478
3825,0,100,100,1,1,28.0,1.0,72.0,478
3826,0,0,0,2,2,28.0,1.0,72.0,478
3827,77,23,100,2,3,28.0,1.0,72.0,478
3828,37,63,100,3,4,28.0,1.0,72.0,478
3829,76,24,100,3,5,28.0,1.0,72.0,478
3830,89,11,100,3,6,28.0,1.0,72.0,478
3831,100,0,100,3,7,28.0,1.0,72.0,478
3832,-5,49,44,1,0,28.0,1.0,72.0,479
3833,87,13,100,1,1,28.0,1.0,72.0,479
3834,-17,80,63,2,2,28.0,1.0,72.0,479
3835,-7,76,69,2,3,28.0,1.0,72.0,479
3836,-10,41,31,3,4,28.0,1.0,72.0,479
3837,-13,50,37,3,5,28.0,1.0,72.0,479
3838,-8,58,50,3,6,28.0,1.0,72.0,479
3839,5,32,37,3,7,28.0,1.0,72.0,479
3840,-51,63,12,1,0,28.0,1.0,72.0,480
3841,13,87,100,1,1,28.0,1.0,72.0,480
3842,10,90,100,2,2,28.0,1.0,72.0,480
3843,13,82,95,2,3,28.0,1.0,72.0,480
3844,-39,56,17,3,4,28.0,1.0,72.0,480
3845,36,64,100,3,5,28.0,1.0,72.0,480
3846,23,70,93,3,6,28.0,1.0,72.0,480
3847,1,13,14,3,7,28.0,1.0,72.0,480
3848,25,71,96,1,0,28.0,1.0,72.0,481
3849,16,83,99,1,1,28.0,1.0,72.0,481
3850,13,19,32,2,2,28.0,1.0,72.0,481
3851,53,37,90,2,3,28.0,1.0,72.0,481
3852,29,64,93,3,4,28.0,1.0,72.0,481
3853,41,55,96,3,5,28.0,1.0,72.0,481
3854,77,23,100,3,6,28.0,1.0,72.0,481
3855,47,42,89,3,7,28.0,1.0,72.0,481
3856,-21,31,10,1,0,28.0,1.0,72.0,482
3857,0,100,100,1,1,28.0,1.0,72.0,482
3858,-10,34,24,2,2,28.0,1.0,72.0,482
3859,21,9,30,2,3,28.0,1.0,72.0,482
3860,8,50,58,3,4,28.0,1.0,72.0,482
3861,-22,36,14,3,5,28.0,1.0,72.0,482
3862,21,57,78,3,6,28.0,1.0,72.0,482
3863,-33,38,5,3,7,28.0,1.0,72.0,482
3864,16,65,81,1,0,28.0,1.0,72.0,483
3865,9,8,17,1,1,28.0,1.0,72.0,483
3866,-11,26,15,2,2,28.0,1.0,72.0,483
3867,-1,42,41,2,3,28.0,1.0,72.0,483
3868,11,58,69,3,4,28.0,1.0,72.0,483
3869,-28,61,33,3,5,28.0,1.0,72.0,483
3870,6,66,72,3,6,28.0,1.0,72.0,483
3871,23,5,28,3,7,28.0,1.0,72.0,483
3872,15,64,79,1,0,28.0,1.0,72.0,484
3873,7,23,30,1,1,28.0,1.0,72.0,484
3874,-2,30,28,2,2,28.0,1.0,72.0,484
3875,1,78,79,2,3,28.0,1.0,72.0,484
3876,13,65,78,3,4,28.0,1.0,72.0,484
3877,0,0,0,3,5,28.0,1.0,72.0,484
3878,6,36,42,3,6,28.0,1.0,72.0,484
3879,2,35,37,3,7,28.0,1.0,72.0,484
3880,1,8,9,1,0,28.0,1.0,72.0,485
3881,-8,15,7,1,1,28.0,1.0,72.0,485
3882,41,36,77,2,2,28.0,1.0,72.0,485
3883,1,54,55,2,3,28.0,1.0,72.0,485
3884,14,75,89,3,4,28.0,1.0,72.0,485
3885,96,4,100,3,5,28.0,1.0,72.0,485
3886,82,13,95,3,6,28.0,1.0,72.0,485
3887,78,11,89,3,7,28.0,1.0,72.0,485
3888,100,0,100,1,0,28.0,1.0,72.0,486
3889,0,100,100,1,1,28.0,1.0,72.0,486
3890,0,0,0,2,2,28.0,1.0,72.0,486
3891,0,0,0,2,3,28.0,1.0,72.0,486
3892,0,100,100,3,4,28.0,1.0,72.0,486
3893,0,0,0,3,5,28.0,1.0,72.0,486
3894,12,88,100,3,6,28.0,1.0,72.0,486
3895,0,0,0,3,7,28.0,1.0,72.0,486
3896,65,35,100,1,0,28.0,1.0,72.0,487
3897,0,100,100,1,1,28.0,1.0,72.0,487
3898,34,33,67,2,2,28.0,1.0,72.0,487
3899,41,59,100,2,3,28.0,1.0,72.0,487
3900,100,0,100,3,4,28.0,1.0,72.0,487
3901,54,46,100,3,5,28.0,1.0,72.0,487
3902,100,0,100,3,6,28.0,1.0,72.0,487
3903,85,15,100,3,7,28.0,1.0,72.0,487
3904,-8,100,92,1,0,29.0,1.0,71.0,488
3905,0,100,100,1,1,29.0,1.0,71.0,488
3906,29,56,85,2,2,29.0,1.0,71.0,488
3907,12,86,98,2,3,29.0,1.0,71.0,488
3908,11,89,100,3,4,29.0,1.0,71.0,488
3909,36,50,86,3,5,29.0,1.0,71.0,488
3910,44,56,100,3,6,29.0,1.0,71.0,488
3911,61,5,66,3,7,29.0,1.0,71.0,488
3912,28,43,71,1,0,29.0,1.0,71.0,489
3913,4,79,83,1,1,29.0,1.0,71.0,489
3914,22,41,63,2,2,29.0,1.0,71.0,489
3915,32,27,59,2,3,29.0,1.0,71.0,489
3916,20,62,82,3,4,29.0,1.0,71.0,489
3917,40,32,72,3,5,29.0,1.0,71.0,489
3918,24,39,63,3,6,29.0,1.0,71.0,489
3919,13,38,51,3,7,29.0,1.0,71.0,489
3920,50,50,100,1,0,29.0,1.0,71.0,490
3921,29,71,100,1,1,29.0,1.0,71.0,490
3922,16,34,50,2,2,29.0,1.0,71.0,490
3923,53,26,79,2,3,29.0,1.0,71.0,490
3924,14,86,100,3,4,29.0,1.0,71.0,490
3925,50,50,100,3,5,29.0,1.0,71.0,490
3926,25,75,100,3,6,29.0,1.0,71.0,490
3927,41,37,78,3,7,29.0,1.0,71.0,490
3928,11,79,90,1,0,29.0,1.0,71.0,491
3929,88,3,91,1,1,29.0,1.0,71.0,491
3930,12,0,12,2,2,29.0,1.0,71.0,491
3931,62,26,88,2,3,29.0,1.0,71.0,491
3932,99,0,99,3,4,29.0,1.0,71.0,491
3933,92,0,92,3,5,29.0,1.0,71.0,491
3934,0,100,100,3,6,29.0,1.0,71.0,491
3935,0,0,0,3,7,29.0,1.0,71.0,491
3936,5,8,13,1,0,29.0,1.0,71.0,492
3937,-24,24,0,1,1,29.0,1.0,71.0,492
3938,0,0,0,2,2,29.0,1.0,71.0,492
3939,-20,20,0,2,3,29.0,1.0,71.0,492
3940,32,34,66,3,4,29.0,1.0,71.0,492
3941,0,87,87,3,5,29.0,1.0,71.0,492
3942,-1,31,30,3,6,29.0,1.0,71.0,492
3943,1,0,1,3,7,29.0,1.0,71.0,492
3944,23,77,100,1,0,29.0,1.0,71.0,493
3945,0,100,100,1,1,29.0,1.0,71.0,493
3946,90,10,100,2,2,29.0,1.0,71.0,493
3947,-26,26,0,2,3,29.0,1.0,71.0,493
3948,0,100,100,3,4,29.0,1.0,71.0,493
3949,100,0,100,3,5,29.0,1.0,71.0,493
3950,11,89,100,3,6,29.0,1.0,71.0,493
3951,10,90,100,3,7,29.0,1.0,71.0,493
3952,0,0,0,1,0,29.0,1.0,71.0,494
3953,7,32,39,1,1,29.0,1.0,71.0,494
3954,-2,58,56,2,2,29.0,1.0,71.0,494
3955,-17,33,16,2,3,29.0,1.0,71.0,494
3956,-22,88,66,3,4,29.0,1.0,71.0,494
3957,-8,42,34,3,5,29.0,1.0,71.0,494
3958,9,0,9,3,6,29.0,1.0,71.0,494
3959,-19,19,0,3,7,29.0,1.0,71.0,494
3960,59,18,77,1,0,29.0,1.0,71.0,495
3961,21,79,100,1,1,29.0,1.0,71.0,495
3962,48,36,84,2,2,29.0,1.0,71.0,495
3963,80,0,80,2,3,29.0,1.0,71.0,495
3964,38,53,91,3,4,29.0,1.0,71.0,495
3965,100,0,100,3,5,29.0,1.0,71.0,495
3966,0,100,100,3,6,29.0,1.0,71.0,495
3967,93,0,93,3,7,29.0,1.0,71.0,495
3968,0,0,0,1,0,29.0,1.0,71.0,496
3969,-5,86,81,1,1,29.0,1.0,71.0,496
3970,-2,11,9,2,2,29.0,1.0,71.0,496
3971,9,50,59,2,3,29.0,1.0,71.0,496
3972,32,51,83,3,4,29.0,1.0,71.0,496
3973,75,0,75,3,5,29.0,1.0,71.0,496
3974,0,100,100,3,6,29.0,1.0,71.0,496
3975,0,0,0,3,7,29.0,1.0,71.0,496
3976,-24,50,26,1,0,29.0,1.0,71.0,497
3977,-16,41,25,1,1,29.0,1.0,71.0,497
3978,-20,58,38,2,2,29.0,1.0,71.0,497
3979,-3,26,23,2,3,29.0,1.0,71.0,497
3980,-29,55,26,3,4,29.0,1.0,71.0,497
3981,-9,35,26,3,5,29.0,1.0,71.0,497
3982,25,75,100,3,6,29.0,1.0,71.0,497
3983,-26,43,17,3,7,29.0,1.0,71.0,497
3984,50,50,100,1,0,29.0,1.0,71.0,498
3985,27,73,100,1,1,29.0,1.0,71.0,498
3986,42,58,100,2,2,29.0,1.0,71.0,498
3987,47,46,93,2,3,29.0,1.0,71.0,498
3988,80,2,82,3,4,29.0,1.0,71.0,498
3989,44,56,100,3,5,29.0,1.0,71.0,498
3990,66,34,100,3,6,29.0,1.0,71.0,498
3991,87,13,100,3,7,29.0,1.0,71.0,498
3992,100,0,100,1,0,29.0,1.0,71.0,499
3993,100,0,100,1,1,29.0,1.0,71.0,499
3994,0,0,0,2,2,29.0,1.0,71.0,499
3995,27,50,77,2,3,29.0,1.0,71.0,499
3996,0,100,100,3,4,29.0,1.0,71.0,499
3997,100,0,100,3,5,29.0,1.0,71.0,499
3998,0,100,100,3,6,29.0,1.0,71.0,499
3999,100,0,100,3,7,29.0,1.0,71.0,499
4000,21,33,54,1,0,29.0,1.0,71.0,500
4001,0,82,82,1,1,29.0,1.0,71.0,500
4002,13,2,15,2,2,29.0,1.0,71.0,500
4003,-9,40,31,2,3,29.0,1.0,71.0,500
4004,16,82,98,3,4,29.0,1.0,71.0,500
4005,-10,31,21,3,5,29.0,1.0,71.0,500
4006,-12,36,24,3,6,29.0,1.0,71.0,500
4007,-4,56,52,3,7,29.0,1.0,71.0,500
4008,100,0,100,1,0,29.0,1.0,71.0,501
4009,49,51,100,1,1,29.0,1.0,71.0,501
4010,50,50,100,2,2,29.0,1.0,71.0,501
4011,0,100,100,2,3,29.0,1.0,71.0,501
4012,24,76,100,3,4,29.0,1.0,71.0,501
4013,100,0,100,3,5,29.0,1.0,71.0,501
4014,34,66,100,3,6,29.0,1.0,71.0,501
4015,100,0,100,3,7,29.0,1.0,71.0,501
4016,19,69,88,1,0,29.0,1.0,71.0,502
4017,0,75,75,1,1,29.0,1.0,71.0,502
4018,14,10,24,2,2,29.0,1.0,71.0,502
4019,6,14,20,2,3,29.0,1.0,71.0,502
4020,15,63,78,3,4,29.0,1.0,71.0,502
4021,39,23,62,3,5,29.0,1.0,71.0,502
4022,-9,73,64,3,6,29.0,1.0,71.0,502
4023,-5,21,16,3,7,29.0,1.0,71.0,502
4024,34,66,100,1,0,30.0,1.0,70.0,503
4025,0,100,100,1,1,30.0,1.0,70.0,503
4026,24,35,59,2,2,30.0,1.0,70.0,503
4027,-17,87,70,2,3,30.0,1.0,70.0,503
4028,-14,90,76,3,4,30.0,1.0,70.0,503
4029,57,28,85,3,5,30.0,1.0,70.0,503
4030,-39,68,29,3,6,30.0,1.0,70.0,503
4031,26,14,40,3,7,30.0,1.0,70.0,503
4032,24,76,100,1,0,30.0,1.0,70.0,504
4033,0,100,100,1,1,30.0,1.0,70.0,504
4034,26,50,76,2,2,30.0,1.0,70.0,504
4035,25,25,50,2,3,30.0,1.0,70.0,504
4036,51,38,89,3,4,30.0,1.0,70.0,504
4037,62,38,100,3,5,30.0,1.0,70.0,504
4038,38,50,88,3,6,30.0,1.0,70.0,504
4039,50,50,100,3,7,30.0,1.0,70.0,504
4040,50,50,100,1,0,30.0,1.0,70.0,505
4041,90,10,100,1,1,30.0,1.0,70.0,505
4042,100,0,100,2,2,30.0,1.0,70.0,505
4043,75,25,100,2,3,30.0,1.0,70.0,505
4044,30,70,100,3,4,30.0,1.0,70.0,505
4045,50,50,100,3,5,30.0,1.0,70.0,505
4046,30,70,100,3,6,30.0,1.0,70.0,505
4047,100,0,100,3,7,30.0,1.0,70.0,505
4048,-3,89,86,1,0,30.0,1.0,70.0,506
4049,9,25,34,1,1,30.0,1.0,70.0,506
4050,-5,45,40,2,2,30.0,1.0,70.0,506
4051,0,20,20,2,3,30.0,1.0,70.0,506
4052,-3,41,38,3,4,30.0,1.0,70.0,506
4053,0,50,50,3,5,30.0,1.0,70.0,506
4054,0,100,100,3,6,30.0,1.0,70.0,506
4055,0,10,10,3,7,30.0,1.0,70.0,506
4056,-10,77,67,1,0,30.0,1.0,70.0,507
4057,-2,29,27,1,1,30.0,1.0,70.0,507
4058,-46,75,29,2,2,30.0,1.0,70.0,507
4059,-19,40,21,2,3,30.0,1.0,70.0,507
4060,-6,67,61,3,4,30.0,1.0,70.0,507
4061,-32,73,41,3,5,30.0,1.0,70.0,507
4062,22,45,67,3,6,30.0,1.0,70.0,507
4063,-40,76,36,3,7,30.0,1.0,70.0,507
4064,20,80,100,1,0,30.0,1.0,70.0,508
4065,0,100,100,1,1,30.0,1.0,70.0,508
4066,100,0,100,2,2,30.0,1.0,70.0,508
4067,-28,28,0,2,3,30.0,1.0,70.0,508
4068,20,80,100,3,4,30.0,1.0,70.0,508
4069,50,0,50,3,5,30.0,1.0,70.0,508
4070,20,80,100,3,6,30.0,1.0,70.0,508
4071,50,50,100,3,7,30.0,1.0,70.0,508
4072,0,100,100,1,0,30.0,1.0,70.0,509
4073,0,100,100,1,1,30.0,1.0,70.0,509
4074,51,49,100,2,2,30.0,1.0,70.0,509
4075,0,0,0,2,3,30.0,1.0,70.0,509
4076,50,50,100,3,4,30.0,1.0,70.0,509
4077,95,5,100,3,5,30.0,1.0,70.0,509
4078,100,0,100,3,6,30.0,1.0,70.0,509
4079,90,10,100,3,7,30.0,1.0,70.0,509
4080,2,79,81,1,0,30.0,1.0,70.0,510
4081,24,76,100,1,1,30.0,1.0,70.0,510
4082,79,0,79,2,2,30.0,1.0,70.0,510
4083,16,64,80,2,3,30.0,1.0,70.0,510
4084,19,81,100,3,4,30.0,1.0,70.0,510
4085,31,49,80,3,5,30.0,1.0,70.0,510
4086,7,75,82,3,6,30.0,1.0,70.0,510
4087,91,0,91,3,7,30.0,1.0,70.0,510
4088,1,90,91,1,0,30.0,1.0,70.0,511
4089,34,62,96,1,1,30.0,1.0,70.0,511
4090,64,23,87,2,2,30.0,1.0,70.0,511
4091,75,17,92,2,3,30.0,1.0,70.0,511
4092,-7,70,63,3,4,30.0,1.0,70.0,511
4093,83,6,89,3,5,30.0,1.0,70.0,511
4094,50,42,92,3,6,30.0,1.0,70.0,511
4095,-19,50,31,3,7,30.0,1.0,70.0,511
4096,24,76,100,1,0,30.0,1.0,70.0,512
4097,25,75,100,1,1,30.0,1.0,70.0,512
4098,60,40,100,2,2,30.0,1.0,70.0,512
4099,61,30,91,2,3,30.0,1.0,70.0,512
4100,10,90,100,3,4,30.0,1.0,70.0,512
4101,50,50,100,3,5,30.0,1.0,70.0,512
4102,80,20,100,3,6,30.0,1.0,70.0,512
4103,34,60,94,3,7,30.0,1.0,70.0,512
4104,22,60,82,1,0,30.0,1.0,70.0,513
4105,-42,100,58,1,1,30.0,1.0,70.0,513
4106,10,25,35,2,2,30.0,1.0,70.0,513
4107,-23,80,57,2,3,30.0,1.0,70.0,513
4108,63,20,83,3,4,30.0,1.0,70.0,513
4109,54,26,80,3,5,30.0,1.0,70.0,513
4110,0,100,100,3,6,30.0,1.0,70.0,513
4111,28,42,70,3,7,30.0,1.0,70.0,513
4112,16,44,60,1,0,30.0,1.0,70.0,514
4113,-51,100,49,1,1,30.0,1.0,70.0,514
4114,100,0,100,2,2,30.0,1.0,70.0,514
4115,41,59,100,2,3,30.0,1.0,70.0,514
4116,0,36,36,3,4,30.0,1.0,70.0,514
4117,1,50,51,3,5,30.0,1.0,70.0,514
4118,50,50,100,3,6,30.0,1.0,70.0,514
4119,100,0,100,3,7,30.0,1.0,70.0,514
4120,10,55,65,1,0,30.0,1.0,70.0,515
4121,-18,48,30,1,1,30.0,1.0,70.0,515
4122,3,30,33,2,2,30.0,1.0,70.0,515
4123,-19,44,25,2,3,30.0,1.0,70.0,515
4124,-8,19,11,3,4,30.0,1.0,70.0,515
4125,2,65,67,3,5,30.0,1.0,70.0,515
4126,-2,40,38,3,6,30.0,1.0,70.0,515
4127,0,0,0,3,7,30.0,1.0,70.0,515
4128,7,84,91,1,0,30.0,1.0,70.0,516
4129,4,93,97,1,1,30.0,1.0,70.0,516
4130,-2,27,25,2,2,30.0,1.0,70.0,516
4131,-13,63,50,2,3,30.0,1.0,70.0,516
4132,49,41,90,3,4,30.0,1.0,70.0,516
4133,89,5,94,3,5,30.0,1.0,70.0,516
4134,5,95,100,3,6,30.0,1.0,70.0,516
4135,76,10,86,3,7,30.0,1.0,70.0,516
4136,0,65,65,1,0,30.0,1.0,70.0,517
4137,0,100,100,1,1,30.0,1.0,70.0,517
4138,0,0,0,2,2,30.0,1.0,70.0,517
4139,-70,90,20,2,3,30.0,1.0,70.0,517
4140,0,65,65,3,4,30.0,1.0,70.0,517
4141,5,60,65,3,5,30.0,1.0,70.0,517
4142,25,40,65,3,6,30.0,1.0,70.0,517
4143,25,0,25,3,7,30.0,1.0,70.0,517
4144,33,25,58,1,0,30.0,1.0,70.0,518
4145,22,78,100,1,1,30.0,1.0,70.0,518
4146,43,22,65,2,2,30.0,1.0,70.0,518
4147,44,22,66,2,3,30.0,1.0,70.0,518
4148,16,84,100,3,4,30.0,1.0,70.0,518
4149,42,37,79,3,5,30.0,1.0,70.0,518
4150,0,100,100,3,6,30.0,1.0,70.0,518
4151,44,22,66,3,7,30.0,1.0,70.0,518
4152,6,78,84,1,0,30.0,1.0,70.0,519
4153,2,84,86,1,1,30.0,1.0,70.0,519
4154,71,0,71,2,2,30.0,1.0,70.0,519
4155,83,10,93,2,3,30.0,1.0,70.0,519
4156,58,42,100,3,4,30.0,1.0,70.0,519
4157,14,83,97,3,5,30.0,1.0,70.0,519
4158,47,50,97,3,6,30.0,1.0,70.0,519
4159,65,12,77,3,7,30.0,1.0,70.0,519
4160,76,20,96,1,0,30.0,1.0,70.0,520
4161,35,61,96,1,1,30.0,1.0,70.0,520
4162,85,8,93,2,2,30.0,1.0,70.0,520
4163,64,31,95,2,3,30.0,1.0,70.0,520
4164,41,51,92,3,4,30.0,1.0,70.0,520
4165,52,39,91,3,5,30.0,1.0,70.0,520
4166,10,90,100,3,6,30.0,1.0,70.0,520
4167,84,10,94,3,7,30.0,1.0,70.0,520
4168,-65,69,4,1,0,30.0,1.0,70.0,521
4169,3,78,81,1,1,30.0,1.0,70.0,521
4170,64,24,88,2,2,30.0,1.0,70.0,521
4171,-3,14,11,2,3,30.0,1.0,70.0,521
4172,28,50,78,3,4,30.0,1.0,70.0,521
4173,-36,50,14,3,5,30.0,1.0,70.0,521
4174,80,14,94,3,6,30.0,1.0,70.0,521
4175,-19,35,16,3,7,30.0,1.0,70.0,521
4176,-44,76,32,1,0,30.0,1.0,70.0,522
4177,0,0,0,1,1,30.0,1.0,70.0,522
4178,-14,14,0,2,2,30.0,1.0,70.0,522
4179,0,0,0,2,3,30.0,1.0,70.0,522
4180,11,45,56,3,4,30.0,1.0,70.0,522
4181,22,37,59,3,5,30.0,1.0,70.0,522
4182,-23,63,40,3,6,30.0,1.0,70.0,522
4183,19,37,56,3,7,30.0,1.0,70.0,522
4184,8,50,58,1,0,30.0,1.0,70.0,523
4185,13,62,75,1,1,30.0,1.0,70.0,523
4186,16,36,52,2,2,30.0,1.0,70.0,523
4187,-6,45,39,2,3,30.0,1.0,70.0,523
4188,16,70,86,3,4,30.0,1.0,70.0,523
4189,3,62,65,3,5,30.0,1.0,70.0,523
4190,1,47,48,3,6,30.0,1.0,70.0,523
4191,26,24,50,3,7,30.0,1.0,70.0,523
4192,25,75,100,1,0,30.0,1.0,70.0,524
4193,50,0,50,1,1,30.0,1.0,70.0,524
4194,25,50,75,2,2,30.0,1.0,70.0,524
4195,50,0,50,2,3,30.0,1.0,70.0,524
4196,25,75,100,3,4,30.0,1.0,70.0,524
4197,50,50,100,3,5,30.0,1.0,70.0,524
4198,50,0,50,3,6,30.0,1.0,70.0,524
4199,-50,50,0,3,7,30.0,1.0,70.0,524
4200,26,50,76,1,0,30.0,1.0,70.0,525
4201,1,76,77,1,1,30.0,1.0,70.0,525
4202,27,50,77,2,2,30.0,1.0,70.0,525
4203,52,26,78,2,3,30.0,1.0,70.0,525
4204,38,39,77,3,4,30.0,1.0,70.0,525
4205,52,25,77,3,5,30.0,1.0,70.0,525
4206,13,64,77,3,6,30.0,1.0,70.0,525
4207,41,35,76,3,7,30.0,1.0,70.0,525
4208,9,45,54,1,0,30.0,1.0,70.0,526
4209,-9,33,24,1,1,30.0,1.0,70.0,526
4210,37,50,87,2,2,30.0,1.0,70.0,526
4211,37,63,100,2,3,30.0,1.0,70.0,526
4212,42,52,94,3,4,30.0,1.0,70.0,526
4213,-1,81,80,3,5,30.0,1.0,70.0,526
4214,28,72,100,3,6,30.0,1.0,70.0,526
4215,73,7,80,3,7,30.0,1.0,70.0,526
4216,6,40,46,1,0,30.0,1.0,70.0,527
4217,0,64,64,1,1,30.0,1.0,70.0,527
4218,3,38,41,2,2,30.0,1.0,70.0,527
4219,48,7,55,2,3,30.0,1.0,70.0,527
4220,0,77,77,3,4,30.0,1.0,70.0,527
4221,39,5,44,3,5,30.0,1.0,70.0,527
4222,9,32,41,3,6,30.0,1.0,70.0,527
4223,3,13,16,3,7,30.0,1.0,70.0,527
4224,28,72,100,1,0,30.0,1.0,70.0,528
4225,10,90,100,1,1,30.0,1.0,70.0,528
4226,89,11,100,2,2,30.0,1.0,70.0,528
4227,96,4,100,2,3,30.0,1.0,70.0,528
4228,74,26,100,3,4,30.0,1.0,70.0,528
4229,41,59,100,3,5,30.0,1.0,70.0,528
4230,89,11,100,3,6,30.0,1.0,70.0,528
4231,58,42,100,3,7,30.0,1.0,70.0,528
4232,2,73,75,1,0,30.0,1.0,70.0,529
4233,45,10,55,1,1,30.0,1.0,70.0,529
4234,30,20,50,2,2,30.0,1.0,70.0,529
4235,10,50,60,2,3,30.0,1.0,70.0,529
4236,20,50,70,3,4,30.0,1.0,70.0,529
4237,4,61,65,3,5,30.0,1.0,70.0,529
4238,15,85,100,3,6,30.0,1.0,70.0,529
4239,17,33,50,3,7,30.0,1.0,70.0,529
4240,52,39,91,1,0,30.0,1.0,70.0,530
4241,56,39,95,1,1,30.0,1.0,70.0,530
4242,34,50,84,2,2,30.0,1.0,70.0,530
4243,22,78,100,2,3,30.0,1.0,70.0,530
4244,40,60,100,3,4,30.0,1.0,70.0,530
4245,47,50,97,3,5,30.0,1.0,70.0,530
4246,71,29,100,3,6,30.0,1.0,70.0,530
4247,49,41,90,3,7,30.0,1.0,70.0,530
4248,-10,30,20,1,0,30.0,1.0,70.0,531
4249,30,0,30,1,1,30.0,1.0,70.0,531
4250,0,30,30,2,2,30.0,1.0,70.0,531
4251,-20,60,40,2,3,30.0,1.0,70.0,531
4252,0,40,40,3,4,30.0,1.0,70.0,531
4253,-10,20,10,3,5,30.0,1.0,70.0,531
4254,0,0,0,3,6,30.0,1.0,70.0,531
4255,0,0,0,3,7,30.0,1.0,70.0,531
4256,10,80,90,1,0,30.0,1.0,70.0,532
4257,20,80,100,1,1,30.0,1.0,70.0,532
4258,45,0,45,2,2,30.0,1.0,70.0,532
4259,30,20,50,2,3,30.0,1.0,70.0,532
4260,0,45,45,3,4,30.0,1.0,70.0,532
4261,50,50,100,3,5,30.0,1.0,70.0,532
4262,10,35,45,3,6,30.0,1.0,70.0,532
4263,-30,75,45,3,7,30.0,1.0,70.0,532
4264,37,38,75,1,0,30.0,1.0,70.0,533
4265,-21,85,64,1,1,30.0,1.0,70.0,533
4266,12,8,20,2,2,30.0,1.0,70.0,533
4267,0,24,24,2,3,30.0,1.0,70.0,533
4268,-5,87,82,3,4,30.0,1.0,70.0,533
4269,8,55,63,3,5,30.0,1.0,70.0,533
4270,0,88,88,3,6,30.0,1.0,70.0,533
4271,2,24,26,3,7,30.0,1.0,70.0,533
4272,34,43,77,1,0,30.0,1.0,70.0,534
4273,-10,95,85,1,1,30.0,1.0,70.0,534
4274,21,44,65,2,2,30.0,1.0,70.0,534
4275,17,3,20,2,3,30.0,1.0,70.0,534
4276,-3,24,21,3,4,30.0,1.0,70.0,534
4277,45,35,80,3,5,30.0,1.0,70.0,534
4278,24,39,63,3,6,30.0,1.0,70.0,534
4279,63,9,72,3,7,30.0,1.0,70.0,534
4280,50,0,50,1,0,30.0,1.0,70.0,535
4281,1,50,51,1,1,30.0,1.0,70.0,535
4282,-24,100,76,2,2,30.0,1.0,70.0,535
4283,0,0,0,2,3,30.0,1.0,70.0,535
4284,5,70,75,3,4,30.0,1.0,70.0,535
4285,29,50,79,3,5,30.0,1.0,70.0,535
4286,-15,25,10,3,6,30.0,1.0,70.0,535
4287,23,0,23,3,7,30.0,1.0,70.0,535
4288,25,40,65,1,0,30.0,1.0,70.0,536
4289,15,85,100,1,1,30.0,1.0,70.0,536
4290,40,20,60,2,2,30.0,1.0,70.0,536
4291,-20,55,35,2,3,30.0,1.0,70.0,536
4292,25,60,85,3,4,30.0,1.0,70.0,536
4293,25,40,65,3,5,30.0,1.0,70.0,536
4294,20,20,40,3,6,30.0,1.0,70.0,536
4295,0,30,30,3,7,30.0,1.0,70.0,536
4296,100,0,100,1,0,30.0,1.0,70.0,537
4297,76,24,100,1,1,30.0,1.0,70.0,537
4298,-50,50,0,2,2,30.0,1.0,70.0,537
4299,100,0,100,2,3,30.0,1.0,70.0,537
4300,50,50,100,3,4,30.0,1.0,70.0,537
4301,78,22,100,3,5,30.0,1.0,70.0,537
4302,0,100,100,3,6,30.0,1.0,70.0,537
4303,100,0,100,3,7,30.0,1.0,70.0,537
4304,50,50,100,1,0,30.0,1.0,70.0,538
4305,50,50,100,1,1,30.0,1.0,70.0,538
4306,43,50,93,2,2,30.0,1.0,70.0,538
4307,10,90,100,2,3,30.0,1.0,70.0,538
4308,60,40,100,3,4,30.0,1.0,70.0,538
4309,45,50,95,3,5,30.0,1.0,70.0,538
4310,55,45,100,3,6,30.0,1.0,70.0,538
4311,100,0,100,3,7,30.0,1.0,70.0,538
4312,7,54,61,1,0,30.0,1.0,70.0,539
4313,-1,64,63,1,1,30.0,1.0,70.0,539
4314,3,51,54,2,2,30.0,1.0,70.0,539
4315,85,9,94,2,3,30.0,1.0,70.0,539
4316,12,63,75,3,4,30.0,1.0,70.0,539
4317,49,27,76,3,5,30.0,1.0,70.0,539
4318,-6,97,91,3,6,30.0,1.0,70.0,539
4319,25,50,75,3,7,30.0,1.0,70.0,539
4320,16,73,89,1,0,30.0,1.0,70.0,540
4321,0,100,100,1,1,30.0,1.0,70.0,540
4322,16,0,16,2,2,30.0,1.0,70.0,540
4323,36,23,59,2,3,30.0,1.0,70.0,540
4324,26,36,62,3,4,30.0,1.0,70.0,540
4325,21,60,81,3,5,30.0,1.0,70.0,540
4326,1,87,88,3,6,30.0,1.0,70.0,540
4327,58,23,81,3,7,30.0,1.0,70.0,540
4328,57,39,96,1,0,31.0,1.0,69.0,541
4329,82,18,100,1,1,31.0,1.0,69.0,541
4330,13,0,13,2,2,31.0,1.0,69.0,541
4331,5,4,9,2,3,31.0,1.0,69.0,541
4332,7,92,99,3,4,31.0,1.0,69.0,541
4333,59,15,74,3,5,31.0,1.0,69.0,541
4334,72,9,81,3,6,31.0,1.0,69.0,541
4335,5,5,10,3,7,31.0,1.0,69.0,541
4336,30,70,100,1,0,31.0,1.0,69.0,542
4337,4,70,74,1,1,31.0,1.0,69.0,542
4338,100,0,100,2,2,31.0,1.0,69.0,542
4339,55,45,100,2,3,31.0,1.0,69.0,542
4340,-2,40,38,3,4,31.0,1.0,69.0,542
4341,6,75,81,3,5,31.0,1.0,69.0,542
4342,3,40,43,3,6,31.0,1.0,69.0,542
4343,42,0,42,3,7,31.0,1.0,69.0,542
4344,0,50,50,1,0,31.0,1.0,69.0,543
4345,-50,100,50,1,1,31.0,1.0,69.0,543
4346,50,0,50,2,2,31.0,1.0,69.0,543
4347,-50,100,50,2,3,31.0,1.0,69.0,543
4348,-50,100,50,3,4,31.0,1.0,69.0,543
4349,10,40,50,3,5,31.0,1.0,69.0,543
4350,50,0,50,3,6,31.0,1.0,69.0,543
4351,51,0,51,3,7,31.0,1.0,69.0,543
4352,-1,89,88,1,0,31.0,1.0,69.0,544
4353,13,77,90,1,1,31.0,1.0,69.0,544
4354,-35,78,43,2,2,31.0,1.0,69.0,544
4355,-6,17,11,2,3,31.0,1.0,69.0,544
4356,1,87,88,3,4,31.0,1.0,69.0,544
4357,1,49,50,3,5,31.0,1.0,69.0,544
4358,1,41,42,3,6,31.0,1.0,69.0,544
4359,4,54,58,3,7,31.0,1.0,69.0,544
4360,41,27,68,1,0,31.0,1.0,69.0,545
4361,-18,32,14,1,1,31.0,1.0,69.0,545
4362,41,34,75,2,2,31.0,1.0,69.0,545
4363,48,18,66,2,3,31.0,1.0,69.0,545
4364,-34,100,66,3,4,31.0,1.0,69.0,545
4365,45,27,72,3,5,31.0,1.0,69.0,545
4366,5,78,83,3,6,31.0,1.0,69.0,545
4367,46,23,69,3,7,31.0,1.0,69.0,545
4368,-3,36,33,1,0,31.0,1.0,69.0,546
4369,-10,21,11,1,1,31.0,1.0,69.0,546
4370,-4,28,24,2,2,31.0,1.0,69.0,546
4371,-3,35,32,2,3,31.0,1.0,69.0,546
4372,10,19,29,3,4,31.0,1.0,69.0,546
4373,-16,33,17,3,5,31.0,1.0,69.0,546
4374,-18,38,20,3,6,31.0,1.0,69.0,546
4375,-10,31,21,3,7,31.0,1.0,69.0,546
4376,84,14,98,1,0,31.0,1.0,69.0,547
4377,4,95,99,1,1,31.0,1.0,69.0,547
4378,2,25,27,2,2,31.0,1.0,69.0,547
4379,1,1,2,2,3,31.0,1.0,69.0,547
4380,19,75,94,3,4,31.0,1.0,69.0,547
4381,73,3,76,3,5,31.0,1.0,69.0,547
4382,12,88,100,3,6,31.0,1.0,69.0,547
4383,33,27,60,3,7,31.0,1.0,69.0,547
4384,17,34,51,1,0,31.0,1.0,69.0,548
4385,0,50,50,1,1,31.0,1.0,69.0,548
4386,0,50,50,2,2,31.0,1.0,69.0,548
4387,7,27,34,2,3,31.0,1.0,69.0,548
4388,-7,54,47,3,4,31.0,1.0,69.0,548
4389,0,50,50,3,5,31.0,1.0,69.0,548
4390,-11,47,36,3,6,31.0,1.0,69.0,548
4391,2,34,36,3,7,31.0,1.0,69.0,548
4392,26,50,76,1,0,31.0,1.0,69.0,549
4393,30,70,100,1,1,31.0,1.0,69.0,549
4394,78,0,78,2,2,31.0,1.0,69.0,549
4395,0,0,0,2,3,31.0,1.0,69.0,549
4396,8,76,84,3,4,31.0,1.0,69.0,549
4397,50,50,100,3,5,31.0,1.0,69.0,549
4398,50,50,100,3,6,31.0,1.0,69.0,549
4399,63,0,63,3,7,31.0,1.0,69.0,549
4400,-5,100,95,1,0,31.0,1.0,69.0,550
4401,-97,97,0,1,1,31.0,1.0,69.0,550
4402,31,60,91,2,2,31.0,1.0,69.0,550
4403,19,79,98,2,3,31.0,1.0,69.0,550
4404,-2,100,98,3,4,31.0,1.0,69.0,550
4405,73,6,79,3,5,31.0,1.0,69.0,550
4406,1,4,5,3,6,31.0,1.0,69.0,550
4407,90,1,91,3,7,31.0,1.0,69.0,550
4408,20,80,100,1,0,31.0,1.0,69.0,551
4409,-27,100,73,1,1,31.0,1.0,69.0,551
4410,36,39,75,2,2,31.0,1.0,69.0,551
4411,37,0,37,2,3,31.0,1.0,69.0,551
4412,15,68,83,3,4,31.0,1.0,69.0,551
4413,69,31,100,3,5,31.0,1.0,69.0,551
4414,26,11,37,3,6,31.0,1.0,69.0,551
4415,34,42,76,3,7,31.0,1.0,69.0,551
4416,1,65,66,1,0,31.0,1.0,69.0,552
4417,5,83,88,1,1,31.0,1.0,69.0,552
4418,65,0,65,2,2,31.0,1.0,69.0,552
4419,24,0,24,2,3,31.0,1.0,69.0,552
4420,13,50,63,3,4,31.0,1.0,69.0,552
4421,13,50,63,3,5,31.0,1.0,69.0,552
4422,64,25,89,3,6,31.0,1.0,69.0,552
4423,39,11,50,3,7,31.0,1.0,69.0,552
4424,-39,58,19,1,0,31.0,1.0,69.0,553
4425,-46,69,23,1,1,31.0,1.0,69.0,553
4426,-33,39,6,2,2,31.0,1.0,69.0,553
4427,-27,37,10,2,3,31.0,1.0,69.0,553
4428,31,57,88,3,4,31.0,1.0,69.0,553
4429,52,44,96,3,5,31.0,1.0,69.0,553
4430,91,9,100,3,6,31.0,1.0,69.0,553
4431,-40,60,20,3,7,31.0,1.0,69.0,553
4432,3,31,34,1,0,32.0,1.0,68.0,554
4433,-12,86,74,1,1,32.0,1.0,68.0,554
4434,49,31,80,2,2,32.0,1.0,68.0,554
4435,32,0,32,2,3,32.0,1.0,68.0,554
4436,39,52,91,3,4,32.0,1.0,68.0,554
4437,-4,29,25,3,5,32.0,1.0,68.0,554
4438,1,23,24,3,6,32.0,1.0,68.0,554
4439,100,0,100,3,7,32.0,1.0,68.0,554
4440,0,88,88,1,0,32.0,1.0,68.0,555
4441,0,100,100,1,1,32.0,1.0,68.0,555
4442,47,24,71,2,2,32.0,1.0,68.0,555
4443,17,23,40,2,3,32.0,1.0,68.0,555
4444,21,54,75,3,4,32.0,1.0,68.0,555
4445,27,50,77,3,5,32.0,1.0,68.0,555
4446,65,24,89,3,6,32.0,1.0,68.0,555
4447,8,62,70,3,7,32.0,1.0,68.0,555
4448,0,100,100,1,0,32.0,1.0,68.0,556
4449,0,100,100,1,1,32.0,1.0,68.0,556
4450,-4,5,1,2,2,32.0,1.0,68.0,556
4451,13,82,95,2,3,32.0,1.0,68.0,556
4452,21,51,72,3,4,32.0,1.0,68.0,556
4453,-19,75,56,3,5,32.0,1.0,68.0,556
4454,0,100,100,3,6,32.0,1.0,68.0,556
4455,54,44,98,3,7,32.0,1.0,68.0,556
4456,49,51,100,1,0,32.0,1.0,68.0,557
4457,19,81,100,1,1,32.0,1.0,68.0,557
4458,92,8,100,2,2,32.0,1.0,68.0,557
4459,100,0,100,2,3,32.0,1.0,68.0,557
4460,29,71,100,3,4,32.0,1.0,68.0,557
4461,36,64,100,3,5,32.0,1.0,68.0,557
4462,22,78,100,3,6,32.0,1.0,68.0,557
4463,38,62,100,3,7,32.0,1.0,68.0,557
4464,0,50,50,1,0,32.0,1.0,68.0,558
4465,0,100,100,1,1,32.0,1.0,68.0,558
4466,50,0,50,2,2,32.0,1.0,68.0,558
4467,3,47,50,2,3,32.0,1.0,68.0,558
4468,0,0,0,3,4,32.0,1.0,68.0,558
4469,0,0,0,3,5,32.0,1.0,68.0,558
4470,-100,100,0,3,6,32.0,1.0,68.0,558
4471,100,0,100,3,7,32.0,1.0,68.0,558
4472,9,61,70,1,0,32.0,1.0,68.0,559
4473,-1,1,0,1,1,32.0,1.0,68.0,559
4474,-8,48,40,2,2,32.0,1.0,68.0,559
4475,-1,1,0,2,3,32.0,1.0,68.0,559
4476,12,35,47,3,4,32.0,1.0,68.0,559
4477,6,61,67,3,5,32.0,1.0,68.0,559
4478,-7,21,14,3,6,32.0,1.0,68.0,559
4479,-8,51,43,3,7,32.0,1.0,68.0,559
4480,34,21,55,1,0,32.0,1.0,68.0,560
4481,26,65,91,1,1,32.0,1.0,68.0,560
4482,78,13,91,2,2,32.0,1.0,68.0,560
4483,79,7,86,2,3,32.0,1.0,68.0,560
4484,-1,35,34,3,4,32.0,1.0,68.0,560
4485,49,50,99,3,5,32.0,1.0,68.0,560
4486,0,100,100,3,6,32.0,1.0,68.0,560
4487,69,13,82,3,7,32.0,1.0,68.0,560
4488,12,46,58,1,0,32.0,1.0,68.0,561
4489,16,66,82,1,1,32.0,1.0,68.0,561
4490,61,22,83,2,2,32.0,1.0,68.0,561
4491,73,8,81,2,3,32.0,1.0,68.0,561
4492,37,59,96,3,4,32.0,1.0,68.0,561
4493,44,42,86,3,5,32.0,1.0,68.0,561
4494,56,39,95,3,6,32.0,1.0,68.0,561
4495,49,31,80,3,7,32.0,1.0,68.0,561
4496,0,20,20,1,0,32.0,1.0,68.0,562
4497,-3,81,78,1,1,32.0,1.0,68.0,562
4498,57,19,76,2,2,32.0,1.0,68.0,562
4499,66,21,87,2,3,32.0,1.0,68.0,562
4500,40,50,90,3,4,32.0,1.0,68.0,562
4501,24,67,91,3,5,32.0,1.0,68.0,562
4502,36,49,85,3,6,32.0,1.0,68.0,562
4503,-25,30,5,3,7,32.0,1.0,68.0,562
4504,-26,27,1,1,0,32.0,1.0,68.0,563
4505,20,80,100,1,1,32.0,1.0,68.0,563
4506,-28,28,0,2,2,32.0,1.0,68.0,563
4507,57,38,95,2,3,32.0,1.0,68.0,563
4508,21,73,94,3,4,32.0,1.0,68.0,563
4509,72,28,100,3,5,32.0,1.0,68.0,563
4510,66,34,100,3,6,32.0,1.0,68.0,563
4511,-11,18,7,3,7,32.0,1.0,68.0,563
4512,-22,27,5,1,0,32.0,1.0,68.0,564
4513,8,5,13,1,1,32.0,1.0,68.0,564
4514,-2,79,77,2,2,32.0,1.0,68.0,564
4515,0,21,21,2,3,32.0,1.0,68.0,564
4516,8,80,88,3,4,32.0,1.0,68.0,564
4517,-15,30,15,3,5,32.0,1.0,68.0,564
4518,-18,28,10,3,6,32.0,1.0,68.0,564
4519,-2,2,0,3,7,32.0,1.0,68.0,564
4520,39,61,100,1,0,33.0,1.0,67.0,565
4521,30,70,100,1,1,33.0,1.0,67.0,565
4522,21,29,50,2,2,33.0,1.0,67.0,565
4523,34,0,34,2,3,33.0,1.0,67.0,565
4524,49,25,74,3,4,33.0,1.0,67.0,565
4525,52,22,74,3,5,33.0,1.0,67.0,565
4526,25,0,25,3,6,33.0,1.0,67.0,565
4527,12,50,62,3,7,33.0,1.0,67.0,565
4528,1,64,65,1,0,33.0,1.0,67.0,566
4529,0,100,100,1,1,33.0,1.0,67.0,566
4530,1,49,50,2,2,33.0,1.0,67.0,566
4531,5,25,30,2,3,33.0,1.0,67.0,566
4532,7,60,67,3,4,33.0,1.0,67.0,566
4533,17,56,73,3,5,33.0,1.0,67.0,566
4534,-9,46,37,3,6,33.0,1.0,67.0,566
4535,40,26,66,3,7,33.0,1.0,67.0,566
4536,33,50,83,1,0,33.0,1.0,67.0,567
4537,0,100,100,1,1,33.0,1.0,67.0,567
4538,86,0,86,2,2,33.0,1.0,67.0,567
4539,80,0,80,2,3,33.0,1.0,67.0,567
4540,27,50,77,3,4,33.0,1.0,67.0,567
4541,28,50,78,3,5,33.0,1.0,67.0,567
4542,78,0,78,3,6,33.0,1.0,67.0,567
4543,84,0,84,3,7,33.0,1.0,67.0,567
4544,11,64,75,1,0,33.0,1.0,67.0,568
4545,-3,82,79,1,1,33.0,1.0,67.0,568
4546,34,40,74,2,2,33.0,1.0,67.0,568
4547,18,59,77,2,3,33.0,1.0,67.0,568
4548,44,33,77,3,4,33.0,1.0,67.0,568
4549,32,40,72,3,5,33.0,1.0,67.0,568
4550,44,32,76,3,6,33.0,1.0,67.0,568
4551,73,0,73,3,7,33.0,1.0,67.0,568
4552,17,50,67,1,0,33.0,1.0,67.0,569
4553,54,25,79,1,1,33.0,1.0,67.0,569
4554,15,50,65,2,2,33.0,1.0,67.0,569
4555,64,0,64,2,3,33.0,1.0,67.0,569
4556,-3,76,73,3,4,33.0,1.0,67.0,569
4557,12,69,81,3,5,33.0,1.0,67.0,569
4558,12,88,100,3,6,33.0,1.0,67.0,569
4559,50,50,100,3,7,33.0,1.0,67.0,569
4560,60,40,100,1,0,33.0,1.0,67.0,570
4561,-5,35,30,1,1,33.0,1.0,67.0,570
4562,-36,67,31,2,2,33.0,1.0,67.0,570
4563,64,36,100,2,3,33.0,1.0,67.0,570
4564,27,71,98,3,4,33.0,1.0,67.0,570
4565,34,66,100,3,5,33.0,1.0,67.0,570
4566,47,33,80,3,6,33.0,1.0,67.0,570
4567,-35,38,3,3,7,33.0,1.0,67.0,570
4568,-3,66,63,1,0,33.0,1.0,67.0,571
4569,-6,82,76,1,1,33.0,1.0,67.0,571
4570,-13,45,32,2,2,33.0,1.0,67.0,571
4571,-10,33,23,2,3,33.0,1.0,67.0,571
4572,-8,79,71,3,4,33.0,1.0,67.0,571
4573,27,32,59,3,5,33.0,1.0,67.0,571
4574,8,11,19,3,6,33.0,1.0,67.0,571
4575,22,42,64,3,7,33.0,1.0,67.0,571
4576,-8,23,15,1,0,33.0,1.0,67.0,572
4577,-33,66,33,1,1,33.0,1.0,67.0,572
4578,5,36,41,2,2,33.0,1.0,67.0,572
4579,7,82,89,2,3,33.0,1.0,67.0,572
4580,45,13,58,3,4,33.0,1.0,67.0,572
4581,-6,33,27,3,5,33.0,1.0,67.0,572
4582,-20,97,77,3,6,33.0,1.0,67.0,572
4583,-18,28,10,3,7,33.0,1.0,67.0,572
4584,48,21,69,1,0,33.0,1.0,67.0,573
4585,12,49,61,1,1,33.0,1.0,67.0,573
4586,73,18,91,2,2,33.0,1.0,67.0,573
4587,-38,77,39,2,3,33.0,1.0,67.0,573
4588,20,19,39,3,4,33.0,1.0,67.0,573
4589,-29,69,40,3,5,33.0,1.0,67.0,573
4590,16,84,100,3,6,33.0,1.0,67.0,573
4591,14,25,39,3,7,33.0,1.0,67.0,573
4592,-9,50,41,1,0,33.0,1.0,67.0,574
4593,-6,88,82,1,1,33.0,1.0,67.0,574
4594,-4,27,23,2,2,33.0,1.0,67.0,574
4595,-25,88,63,2,3,33.0,1.0,67.0,574
4596,-5,88,83,3,4,33.0,1.0,67.0,574
4597,0,51,51,3,5,33.0,1.0,67.0,574
4598,0,0,0,3,6,33.0,1.0,67.0,574
4599,-7,73,66,3,7,33.0,1.0,67.0,574
4600,55,45,100,1,0,33.0,1.0,67.0,575
4601,90,10,100,1,1,33.0,1.0,67.0,575
4602,70,29,99,2,2,33.0,1.0,67.0,575
4603,53,47,100,2,3,33.0,1.0,67.0,575
4604,25,75,100,3,4,33.0,1.0,67.0,575
4605,56,44,100,3,5,33.0,1.0,67.0,575
4606,60,40,100,3,6,33.0,1.0,67.0,575
4607,97,3,100,3,7,33.0,1.0,67.0,575
4608,75,25,100,1,0,33.0,1.0,67.0,576
4609,100,0,100,1,1,33.0,1.0,67.0,576
4610,76,24,100,2,2,33.0,1.0,67.0,576
4611,98,0,98,2,3,33.0,1.0,67.0,576
4612,43,57,100,3,4,33.0,1.0,67.0,576
4613,100,0,100,3,5,33.0,1.0,67.0,576
4614,27,70,97,3,6,33.0,1.0,67.0,576
4615,99,1,100,3,7,33.0,1.0,67.0,576
4616,-9,27,18,1,0,34.0,1.0,66.0,577
4617,-14,36,22,1,1,34.0,1.0,66.0,577
4618,-14,32,18,2,2,34.0,1.0,66.0,577
4619,-1,31,30,2,3,34.0,1.0,66.0,577
4620,33,40,73,3,4,34.0,1.0,66.0,577
4621,-4,31,27,3,5,34.0,1.0,66.0,577
4622,-32,68,36,3,6,34.0,1.0,66.0,577
4623,-7,35,28,3,7,34.0,1.0,66.0,577
4624,-1,95,94,1,0,34.0,1.0,66.0,578
4625,-100,100,0,1,1,34.0,1.0,66.0,578
4626,-11,30,19,2,2,34.0,1.0,66.0,578
4627,-8,92,84,2,3,34.0,1.0,66.0,578
4628,-5,20,15,3,4,34.0,1.0,66.0,578
4629,-1,81,80,3,5,34.0,1.0,66.0,578
4630,11,79,90,3,6,34.0,1.0,66.0,578
4631,-53,83,30,3,7,34.0,1.0,66.0,578
4632,16,58,74,1,0,34.0,1.0,66.0,579
4633,32,65,97,1,1,34.0,1.0,66.0,579
4634,50,24,74,2,2,34.0,1.0,66.0,579
4635,63,15,78,2,3,34.0,1.0,66.0,579
4636,35,62,97,3,4,34.0,1.0,66.0,579
4637,44,40,84,3,5,34.0,1.0,66.0,579
4638,58,37,95,3,6,34.0,1.0,66.0,579
4639,79,11,90,3,7,34.0,1.0,66.0,579
4640,36,50,86,1,0,34.0,1.0,66.0,580
4641,0,100,100,1,1,34.0,1.0,66.0,580
4642,67,0,67,2,2,34.0,1.0,66.0,580
4643,63,37,100,2,3,34.0,1.0,66.0,580
4644,32,68,100,3,4,34.0,1.0,66.0,580
4645,64,36,100,3,5,34.0,1.0,66.0,580
4646,59,41,100,3,6,34.0,1.0,66.0,580
4647,24,0,24,3,7,34.0,1.0,66.0,580
4648,-7,18,11,1,0,34.0,1.0,66.0,581
4649,9,87,96,1,1,34.0,1.0,66.0,581
4650,-5,27,22,2,2,34.0,1.0,66.0,581
4651,3,11,14,2,3,34.0,1.0,66.0,581
4652,9,80,89,3,4,34.0,1.0,66.0,581
4653,2,61,63,3,5,34.0,1.0,66.0,581
4654,19,81,100,3,6,34.0,1.0,66.0,581
4655,-2,9,7,3,7,34.0,1.0,66.0,581
4656,100,0,100,1,0,34.0,1.0,66.0,582
4657,100,0,100,1,1,34.0,1.0,66.0,582
4658,-7,100,93,2,2,34.0,1.0,66.0,582
4659,0,99,99,2,3,34.0,1.0,66.0,582
4660,46,53,99,3,4,34.0,1.0,66.0,582
4661,98,1,99,3,5,34.0,1.0,66.0,582
4662,-1,100,99,3,6,34.0,1.0,66.0,582
4663,0,1,1,3,7,34.0,1.0,66.0,582
4664,27,63,90,1,0,34.0,1.0,66.0,583
4665,-11,11,0,1,1,34.0,1.0,66.0,583
4666,41,47,88,2,2,34.0,1.0,66.0,583
4667,74,0,74,2,3,34.0,1.0,66.0,583
4668,25,75,100,3,4,34.0,1.0,66.0,583
4669,31,50,81,3,5,34.0,1.0,66.0,583
4670,45,55,100,3,6,34.0,1.0,66.0,583
4671,5,11,16,3,7,34.0,1.0,66.0,583
4672,0,0,0,1,0,34.0,1.0,66.0,584
4673,-11,11,0,1,1,34.0,1.0,66.0,584
4674,0,0,0,2,2,34.0,1.0,66.0,584
4675,3,0,3,2,3,34.0,1.0,66.0,584
4676,-100,100,0,3,4,34.0,1.0,66.0,584
4677,-6,6,0,3,5,34.0,1.0,66.0,584
4678,-1,1,0,3,6,34.0,1.0,66.0,584
4679,0,0,0,3,7,34.0,1.0,66.0,584
4680,50,39,89,1,0,34.0,1.0,66.0,585
4681,92,0,92,1,1,34.0,1.0,66.0,585
4682,80,2,82,2,2,34.0,1.0,66.0,585
4683,99,1,100,2,3,34.0,1.0,66.0,585
4684,45,37,82,3,4,34.0,1.0,66.0,585
4685,43,41,84,3,5,34.0,1.0,66.0,585
4686,14,57,71,3,6,34.0,1.0,66.0,585
4687,77,9,86,3,7,34.0,1.0,66.0,585
4688,2,69,71,1,0,34.0,1.0,66.0,586
4689,-32,63,31,1,1,34.0,1.0,66.0,586
4690,-5,75,70,2,2,34.0,1.0,66.0,586
4691,44,32,76,2,3,34.0,1.0,66.0,586
4692,12,55,67,3,4,34.0,1.0,66.0,586
4693,-21,47,26,3,5,34.0,1.0,66.0,586
4694,2,64,66,3,6,34.0,1.0,66.0,586
4695,29,50,79,3,7,34.0,1.0,66.0,586
4696,67,4,71,1,0,34.0,1.0,66.0,587
4697,7,88,95,1,1,34.0,1.0,66.0,587
4698,18,57,75,2,2,34.0,1.0,66.0,587
4699,60,0,60,2,3,34.0,1.0,66.0,587
4700,0,90,90,3,4,34.0,1.0,66.0,587
4701,82,0,82,3,5,34.0,1.0,66.0,587
4702,45,40,85,3,6,34.0,1.0,66.0,587
4703,33,0,33,3,7,34.0,1.0,66.0,587
4704,35,65,100,1,0,35.0,1.0,65.0,588
4705,0,100,100,1,1,35.0,1.0,65.0,588
4706,25,50,75,2,2,35.0,1.0,65.0,588
4707,25,50,75,2,3,35.0,1.0,65.0,588
4708,15,75,90,3,4,35.0,1.0,65.0,588
4709,50,50,100,3,5,35.0,1.0,65.0,588
4710,25,75,100,3,6,35.0,1.0,65.0,588
4711,25,50,75,3,7,35.0,1.0,65.0,588
4712,35,34,69,1,0,35.0,1.0,65.0,589
4713,-50,58,8,1,1,35.0,1.0,65.0,589
4714,0,38,38,2,2,35.0,1.0,65.0,589
4715,-25,46,21,2,3,35.0,1.0,65.0,589
4716,16,50,66,3,4,35.0,1.0,65.0,589
4717,8,33,41,3,5,35.0,1.0,65.0,589
4718,-2,19,17,3,6,35.0,1.0,65.0,589
4719,34,10,44,3,7,35.0,1.0,65.0,589
4720,-5,69,64,1,0,35.0,1.0,65.0,590
4721,-16,76,60,1,1,35.0,1.0,65.0,590
4722,-22,63,41,2,2,35.0,1.0,65.0,590
4723,5,35,40,2,3,35.0,1.0,65.0,590
4724,-28,63,35,3,4,35.0,1.0,65.0,590
4725,-22,86,64,3,5,35.0,1.0,65.0,590
4726,-33,67,34,3,6,35.0,1.0,65.0,590
4727,3,37,40,3,7,35.0,1.0,65.0,590
4728,11,89,100,1,0,35.0,1.0,65.0,591
4729,98,2,100,1,1,35.0,1.0,65.0,591
4730,94,6,100,2,2,35.0,1.0,65.0,591
4731,72,26,98,2,3,35.0,1.0,65.0,591
4732,23,77,100,3,4,35.0,1.0,65.0,591
4733,95,5,100,3,5,35.0,1.0,65.0,591
4734,98,2,100,3,6,35.0,1.0,65.0,591
4735,69,31,100,3,7,35.0,1.0,65.0,591
4736,-32,68,36,1,0,35.0,1.0,65.0,592
4737,16,15,31,1,1,35.0,1.0,65.0,592
4738,-1,65,64,2,2,35.0,1.0,65.0,592
4739,-14,81,67,2,3,35.0,1.0,65.0,592
4740,-50,80,30,3,4,35.0,1.0,65.0,592
4741,-25,88,63,3,5,35.0,1.0,65.0,592
4742,38,30,68,3,6,35.0,1.0,65.0,592
4743,2,64,66,3,7,35.0,1.0,65.0,592
4744,10,67,77,1,0,35.0,1.0,65.0,593
4745,-100,100,0,1,1,35.0,1.0,65.0,593
4746,11,0,11,2,2,35.0,1.0,65.0,593
4747,-3,18,15,2,3,35.0,1.0,65.0,593
4748,4,75,79,3,4,35.0,1.0,65.0,593
4749,28,37,65,3,5,35.0,1.0,65.0,593
4750,20,71,91,3,6,35.0,1.0,65.0,593
4751,14,8,22,3,7,35.0,1.0,65.0,593
4752,1,87,88,1,0,35.0,1.0,65.0,594
4753,1,90,91,1,1,35.0,1.0,65.0,594
4754,-7,28,21,2,2,35.0,1.0,65.0,594
4755,7,15,22,2,3,35.0,1.0,65.0,594
4756,16,75,91,3,4,35.0,1.0,65.0,594
4757,0,50,50,3,5,35.0,1.0,65.0,594
4758,1,50,51,3,6,35.0,1.0,65.0,594
4759,59,20,79,3,7,35.0,1.0,65.0,594
4760,7,73,80,1,0,35.0,1.0,65.0,595
4761,13,75,88,1,1,35.0,1.0,65.0,595
4762,44,12,56,2,2,35.0,1.0,65.0,595
4763,8,70,78,2,3,35.0,1.0,65.0,595
4764,68,31,99,3,4,35.0,1.0,65.0,595
4765,-6,78,72,3,5,35.0,1.0,65.0,595
4766,-43,73,30,3,6,35.0,1.0,65.0,595
4767,52,25,77,3,7,35.0,1.0,65.0,595
4768,10,40,50,1,0,35.0,1.0,65.0,596
4769,40,20,60,1,1,35.0,1.0,65.0,596
4770,20,40,60,2,2,35.0,1.0,65.0,596
4771,15,35,50,2,3,35.0,1.0,65.0,596
4772,10,50,60,3,4,35.0,1.0,65.0,596
4773,25,40,65,3,5,35.0,1.0,65.0,596
4774,55,20,75,3,6,35.0,1.0,65.0,596
4775,50,25,75,3,7,35.0,1.0,65.0,596
4776,77,5,82,1,0,35.0,1.0,65.0,597
4777,79,19,98,1,1,35.0,1.0,65.0,597
4778,76,10,86,2,2,35.0,1.0,65.0,597
4779,67,25,92,2,3,35.0,1.0,65.0,597
4780,65,32,97,3,4,35.0,1.0,65.0,597
4781,92,1,93,3,5,35.0,1.0,65.0,597
4782,4,96,100,3,6,35.0,1.0,65.0,597
4783,90,0,90,3,7,35.0,1.0,65.0,597
4784,57,22,79,1,0,35.0,1.0,65.0,598
4785,-55,72,17,1,1,35.0,1.0,65.0,598
4786,-24,50,26,2,2,35.0,1.0,65.0,598
4787,34,50,84,2,3,35.0,1.0,65.0,598
4788,23,66,89,3,4,35.0,1.0,65.0,598
4789,64,28,92,3,5,35.0,1.0,65.0,598
4790,54,36,90,3,6,35.0,1.0,65.0,598
4791,38,50,88,3,7,35.0,1.0,65.0,598
4792,-40,40,0,1,0,35.0,1.0,65.0,599
4793,-34,41,7,1,1,35.0,1.0,65.0,599
4794,2,5,7,2,2,35.0,1.0,65.0,599
4795,-17,22,5,2,3,35.0,1.0,65.0,599
4796,-2,60,58,3,4,35.0,1.0,65.0,599
4797,-5,31,26,3,5,35.0,1.0,65.0,599
4798,4,54,58,3,6,35.0,1.0,65.0,599
4799,-9,14,5,3,7,35.0,1.0,65.0,599
4800,25,38,63,1,0,35.0,1.0,65.0,600
4801,-14,77,63,1,1,35.0,1.0,65.0,600
4802,33,5,38,2,2,35.0,1.0,65.0,600
4803,63,0,63,2,3,35.0,1.0,65.0,600
4804,1,62,63,3,4,35.0,1.0,65.0,600
4805,49,13,62,3,5,35.0,1.0,65.0,600
4806,49,13,62,3,6,35.0,1.0,65.0,600
4807,63,0,63,3,7,35.0,1.0,65.0,600
4808,92,8,100,1,0,35.0,1.0,65.0,601
4809,25,75,100,1,1,35.0,1.0,65.0,601
4810,50,50,100,2,2,35.0,1.0,65.0,601
4811,50,50,100,2,3,35.0,1.0,65.0,601
4812,5,95,100,3,4,35.0,1.0,65.0,601
4813,88,12,100,3,5,35.0,1.0,65.0,601
4814,89,11,100,3,6,35.0,1.0,65.0,601
4815,76,24,100,3,7,35.0,1.0,65.0,601
4816,-17,48,31,1,0,35.0,1.0,65.0,602
4817,39,61,100,1,1,35.0,1.0,65.0,602
4818,9,91,100,2,2,35.0,1.0,65.0,602
4819,0,100,100,2,3,35.0,1.0,65.0,602
4820,42,55,97,3,4,35.0,1.0,65.0,602
4821,45,53,98,3,5,35.0,1.0,65.0,602
4822,57,25,82,3,6,35.0,1.0,65.0,602
4823,-56,65,9,3,7,35.0,1.0,65.0,602
4824,30,50,80,1,0,35.0,1.0,65.0,603
4825,0,100,100,1,1,35.0,1.0,65.0,603
4826,50,20,70,2,2,35.0,1.0,65.0,603
4827,30,35,65,2,3,35.0,1.0,65.0,603
4828,25,60,85,3,4,35.0,1.0,65.0,603
4829,45,50,95,3,5,35.0,1.0,65.0,603
4830,15,50,65,3,6,35.0,1.0,65.0,603
4831,50,10,60,3,7,35.0,1.0,65.0,603
4832,43,28,71,1,0,35.0,1.0,65.0,604
4833,18,65,83,1,1,35.0,1.0,65.0,604
4834,31,41,72,2,2,35.0,1.0,65.0,604
4835,10,69,79,2,3,35.0,1.0,65.0,604
4836,36,30,66,3,4,35.0,1.0,65.0,604
4837,-18,50,32,3,5,35.0,1.0,65.0,604
4838,0,100,100,3,6,35.0,1.0,65.0,604
4839,0,0,0,3,7,35.0,1.0,65.0,604
4840,-42,62,20,1,0,35.0,1.0,65.0,605
4841,4,63,67,1,1,35.0,1.0,65.0,605
4842,3,77,80,2,2,35.0,1.0,65.0,605
4843,100,0,100,2,3,35.0,1.0,65.0,605
4844,0,0,0,3,4,35.0,1.0,65.0,605
4845,0,27,27,3,5,35.0,1.0,65.0,605
4846,72,0,72,3,6,35.0,1.0,65.0,605
4847,31,0,31,3,7,35.0,1.0,65.0,605
4848,-35,69,34,1,0,35.0,1.0,65.0,606
4849,2,68,70,1,1,35.0,1.0,65.0,606
4850,-67,67,0,2,2,35.0,1.0,65.0,606
4851,0,74,74,2,3,35.0,1.0,65.0,606
4852,-11,39,28,3,4,35.0,1.0,65.0,606
4853,-3,63,60,3,5,35.0,1.0,65.0,606
4854,39,21,60,3,6,35.0,1.0,65.0,606
4855,-2,2,0,3,7,35.0,1.0,65.0,606
4856,-24,74,50,1,0,36.0,1.0,64.0,607
4857,0,100,100,1,1,36.0,1.0,64.0,607
4858,0,50,50,2,2,36.0,1.0,64.0,607
4859,-51,77,26,2,3,36.0,1.0,64.0,607
4860,6,72,78,3,4,36.0,1.0,64.0,607
4861,-2,30,28,3,5,36.0,1.0,64.0,607
4862,0,50,50,3,6,36.0,1.0,64.0,607
4863,72,0,72,3,7,36.0,1.0,64.0,607
4864,50,50,100,1,0,36.0,1.0,64.0,608
4865,50,50,100,1,1,36.0,1.0,64.0,608
4866,39,11,50,2,2,36.0,1.0,64.0,608
4867,-44,50,6,2,3,36.0,1.0,64.0,608
4868,68,32,100,3,4,36.0,1.0,64.0,608
4869,82,18,100,3,5,36.0,1.0,64.0,608
4870,85,15,100,3,6,36.0,1.0,64.0,608
4871,87,13,100,3,7,36.0,1.0,64.0,608
4872,0,87,87,1,0,36.0,1.0,64.0,609
4873,69,17,86,1,1,36.0,1.0,64.0,609
4874,53,36,89,2,2,36.0,1.0,64.0,609
4875,1,15,16,2,3,36.0,1.0,64.0,609
4876,-9,92,83,3,4,36.0,1.0,64.0,609
4877,54,36,90,3,5,36.0,1.0,64.0,609
4878,65,25,90,3,6,36.0,1.0,64.0,609
4879,63,23,86,3,7,36.0,1.0,64.0,609
4880,58,42,100,1,0,36.0,1.0,64.0,610
4881,36,64,100,1,1,36.0,1.0,64.0,610
4882,56,44,100,2,2,36.0,1.0,64.0,610
4883,46,54,100,2,3,36.0,1.0,64.0,610
4884,18,82,100,3,4,36.0,1.0,64.0,610
4885,100,0,100,3,5,36.0,1.0,64.0,610
4886,93,7,100,3,6,36.0,1.0,64.0,610
4887,-13,13,0,3,7,36.0,1.0,64.0,610
4888,-3,70,67,1,0,36.0,1.0,64.0,611
4889,-46,65,19,1,1,36.0,1.0,64.0,611
4890,-5,34,29,2,2,36.0,1.0,64.0,611
4891,-2,66,64,2,3,36.0,1.0,64.0,611
4892,1,63,64,3,4,36.0,1.0,64.0,611
4893,7,32,39,3,5,36.0,1.0,64.0,611
4894,-1,40,39,3,6,36.0,1.0,64.0,611
4895,-6,75,69,3,7,36.0,1.0,64.0,611
4896,33,48,81,1,0,36.0,1.0,64.0,612
4897,28,52,80,1,1,36.0,1.0,64.0,612
4898,8,76,84,2,2,36.0,1.0,64.0,612
4899,6,85,91,2,3,36.0,1.0,64.0,612
4900,28,56,84,3,4,36.0,1.0,64.0,612
4901,60,34,94,3,5,36.0,1.0,64.0,612
4902,34,51,85,3,6,36.0,1.0,64.0,612
4903,54,24,78,3,7,36.0,1.0,64.0,612
4904,-6,97,91,1,0,37.0,1.0,63.0,613
4905,0,100,100,1,1,37.0,1.0,63.0,613
4906,19,28,47,2,2,37.0,1.0,63.0,613
4907,52,16,68,2,3,37.0,1.0,63.0,613
4908,-1,47,46,3,4,37.0,1.0,63.0,613
4909,-3,70,67,3,5,37.0,1.0,63.0,613
4910,-12,44,32,3,6,37.0,1.0,63.0,613
4911,10,9,19,3,7,37.0,1.0,63.0,613
4912,-5,90,85,1,0,37.0,1.0,63.0,614
4913,0,100,100,1,1,37.0,1.0,63.0,614
4914,61,35,96,2,2,37.0,1.0,63.0,614
4915,90,5,95,2,3,37.0,1.0,63.0,614
4916,29,46,75,3,4,37.0,1.0,63.0,614
4917,70,30,100,3,5,37.0,1.0,63.0,614
4918,45,53,98,3,6,37.0,1.0,63.0,614
4919,86,10,96,3,7,37.0,1.0,63.0,614
4920,0,15,15,1,0,37.0,1.0,63.0,615
4921,1,40,41,1,1,37.0,1.0,63.0,615
4922,-30,57,27,2,2,37.0,1.0,63.0,615
4923,-10,27,17,2,3,37.0,1.0,63.0,615
4924,15,69,84,3,4,37.0,1.0,63.0,615
4925,33,0,33,3,5,37.0,1.0,63.0,615
4926,10,80,90,3,6,37.0,1.0,63.0,615
4927,4,14,18,3,7,37.0,1.0,63.0,615
4928,-16,60,44,1,0,37.0,1.0,63.0,616
4929,0,100,100,1,1,37.0,1.0,63.0,616
4930,14,40,54,2,2,37.0,1.0,63.0,616
4931,31,38,69,2,3,37.0,1.0,63.0,616
4932,-20,75,55,3,4,37.0,1.0,63.0,616
4933,-9,46,37,3,5,37.0,1.0,63.0,616
4934,12,26,38,3,6,37.0,1.0,63.0,616
4935,24,25,49,3,7,37.0,1.0,63.0,616
4936,-8,73,65,1,0,37.0,1.0,63.0,617
4937,-49,76,27,1,1,37.0,1.0,63.0,617
4938,44,32,76,2,2,37.0,1.0,63.0,617
4939,42,40,82,2,3,37.0,1.0,63.0,617
4940,38,44,82,3,4,37.0,1.0,63.0,617
4941,43,38,81,3,5,37.0,1.0,63.0,617
4942,17,79,96,3,6,37.0,1.0,63.0,617
4943,49,29,78,3,7,37.0,1.0,63.0,617
4944,5,74,79,1,0,37.0,1.0,63.0,618
4945,-3,13,10,1,1,37.0,1.0,63.0,618
4946,1,61,62,2,2,37.0,1.0,63.0,618
4947,0,24,24,2,3,37.0,1.0,63.0,618
4948,-2,37,35,3,4,37.0,1.0,63.0,618
4949,41,9,50,3,5,37.0,1.0,63.0,618
4950,-1,25,24,3,6,37.0,1.0,63.0,618
4951,9,70,79,3,7,37.0,1.0,63.0,618
4952,-12,50,38,1,0,37.0,1.0,63.0,619
4953,-8,88,80,1,1,37.0,1.0,63.0,619
4954,9,4,13,2,2,37.0,1.0,63.0,619
4955,7,12,19,2,3,37.0,1.0,63.0,619
4956,-1,82,81,3,4,37.0,1.0,63.0,619
4957,19,6,25,3,5,37.0,1.0,63.0,619
4958,0,50,50,3,6,37.0,1.0,63.0,619
4959,11,11,22,3,7,37.0,1.0,63.0,619
4960,90,10,100,1,0,37.0,1.0,63.0,620
4961,43,57,100,1,1,37.0,1.0,63.0,620
4962,76,24,100,2,2,37.0,1.0,63.0,620
4963,76,24,100,2,3,37.0,1.0,63.0,620
4964,50,50,100,3,4,37.0,1.0,63.0,620
4965,50,50,100,3,5,37.0,1.0,63.0,620
4966,89,11,100,3,6,37.0,1.0,63.0,620
4967,100,0,100,3,7,37.0,1.0,63.0,620
4968,61,28,89,1,0,37.0,1.0,63.0,621
4969,22,75,97,1,1,37.0,1.0,63.0,621
4970,-6,26,20,2,2,37.0,1.0,63.0,621
4971,51,33,84,2,3,37.0,1.0,63.0,621
4972,-2,35,33,3,4,37.0,1.0,63.0,621
4973,82,18,100,3,5,37.0,1.0,63.0,621
4974,64,36,100,3,6,37.0,1.0,63.0,621
4975,66,21,87,3,7,37.0,1.0,63.0,621
4976,38,62,100,1,0,38.0,1.0,62.0,622
4977,10,90,100,1,1,38.0,1.0,62.0,622
4978,63,37,100,2,2,38.0,1.0,62.0,622
4979,100,0,100,2,3,38.0,1.0,62.0,622
4980,50,50,100,3,4,38.0,1.0,62.0,622
4981,50,50,100,3,5,38.0,1.0,62.0,622
4982,25,75,100,3,6,38.0,1.0,62.0,622
4983,50,50,100,3,7,38.0,1.0,62.0,622
4984,-37,76,39,1,0,38.0,1.0,62.0,623
4985,-19,81,62,1,1,38.0,1.0,62.0,623
4986,-34,70,36,2,2,38.0,1.0,62.0,623
4987,52,22,74,2,3,38.0,1.0,62.0,623
4988,-8,72,64,3,4,38.0,1.0,62.0,623
4989,8,21,29,3,5,38.0,1.0,62.0,623
4990,-10,76,66,3,6,38.0,1.0,62.0,623
4991,6,20,26,3,7,38.0,1.0,62.0,623
4992,0,0,0,1,0,38.0,1.0,62.0,624
4993,-18,76,58,1,1,38.0,1.0,62.0,624
4994,-38,90,52,2,2,38.0,1.0,62.0,624
4995,62,0,62,2,3,38.0,1.0,62.0,624
4996,11,50,61,3,4,38.0,1.0,62.0,624
4997,46,0,46,3,5,38.0,1.0,62.0,624
4998,63,0,63,3,6,38.0,1.0,62.0,624
4999,4,65,69,3,7,38.0,1.0,62.0,624
5000,36,60,96,1,0,38.0,1.0,62.0,625
5001,16,76,92,1,1,38.0,1.0,62.0,625
5002,58,42,100,2,2,38.0,1.0,62.0,625
5003,-30,33,3,2,3,38.0,1.0,62.0,625
5004,34,62,96,3,4,38.0,1.0,62.0,625
5005,57,43,100,3,5,38.0,1.0,62.0,625
5006,51,49,100,3,6,38.0,1.0,62.0,625
5007,49,51,100,3,7,38.0,1.0,62.0,625
5008,28,62,90,1,0,38.0,1.0,62.0,626
5009,16,51,67,1,1,38.0,1.0,62.0,626
5010,26,64,90,2,2,38.0,1.0,62.0,626
5011,27,38,65,2,3,38.0,1.0,62.0,626
5012,26,62,88,3,4,38.0,1.0,62.0,626
5013,23,65,88,3,5,38.0,1.0,62.0,626
5014,63,25,88,3,6,38.0,1.0,62.0,626
5015,75,0,75,3,7,38.0,1.0,62.0,626
5016,49,36,85,1,0,38.0,1.0,62.0,627
5017,4,14,18,1,1,38.0,1.0,62.0,627
5018,2,22,24,2,2,38.0,1.0,62.0,627
5019,2,10,12,2,3,38.0,1.0,62.0,627
5020,7,88,95,3,4,38.0,1.0,62.0,627
5021,2,76,78,3,5,38.0,1.0,62.0,627
5022,0,100,100,3,6,38.0,1.0,62.0,627
5023,10,16,26,3,7,38.0,1.0,62.0,627
5024,80,10,90,1,0,38.0,1.0,62.0,628
5025,18,71,89,1,1,38.0,1.0,62.0,628
5026,28,50,78,2,2,38.0,1.0,62.0,628
5027,46,44,90,2,3,38.0,1.0,62.0,628
5028,24,58,82,3,4,38.0,1.0,62.0,628
5029,58,25,83,3,5,38.0,1.0,62.0,628
5030,41,50,91,3,6,38.0,1.0,62.0,628
5031,60,10,70,3,7,38.0,1.0,62.0,628
5032,79,1,80,1,0,38.0,1.0,62.0,629
5033,0,50,50,1,1,38.0,1.0,62.0,629
5034,95,0,95,2,2,38.0,1.0,62.0,629
5035,20,71,91,2,3,38.0,1.0,62.0,629
5036,33,61,94,3,4,38.0,1.0,62.0,629
5037,88,1,89,3,5,38.0,1.0,62.0,629
5038,0,100,100,3,6,38.0,1.0,62.0,629
5039,83,7,90,3,7,38.0,1.0,62.0,629
5040,32,68,100,1,0,39.0,1.0,61.0,630
5041,0,100,100,1,1,39.0,1.0,61.0,630
5042,61,39,100,2,2,39.0,1.0,61.0,630
5043,93,0,93,2,3,39.0,1.0,61.0,630
5044,25,75,100,3,4,39.0,1.0,61.0,630
5045,29,71,100,3,5,39.0,1.0,61.0,630
5046,92,0,92,3,6,39.0,1.0,61.0,630
5047,97,3,100,3,7,39.0,1.0,61.0,630
5048,-3,18,15,1,0,39.0,1.0,61.0,631
5049,14,64,78,1,1,39.0,1.0,61.0,631
5050,-10,33,23,2,2,39.0,1.0,61.0,631
5051,-8,25,17,2,3,39.0,1.0,61.0,631
5052,-4,20,16,3,4,39.0,1.0,61.0,631
5053,8,0,8,3,5,39.0,1.0,61.0,631
5054,-16,31,15,3,6,39.0,1.0,61.0,631
5055,5,8,13,3,7,39.0,1.0,61.0,631
5056,50,50,100,1,0,39.0,1.0,61.0,632
5057,31,69,100,1,1,39.0,1.0,61.0,632
5058,50,50,100,2,2,39.0,1.0,61.0,632
5059,26,74,100,2,3,39.0,1.0,61.0,632
5060,50,50,100,3,4,39.0,1.0,61.0,632
5061,50,50,100,3,5,39.0,1.0,61.0,632
5062,-27,27,0,3,6,39.0,1.0,61.0,632
5063,78,22,100,3,7,39.0,1.0,61.0,632
5064,30,36,66,1,0,39.0,1.0,61.0,633
5065,7,65,72,1,1,39.0,1.0,61.0,633
5066,41,43,84,2,2,39.0,1.0,61.0,633
5067,30,32,62,2,3,39.0,1.0,61.0,633
5068,24,61,85,3,4,39.0,1.0,61.0,633
5069,47,34,81,3,5,39.0,1.0,61.0,633
5070,27,43,70,3,6,39.0,1.0,61.0,633
5071,0,32,32,3,7,39.0,1.0,61.0,633
5072,0,100,100,1,0,39.0,1.0,61.0,634
5073,6,94,100,1,1,39.0,1.0,61.0,634
5074,4,52,56,2,2,39.0,1.0,61.0,634
5075,-10,10,0,2,3,39.0,1.0,61.0,634
5076,-3,63,60,3,4,39.0,1.0,61.0,634
5077,17,1,18,3,5,39.0,1.0,61.0,634
5078,-11,57,46,3,6,39.0,1.0,61.0,634
5079,13,45,58,3,7,39.0,1.0,61.0,634
5080,62,38,100,1,0,39.0,1.0,61.0,635
5081,42,58,100,1,1,39.0,1.0,61.0,635
5082,11,8,19,2,2,39.0,1.0,61.0,635
5083,66,34,100,2,3,39.0,1.0,61.0,635
5084,39,61,100,3,4,39.0,1.0,61.0,635
5085,32,68,100,3,5,39.0,1.0,61.0,635
5086,100,0,100,3,6,39.0,1.0,61.0,635
5087,100,0,100,3,7,39.0,1.0,61.0,635
5088,77,0,77,1,0,39.0,1.0,61.0,636
5089,100,0,100,1,1,39.0,1.0,61.0,636
5090,-44,52,8,2,2,39.0,1.0,61.0,636
5091,56,44,100,2,3,39.0,1.0,61.0,636
5092,44,56,100,3,4,39.0,1.0,61.0,636
5093,54,46,100,3,5,39.0,1.0,61.0,636
5094,75,25,100,3,6,39.0,1.0,61.0,636
5095,100,0,100,3,7,39.0,1.0,61.0,636
5096,26,74,100,1,0,39.0,1.0,61.0,637
5097,84,16,100,1,1,39.0,1.0,61.0,637
5098,80,20,100,2,2,39.0,1.0,61.0,637
5099,87,13,100,2,3,39.0,1.0,61.0,637
5100,-83,83,0,3,4,39.0,1.0,61.0,637
5101,31,69,100,3,5,39.0,1.0,61.0,637
5102,71,29,100,3,6,39.0,1.0,61.0,637
5103,100,0,100,3,7,39.0,1.0,61.0,637
5104,34,51,85,1,0,39.0,1.0,61.0,638
5105,0,100,100,1,1,39.0,1.0,61.0,638
5106,30,49,79,2,2,39.0,1.0,61.0,638
5107,5,63,68,2,3,39.0,1.0,61.0,638
5108,-23,65,42,3,4,39.0,1.0,61.0,638
5109,23,53,76,3,5,39.0,1.0,61.0,638
5110,13,87,100,3,6,39.0,1.0,61.0,638
5111,15,27,42,3,7,39.0,1.0,61.0,638
5112,-19,92,73,1,0,39.0,1.0,61.0,639
5113,-1,80,79,1,1,39.0,1.0,61.0,639
5114,4,71,75,2,2,39.0,1.0,61.0,639
5115,9,71,80,2,3,39.0,1.0,61.0,639
5116,-3,79,76,3,4,39.0,1.0,61.0,639
5117,13,28,41,3,5,39.0,1.0,61.0,639
5118,18,48,66,3,6,39.0,1.0,61.0,639
5119,21,79,100,3,7,39.0,1.0,61.0,639
5120,3,50,53,1,0,39.0,1.0,61.0,640
5121,-6,89,83,1,1,39.0,1.0,61.0,640
5122,6,48,54,2,2,39.0,1.0,61.0,640
5123,3,48,51,2,3,39.0,1.0,61.0,640
5124,-4,62,58,3,4,39.0,1.0,61.0,640
5125,19,43,62,3,5,39.0,1.0,61.0,640
5126,-16,50,34,3,6,39.0,1.0,61.0,640
5127,15,47,62,3,7,39.0,1.0,61.0,640
5128,-11,57,46,1,0,40.0,1.0,60.0,641
5129,-43,94,51,1,1,40.0,1.0,60.0,641
5130,22,43,65,2,2,40.0,1.0,60.0,641
5131,60,29,89,2,3,40.0,1.0,60.0,641
5132,18,42,60,3,4,40.0,1.0,60.0,641
5133,44,51,95,3,5,40.0,1.0,60.0,641
5134,74,22,96,3,6,40.0,1.0,60.0,641
5135,44,3,47,3,7,40.0,1.0,60.0,641
5136,65,35,100,1,0,40.0,1.0,60.0,642
5137,40,60,100,1,1,40.0,1.0,60.0,642
5138,50,0,50,2,2,40.0,1.0,60.0,642
5139,85,15,100,2,3,40.0,1.0,60.0,642
5140,30,70,100,3,4,40.0,1.0,60.0,642
5141,100,0,100,3,5,40.0,1.0,60.0,642
5142,50,50,100,3,6,40.0,1.0,60.0,642
5143,95,5,100,3,7,40.0,1.0,60.0,642
5144,25,67,92,1,0,40.0,1.0,60.0,643
5145,0,100,100,1,1,40.0,1.0,60.0,643
5146,28,0,28,2,2,40.0,1.0,60.0,643
5147,24,37,61,2,3,40.0,1.0,60.0,643
5148,25,64,89,3,4,40.0,1.0,60.0,643
5149,20,70,90,3,5,40.0,1.0,60.0,643
5150,16,84,100,3,6,40.0,1.0,60.0,643
5151,50,0,50,3,7,40.0,1.0,60.0,643
5152,85,0,85,1,0,40.0,1.0,60.0,644
5153,78,10,88,1,1,40.0,1.0,60.0,644
5154,100,0,100,2,2,40.0,1.0,60.0,644
5155,14,86,100,2,3,40.0,1.0,60.0,644
5156,0,100,100,3,4,40.0,1.0,60.0,644
5157,100,0,100,3,5,40.0,1.0,60.0,644
5158,50,50,100,3,6,40.0,1.0,60.0,644
5159,100,0,100,3,7,40.0,1.0,60.0,644
5160,22,70,92,1,0,40.0,1.0,60.0,645
5161,12,68,80,1,1,40.0,1.0,60.0,645
5162,40,33,73,2,2,40.0,1.0,60.0,645
5163,45,32,77,2,3,40.0,1.0,60.0,645
5164,35,50,85,3,4,40.0,1.0,60.0,645
5165,43,56,99,3,5,40.0,1.0,60.0,645
5166,19,81,100,3,6,40.0,1.0,60.0,645
5167,45,34,79,3,7,40.0,1.0,60.0,645
5168,-43,66,23,1,0,40.0,1.0,60.0,646
5169,0,100,100,1,1,40.0,1.0,60.0,646
5170,28,35,63,2,2,40.0,1.0,60.0,646
5171,26,65,91,2,3,40.0,1.0,60.0,646
5172,51,49,100,3,4,40.0,1.0,60.0,646
5173,20,68,88,3,5,40.0,1.0,60.0,646
5174,-19,29,10,3,6,40.0,1.0,60.0,646
5175,71,10,81,3,7,40.0,1.0,60.0,646
5176,0,75,75,1,0,40.0,1.0,60.0,647
5177,0,100,100,1,1,40.0,1.0,60.0,647
5178,50,0,50,2,2,40.0,1.0,60.0,647
5179,0,50,50,2,3,40.0,1.0,60.0,647
5180,0,75,75,3,4,40.0,1.0,60.0,647
5181,75,0,75,3,5,40.0,1.0,60.0,647
5182,0,100,100,3,6,40.0,1.0,60.0,647
5183,0,0,0,3,7,40.0,1.0,60.0,647
5184,13,87,100,1,0,40.0,1.0,60.0,648
5185,6,94,100,1,1,40.0,1.0,60.0,648
5186,71,14,85,2,2,40.0,1.0,60.0,648
5187,17,83,100,2,3,40.0,1.0,60.0,648
5188,71,29,100,3,4,40.0,1.0,60.0,648
5189,0,0,0,3,5,40.0,1.0,60.0,648
5190,-13,93,80,3,6,40.0,1.0,60.0,648
5191,64,5,69,3,7,40.0,1.0,60.0,648
5192,36,64,100,1,0,40.0,1.0,60.0,649
5193,0,100,100,1,1,40.0,1.0,60.0,649
5194,24,26,50,2,2,40.0,1.0,60.0,649
5195,9,0,9,2,3,40.0,1.0,60.0,649
5196,0,0,0,3,4,40.0,1.0,60.0,649
5197,1,60,61,3,5,40.0,1.0,60.0,649
5198,-2,76,74,3,6,40.0,1.0,60.0,649
5199,-3,30,27,3,7,40.0,1.0,60.0,649
5200,12,64,76,1,0,40.0,1.0,60.0,650
5201,6,73,79,1,1,40.0,1.0,60.0,650
5202,-3,47,44,2,2,40.0,1.0,60.0,650
5203,-17,60,43,2,3,40.0,1.0,60.0,650
5204,7,55,62,3,4,40.0,1.0,60.0,650
5205,11,31,42,3,5,40.0,1.0,60.0,650
5206,-1,47,46,3,6,40.0,1.0,60.0,650
5207,9,30,39,3,7,40.0,1.0,60.0,650
5208,-7,48,41,1,0,40.0,1.0,60.0,651
5209,9,50,59,1,1,40.0,1.0,60.0,651
5210,-6,41,35,2,2,40.0,1.0,60.0,651
5211,20,25,45,2,3,40.0,1.0,60.0,651
5212,10,60,70,3,4,40.0,1.0,60.0,651
5213,15,45,60,3,5,40.0,1.0,60.0,651
5214,0,100,100,3,6,40.0,1.0,60.0,651
5215,-10,40,30,3,7,40.0,1.0,60.0,651
5216,62,25,87,1,0,40.0,1.0,60.0,652
5217,1,88,89,1,1,40.0,1.0,60.0,652
5218,-10,87,77,2,2,40.0,1.0,60.0,652
5219,48,25,73,2,3,40.0,1.0,60.0,652
5220,26,50,76,3,4,40.0,1.0,60.0,652
5221,1,21,22,3,5,40.0,1.0,60.0,652
5222,-14,25,11,3,6,40.0,1.0,60.0,652
5223,75,0,75,3,7,40.0,1.0,60.0,652
5224,10,75,85,1,0,40.0,1.0,60.0,653
5225,0,100,100,1,1,40.0,1.0,60.0,653
5226,12,52,64,2,2,40.0,1.0,60.0,653
5227,37,25,62,2,3,40.0,1.0,60.0,653
5228,5,80,85,3,4,40.0,1.0,60.0,653
5229,27,38,65,3,5,40.0,1.0,60.0,653
5230,58,39,97,3,6,40.0,1.0,60.0,653
5231,47,42,89,3,7,40.0,1.0,60.0,653
5232,37,63,100,1,0,40.0,1.0,60.0,654
5233,11,89,100,1,1,40.0,1.0,60.0,654
5234,54,46,100,2,2,40.0,1.0,60.0,654
5235,75,25,100,2,3,40.0,1.0,60.0,654
5236,11,89,100,3,4,40.0,1.0,60.0,654
5237,50,50,100,3,5,40.0,1.0,60.0,654
5238,62,38,100,3,6,40.0,1.0,60.0,654
5239,63,37,100,3,7,40.0,1.0,60.0,654
5240,42,50,92,1,0,40.0,1.0,60.0,655
5241,61,39,100,1,1,40.0,1.0,60.0,655
5242,42,50,92,2,2,40.0,1.0,60.0,655
5243,86,14,100,2,3,40.0,1.0,60.0,655
5244,12,88,100,3,4,40.0,1.0,60.0,655
5245,84,16,100,3,5,40.0,1.0,60.0,655
5246,73,27,100,3,6,40.0,1.0,60.0,655
5247,75,15,90,3,7,40.0,1.0,60.0,655
5248,9,70,79,1,0,40.0,1.0,60.0,656
5249,-2,100,98,1,1,40.0,1.0,60.0,656
5250,81,0,81,2,2,40.0,1.0,60.0,656
5251,18,18,36,2,3,40.0,1.0,60.0,656
5252,-49,68,19,3,4,40.0,1.0,60.0,656
5253,-26,33,7,3,5,40.0,1.0,60.0,656
5254,9,88,97,3,6,40.0,1.0,60.0,656
5255,4,90,94,3,7,40.0,1.0,60.0,656
5256,0,0,0,1,0,40.0,1.0,60.0,657
5257,44,25,69,1,1,40.0,1.0,60.0,657
5258,15,75,90,2,2,40.0,1.0,60.0,657
5259,0,0,0,2,3,40.0,1.0,60.0,657
5260,0,100,100,3,4,40.0,1.0,60.0,657
5261,91,0,91,3,5,40.0,1.0,60.0,657
5262,47,40,87,3,6,40.0,1.0,60.0,657
5263,82,0,82,3,7,40.0,1.0,60.0,657
5264,60,40,100,1,0,40.0,1.0,60.0,658
5265,75,25,100,1,1,40.0,1.0,60.0,658
5266,50,0,50,2,2,40.0,1.0,60.0,658
5267,-40,40,0,2,3,40.0,1.0,60.0,658
5268,0,100,100,3,4,40.0,1.0,60.0,658
5269,100,0,100,3,5,40.0,1.0,60.0,658
5270,39,61,100,3,6,40.0,1.0,60.0,658
5271,0,0,0,3,7,40.0,1.0,60.0,658
5272,10,90,100,1,0,40.0,1.0,60.0,659
5273,40,60,100,1,1,40.0,1.0,60.0,659
5274,-39,50,11,2,2,40.0,1.0,60.0,659
5275,60,10,70,2,3,40.0,1.0,60.0,659
5276,25,65,90,3,4,40.0,1.0,60.0,659
5277,55,30,85,3,5,40.0,1.0,60.0,659
5278,10,90,100,3,6,40.0,1.0,60.0,659
5279,75,10,85,3,7,40.0,1.0,60.0,659
5280,46,54,100,1,0,40.0,1.0,60.0,660
5281,0,100,100,1,1,40.0,1.0,60.0,660
5282,54,0,54,2,2,40.0,1.0,60.0,660
5283,17,40,57,2,3,40.0,1.0,60.0,660
5284,-8,63,55,3,4,40.0,1.0,60.0,660
5285,17,38,55,3,5,40.0,1.0,60.0,660
5286,-53,100,47,3,6,40.0,1.0,60.0,660
5287,3,50,53,3,7,40.0,1.0,60.0,660
5288,35,65,100,1,0,40.0,1.0,60.0,661
5289,0,100,100,1,1,40.0,1.0,60.0,661
5290,18,79,97,2,2,40.0,1.0,60.0,661
5291,20,80,100,2,3,40.0,1.0,60.0,661
5292,38,50,88,3,4,40.0,1.0,60.0,661
5293,41,59,100,3,5,40.0,1.0,60.0,661
5294,63,37,100,3,6,40.0,1.0,60.0,661
5295,62,38,100,3,7,40.0,1.0,60.0,661
5296,60,40,100,1,0,40.0,1.0,60.0,662
5297,0,100,100,1,1,40.0,1.0,60.0,662
5298,100,0,100,2,2,40.0,1.0,60.0,662
5299,100,0,100,2,3,40.0,1.0,60.0,662
5300,70,30,100,3,4,40.0,1.0,60.0,662
5301,100,0,100,3,5,40.0,1.0,60.0,662
5302,0,0,0,3,6,40.0,1.0,60.0,662
5303,100,0,100,3,7,40.0,1.0,60.0,662
5304,12,71,83,1,0,40.0,1.0,60.0,663
5305,16,73,89,1,1,40.0,1.0,60.0,663
5306,57,36,93,2,2,40.0,1.0,60.0,663
5307,79,13,92,2,3,40.0,1.0,60.0,663
5308,0,86,86,3,4,40.0,1.0,60.0,663
5309,10,90,100,3,5,40.0,1.0,60.0,663
5310,90,10,100,3,6,40.0,1.0,60.0,663
5311,37,50,87,3,7,40.0,1.0,60.0,663
5312,3,79,82,1,0,40.0,1.0,60.0,664
5313,-4,94,90,1,1,40.0,1.0,60.0,664
5314,0,0,0,2,2,40.0,1.0,60.0,664
5315,-12,14,2,2,3,40.0,1.0,60.0,664
5316,1,28,29,3,4,40.0,1.0,60.0,664
5317,2,20,22,3,5,40.0,1.0,60.0,664
5318,3,85,88,3,6,40.0,1.0,60.0,664
5319,-14,22,8,3,7,40.0,1.0,60.0,664
5320,-32,59,27,1,0,40.0,1.0,60.0,665
5321,20,56,76,1,1,40.0,1.0,60.0,665
5322,-14,14,0,2,2,40.0,1.0,60.0,665
5323,0,0,0,2,3,40.0,1.0,60.0,665
5324,4,57,61,3,4,40.0,1.0,60.0,665
5325,0,34,34,3,5,40.0,1.0,60.0,665
5326,-6,69,63,3,6,40.0,1.0,60.0,665
5327,-1,27,26,3,7,40.0,1.0,60.0,665
5328,100,0,100,1,0,40.0,1.0,60.0,666
5329,0,0,0,1,1,40.0,1.0,60.0,666
5330,90,7,97,2,2,40.0,1.0,60.0,666
5331,100,0,100,2,3,40.0,1.0,60.0,666
5332,62,38,100,3,4,40.0,1.0,60.0,666
5333,-6,6,0,3,5,40.0,1.0,60.0,666
5334,92,8,100,3,6,40.0,1.0,60.0,666
5335,-24,24,0,3,7,40.0,1.0,60.0,666
5336,3,57,60,1,0,40.0,1.0,60.0,667
5337,0,77,77,1,1,40.0,1.0,60.0,667
5338,25,32,57,2,2,40.0,1.0,60.0,667
5339,3,36,39,2,3,40.0,1.0,60.0,667
5340,8,69,77,3,4,40.0,1.0,60.0,667
5341,15,50,65,3,5,40.0,1.0,60.0,667
5342,18,45,63,3,6,40.0,1.0,60.0,667
5343,32,44,76,3,7,40.0,1.0,60.0,667
5344,94,0,94,1,0,40.0,1.0,60.0,668
5345,0,100,100,1,1,40.0,1.0,60.0,668
5346,50,30,80,2,2,40.0,1.0,60.0,668
5347,40,0,40,2,3,40.0,1.0,60.0,668
5348,0,100,100,3,4,40.0,1.0,60.0,668
5349,100,0,100,3,5,40.0,1.0,60.0,668
5350,0,100,100,3,6,40.0,1.0,60.0,668
5351,0,0,0,3,7,40.0,1.0,60.0,668
5352,100,0,100,1,0,40.0,1.0,60.0,669
5353,37,63,100,1,1,40.0,1.0,60.0,669
5354,100,0,100,2,2,40.0,1.0,60.0,669
5355,100,0,100,2,3,40.0,1.0,60.0,669
5356,50,50,100,3,4,40.0,1.0,60.0,669
5357,50,50,100,3,5,40.0,1.0,60.0,669
5358,0,0,0,3,6,40.0,1.0,60.0,669
5359,100,0,100,3,7,40.0,1.0,60.0,669
5360,17,50,67,1,0,40.0,1.0,60.0,670
5361,9,55,64,1,1,40.0,1.0,60.0,670
5362,8,50,58,2,2,40.0,1.0,60.0,670
5363,22,31,53,2,3,40.0,1.0,60.0,670
5364,3,67,70,3,4,40.0,1.0,60.0,670
5365,-1,54,53,3,5,40.0,1.0,60.0,670
5366,11,50,61,3,6,40.0,1.0,60.0,670
5367,20,36,56,3,7,40.0,1.0,60.0,670
5368,-1,64,63,1,0,40.0,1.0,60.0,671
5369,-10,76,66,1,1,40.0,1.0,60.0,671
5370,29,17,46,2,2,40.0,1.0,60.0,671
5371,15,0,15,2,3,40.0,1.0,60.0,671
5372,-21,62,41,3,4,40.0,1.0,60.0,671
5373,41,16,57,3,5,40.0,1.0,60.0,671
5374,13,42,55,3,6,40.0,1.0,60.0,671
5375,-6,39,33,3,7,40.0,1.0,60.0,671
5376,49,50,99,1,0,40.0,1.0,60.0,672
5377,11,89,100,1,1,40.0,1.0,60.0,672
5378,67,32,99,2,2,40.0,1.0,60.0,672
5379,71,24,95,2,3,40.0,1.0,60.0,672
5380,54,42,96,3,4,40.0,1.0,60.0,672
5381,47,50,97,3,5,40.0,1.0,60.0,672
5382,63,37,100,3,6,40.0,1.0,60.0,672
5383,46,50,96,3,7,40.0,1.0,60.0,672
5384,50,50,100,1,0,40.0,1.0,60.0,673
5385,0,100,100,1,1,40.0,1.0,60.0,673
5386,100,0,100,2,2,40.0,1.0,60.0,673
5387,100,0,100,2,3,40.0,1.0,60.0,673
5388,22,78,100,3,4,40.0,1.0,60.0,673
5389,50,50,100,3,5,40.0,1.0,60.0,673
5390,25,75,100,3,6,40.0,1.0,60.0,673
5391,100,0,100,3,7,40.0,1.0,60.0,673
5392,0,50,50,1,0,40.0,1.0,60.0,674
5393,20,80,100,1,1,40.0,1.0,60.0,674
5394,30,50,80,2,2,40.0,1.0,60.0,674
5395,50,25,75,2,3,40.0,1.0,60.0,674
5396,30,70,100,3,4,40.0,1.0,60.0,674
5397,0,50,50,3,5,40.0,1.0,60.0,674
5398,0,100,100,3,6,40.0,1.0,60.0,674
5399,30,50,80,3,7,40.0,1.0,60.0,674
5400,43,50,93,1,0,40.0,1.0,60.0,675
5401,0,90,90,1,1,40.0,1.0,60.0,675
5402,61,25,86,2,2,40.0,1.0,60.0,675
5403,65,25,90,2,3,40.0,1.0,60.0,675
5404,24,75,99,3,4,40.0,1.0,60.0,675
5405,44,50,94,3,5,40.0,1.0,60.0,675
5406,49,50,99,3,6,40.0,1.0,60.0,675
5407,50,40,90,3,7,40.0,1.0,60.0,675
5408,54,11,65,1,0,40.0,1.0,60.0,676
5409,25,64,89,1,1,40.0,1.0,60.0,676
5410,47,34,81,2,2,40.0,1.0,60.0,676
5411,51,0,51,2,3,40.0,1.0,60.0,676
5412,13,64,77,3,4,40.0,1.0,60.0,676
5413,65,24,89,3,5,40.0,1.0,60.0,676
5414,0,100,100,3,6,40.0,1.0,60.0,676
5415,21,11,32,3,7,40.0,1.0,60.0,676
5416,2,51,53,1,0,40.0,1.0,60.0,677
5417,2,51,53,1,1,40.0,1.0,60.0,677
5418,-4,56,52,2,2,40.0,1.0,60.0,677
5419,-11,39,28,2,3,40.0,1.0,60.0,677
5420,11,75,86,3,4,40.0,1.0,60.0,677
5421,2,70,72,3,5,40.0,1.0,60.0,677
5422,-2,71,69,3,6,40.0,1.0,60.0,677
5423,-1,24,23,3,7,40.0,1.0,60.0,677
5424,0,65,65,1,0,40.0,1.0,60.0,678
5425,5,85,90,1,1,40.0,1.0,60.0,678
5426,0,10,10,2,2,40.0,1.0,60.0,678
5427,-25,35,10,2,3,40.0,1.0,60.0,678
5428,5,50,55,3,4,40.0,1.0,60.0,678
5429,0,50,50,3,5,40.0,1.0,60.0,678
5430,15,10,25,3,6,40.0,1.0,60.0,678
5431,15,35,50,3,7,40.0,1.0,60.0,678
5432,20,80,100,1,0,40.0,1.0,60.0,679
5433,0,100,100,1,1,40.0,1.0,60.0,679
5434,75,0,75,2,2,40.0,1.0,60.0,679
5435,20,80,100,2,3,40.0,1.0,60.0,679
5436,35,65,100,3,4,40.0,1.0,60.0,679
5437,44,56,100,3,5,40.0,1.0,60.0,679
5438,3,97,100,3,6,40.0,1.0,60.0,679
5439,59,16,75,3,7,40.0,1.0,60.0,679
5440,35,65,100,1,0,40.0,1.0,60.0,680
5441,10,90,100,1,1,40.0,1.0,60.0,680
5442,35,65,100,2,2,40.0,1.0,60.0,680
5443,35,65,100,2,3,40.0,1.0,60.0,680
5444,50,50,100,3,4,40.0,1.0,60.0,680
5445,75,25,100,3,5,40.0,1.0,60.0,680
5446,90,10,100,3,6,40.0,1.0,60.0,680
5447,75,25,100,3,7,40.0,1.0,60.0,680
5448,-1,89,88,1,0,40.0,1.0,60.0,681
5449,-58,84,26,1,1,40.0,1.0,60.0,681
5450,19,78,97,2,2,40.0,1.0,60.0,681
5451,9,83,92,2,3,40.0,1.0,60.0,681
5452,3,88,91,3,4,40.0,1.0,60.0,681
5453,-6,95,89,3,5,40.0,1.0,60.0,681
5454,-4,82,78,3,6,40.0,1.0,60.0,681
5455,-12,85,73,3,7,40.0,1.0,60.0,681
5456,27,67,94,1,0,40.0,1.0,60.0,682
5457,3,90,93,1,1,40.0,1.0,60.0,682
5458,17,7,24,2,2,40.0,1.0,60.0,682
5459,15,10,25,2,3,40.0,1.0,60.0,682
5460,23,62,85,3,4,40.0,1.0,60.0,682
5461,64,12,76,3,5,40.0,1.0,60.0,682
5462,11,89,100,3,6,40.0,1.0,60.0,682
5463,11,8,19,3,7,40.0,1.0,60.0,682
5464,9,64,73,1,0,40.0,1.0,60.0,683
5465,34,35,69,1,1,40.0,1.0,60.0,683
5466,15,50,65,2,2,40.0,1.0,60.0,683
5467,1,64,65,2,3,40.0,1.0,60.0,683
5468,-1,63,62,3,4,40.0,1.0,60.0,683
5469,38,0,38,3,5,40.0,1.0,60.0,683
5470,2,37,39,3,6,40.0,1.0,60.0,683
5471,4,35,39,3,7,40.0,1.0,60.0,683
5472,15,63,78,1,0,40.0,1.0,60.0,684
5473,0,91,91,1,1,40.0,1.0,60.0,684
5474,49,26,75,2,2,40.0,1.0,60.0,684
5475,45,36,81,2,3,40.0,1.0,60.0,684
5476,28,50,78,3,4,40.0,1.0,60.0,684
5477,33,50,83,3,5,40.0,1.0,60.0,684
5478,52,25,77,3,6,40.0,1.0,60.0,684
5479,50,28,78,3,7,40.0,1.0,60.0,684
5480,43,50,93,1,0,40.0,1.0,60.0,685
5481,29,71,100,1,1,40.0,1.0,60.0,685
5482,38,24,62,2,2,40.0,1.0,60.0,685
5483,43,42,85,2,3,40.0,1.0,60.0,685
5484,18,64,82,3,4,40.0,1.0,60.0,685
5485,48,38,86,3,5,40.0,1.0,60.0,685
5486,20,44,64,3,6,40.0,1.0,60.0,685
5487,50,39,89,3,7,40.0,1.0,60.0,685
5488,27,58,85,1,0,40.0,1.0,60.0,686
5489,55,38,93,1,1,40.0,1.0,60.0,686
5490,32,4,36,2,2,40.0,1.0,60.0,686
5491,55,25,80,2,3,40.0,1.0,60.0,686
5492,22,55,77,3,4,40.0,1.0,60.0,686
5493,-6,62,56,3,5,40.0,1.0,60.0,686
5494,23,77,100,3,6,40.0,1.0,60.0,686
5495,59,11,70,3,7,40.0,1.0,60.0,686
5496,7,68,75,1,0,40.0,1.0,60.0,687
5497,53,11,64,1,1,40.0,1.0,60.0,687
5498,1,62,63,2,2,40.0,1.0,60.0,687
5499,-1,39,38,2,3,40.0,1.0,60.0,687
5500,0,0,0,3,4,40.0,1.0,60.0,687
5501,12,0,12,3,5,40.0,1.0,60.0,687
5502,0,64,64,3,6,40.0,1.0,60.0,687
5503,23,13,36,3,7,40.0,1.0,60.0,687
5504,4,34,38,1,0,40.0,1.0,60.0,688
5505,-38,74,36,1,1,40.0,1.0,60.0,688
5506,17,19,36,2,2,40.0,1.0,60.0,688
5507,12,9,21,2,3,40.0,1.0,60.0,688
5508,-37,66,29,3,4,40.0,1.0,60.0,688
5509,2,33,35,3,5,40.0,1.0,60.0,688
5510,0,39,39,3,6,40.0,1.0,60.0,688
5511,4,31,35,3,7,40.0,1.0,60.0,688
5512,68,32,100,1,0,41.0,1.0,59.0,689
5513,23,77,100,1,1,41.0,1.0,59.0,689
5514,-27,27,0,2,2,41.0,1.0,59.0,689
5515,100,0,100,2,3,41.0,1.0,59.0,689
5516,-17,31,14,3,4,41.0,1.0,59.0,689
5517,34,66,100,3,5,41.0,1.0,59.0,689
5518,69,31,100,3,6,41.0,1.0,59.0,689
5519,100,0,100,3,7,41.0,1.0,59.0,689
5520,10,62,72,1,0,41.0,1.0,59.0,690
5521,48,50,98,1,1,41.0,1.0,59.0,690
5522,0,50,50,2,2,41.0,1.0,59.0,690
5523,15,51,66,2,3,41.0,1.0,59.0,690
5524,10,88,98,3,4,41.0,1.0,59.0,690
5525,38,37,75,3,5,41.0,1.0,59.0,690
5526,5,95,100,3,6,41.0,1.0,59.0,690
5527,23,58,81,3,7,41.0,1.0,59.0,690
5528,-30,35,5,1,0,41.0,1.0,59.0,691
5529,61,39,100,1,1,41.0,1.0,59.0,691
5530,-10,42,32,2,2,41.0,1.0,59.0,691
5531,74,26,100,2,3,41.0,1.0,59.0,691
5532,1,75,76,3,4,41.0,1.0,59.0,691
5533,-18,30,12,3,5,41.0,1.0,59.0,691
5534,78,22,100,3,6,41.0,1.0,59.0,691
5535,76,22,98,3,7,41.0,1.0,59.0,691
5536,19,68,87,1,0,41.0,1.0,59.0,692
5537,0,100,100,1,1,41.0,1.0,59.0,692
5538,51,14,65,2,2,41.0,1.0,59.0,692
5539,49,15,64,2,3,41.0,1.0,59.0,692
5540,28,63,91,3,4,41.0,1.0,59.0,692
5541,25,49,74,3,5,41.0,1.0,59.0,692
5542,7,76,83,3,6,41.0,1.0,59.0,692
5543,9,61,70,3,7,41.0,1.0,59.0,692
5544,64,30,94,1,0,41.0,1.0,59.0,693
5545,29,70,99,1,1,41.0,1.0,59.0,693
5546,-6,13,7,2,2,41.0,1.0,59.0,693
5547,46,50,96,2,3,41.0,1.0,59.0,693
5548,79,19,98,3,4,41.0,1.0,59.0,693
5549,86,13,99,3,5,41.0,1.0,59.0,693
5550,54,44,98,3,6,41.0,1.0,59.0,693
5551,71,24,95,3,7,41.0,1.0,59.0,693
5552,24,65,89,1,0,41.0,1.0,59.0,694
5553,10,77,87,1,1,41.0,1.0,59.0,694
5554,67,13,80,2,2,41.0,1.0,59.0,694
5555,-6,12,6,2,3,41.0,1.0,59.0,694
5556,18,72,90,3,4,41.0,1.0,59.0,694
5557,77,7,84,3,5,41.0,1.0,59.0,694
5558,-39,61,22,3,6,41.0,1.0,59.0,694
5559,73,10,83,3,7,41.0,1.0,59.0,694
5560,-4,24,20,1,0,41.0,1.0,59.0,695
5561,-16,16,0,1,1,41.0,1.0,59.0,695
5562,65,22,87,2,2,41.0,1.0,59.0,695
5563,65,18,83,2,3,41.0,1.0,59.0,695
5564,38,43,81,3,4,41.0,1.0,59.0,695
5565,26,24,50,3,5,41.0,1.0,59.0,695
5566,0,0,0,3,6,41.0,1.0,59.0,695
5567,-3,9,6,3,7,41.0,1.0,59.0,695
5568,7,70,77,1,0,41.0,1.0,59.0,696
5569,15,85,100,1,1,41.0,1.0,59.0,696
5570,7,50,57,2,2,41.0,1.0,59.0,696
5571,0,50,50,2,3,41.0,1.0,59.0,696
5572,-21,50,29,3,4,41.0,1.0,59.0,696
5573,0,50,50,3,5,41.0,1.0,59.0,696
5574,20,80,100,3,6,41.0,1.0,59.0,696
5575,18,0,18,3,7,41.0,1.0,59.0,696
5576,15,65,80,1,0,41.0,1.0,59.0,697
5577,60,35,95,1,1,41.0,1.0,59.0,697
5578,-1,22,21,2,2,41.0,1.0,59.0,697
5579,-25,58,33,2,3,41.0,1.0,59.0,697
5580,-3,91,88,3,4,41.0,1.0,59.0,697
5581,0,32,32,3,5,41.0,1.0,59.0,697
5582,7,84,91,3,6,41.0,1.0,59.0,697
5583,-4,29,25,3,7,41.0,1.0,59.0,697
5584,-37,46,9,1,0,41.0,1.0,59.0,698
5585,-41,82,41,1,1,41.0,1.0,59.0,698
5586,-16,51,35,2,2,41.0,1.0,59.0,698
5587,-27,51,24,2,3,41.0,1.0,59.0,698
5588,-26,56,30,3,4,41.0,1.0,59.0,698
5589,-25,25,0,3,5,41.0,1.0,59.0,698
5590,-32,100,68,3,6,41.0,1.0,59.0,698
5591,-30,74,44,3,7,41.0,1.0,59.0,698
5592,14,76,90,1,0,41.0,1.0,59.0,699
5593,4,84,88,1,1,41.0,1.0,59.0,699
5594,14,7,21,2,2,41.0,1.0,59.0,699
5595,43,38,81,2,3,41.0,1.0,59.0,699
5596,5,40,45,3,4,41.0,1.0,59.0,699
5597,15,28,43,3,5,41.0,1.0,59.0,699
5598,9,88,97,3,6,41.0,1.0,59.0,699
5599,31,27,58,3,7,41.0,1.0,59.0,699
5600,14,24,38,1,0,41.0,1.0,59.0,700
5601,-23,39,16,1,1,41.0,1.0,59.0,700
5602,40,6,46,2,2,41.0,1.0,59.0,700
5603,16,19,35,2,3,41.0,1.0,59.0,700
5604,23,70,93,3,4,41.0,1.0,59.0,700
5605,22,39,61,3,5,41.0,1.0,59.0,700
5606,-6,34,28,3,6,41.0,1.0,59.0,700
5607,45,0,45,3,7,41.0,1.0,59.0,700
5608,25,50,75,1,0,41.0,1.0,59.0,701
5609,25,25,50,1,1,41.0,1.0,59.0,701
5610,30,38,68,2,2,41.0,1.0,59.0,701
5611,-4,70,66,2,3,41.0,1.0,59.0,701
5612,-1,75,74,3,4,41.0,1.0,59.0,701
5613,51,22,73,3,5,41.0,1.0,59.0,701
5614,28,22,50,3,6,41.0,1.0,59.0,701
5615,42,25,67,3,7,41.0,1.0,59.0,701
5616,99,1,100,1,0,41.0,1.0,59.0,702
5617,0,100,100,1,1,41.0,1.0,59.0,702
5618,100,0,100,2,2,41.0,1.0,59.0,702
5619,100,0,100,2,3,41.0,1.0,59.0,702
5620,0,100,100,3,4,41.0,1.0,59.0,702
5621,100,0,100,3,5,41.0,1.0,59.0,702
5622,100,0,100,3,6,41.0,1.0,59.0,702
5623,100,0,100,3,7,41.0,1.0,59.0,702
5624,-4,45,41,1,0,42.0,1.0,58.0,703
5625,73,0,73,1,1,42.0,1.0,58.0,703
5626,8,24,32,2,2,42.0,1.0,58.0,703
5627,16,52,68,2,3,42.0,1.0,58.0,703
5628,-7,39,32,3,4,42.0,1.0,58.0,703
5629,17,25,42,3,5,42.0,1.0,58.0,703
5630,15,25,40,3,6,42.0,1.0,58.0,703
5631,7,26,33,3,7,42.0,1.0,58.0,703
5632,17,70,87,1,0,42.0,1.0,58.0,704
5633,10,81,91,1,1,42.0,1.0,58.0,704
5634,10,70,80,2,2,42.0,1.0,58.0,704
5635,-8,34,26,2,3,42.0,1.0,58.0,704
5636,8,73,81,3,4,42.0,1.0,58.0,704
5637,57,23,80,3,5,42.0,1.0,58.0,704
5638,11,73,84,3,6,42.0,1.0,58.0,704
5639,54,33,87,3,7,42.0,1.0,58.0,704
5640,13,73,86,1,0,42.0,1.0,58.0,705
5641,8,77,85,1,1,42.0,1.0,58.0,705
5642,5,27,32,2,2,42.0,1.0,58.0,705
5643,-7,63,56,2,3,42.0,1.0,58.0,705
5644,4,55,59,3,4,42.0,1.0,58.0,705
5645,12,44,56,3,5,42.0,1.0,58.0,705
5646,0,50,50,3,6,42.0,1.0,58.0,705
5647,16,30,46,3,7,42.0,1.0,58.0,705
5648,-19,65,46,1,0,42.0,1.0,58.0,706
5649,33,31,64,1,1,42.0,1.0,58.0,706
5650,-22,68,46,2,2,42.0,1.0,58.0,706
5651,2,58,60,2,3,42.0,1.0,58.0,706
5652,27,34,61,3,4,42.0,1.0,58.0,706
5653,-5,54,49,3,5,42.0,1.0,58.0,706
5654,-5,61,56,3,6,42.0,1.0,58.0,706
5655,-6,39,33,3,7,42.0,1.0,58.0,706
5656,45,31,76,1,0,42.0,1.0,58.0,707
5657,-80,100,20,1,1,42.0,1.0,58.0,707
5658,2,24,26,2,2,42.0,1.0,58.0,707
5659,58,27,85,2,3,42.0,1.0,58.0,707
5660,20,61,81,3,4,42.0,1.0,58.0,707
5661,62,20,82,3,5,42.0,1.0,58.0,707
5662,-1,76,75,3,6,42.0,1.0,58.0,707
5663,48,14,62,3,7,42.0,1.0,58.0,707
5664,0,0,0,1,0,42.0,1.0,58.0,708
5665,1,66,67,1,1,42.0,1.0,58.0,708
5666,15,42,57,2,2,42.0,1.0,58.0,708
5667,29,67,96,2,3,42.0,1.0,58.0,708
5668,5,66,71,3,4,42.0,1.0,58.0,708
5669,17,50,67,3,5,42.0,1.0,58.0,708
5670,0,0,0,3,6,42.0,1.0,58.0,708
5671,-18,59,41,3,7,42.0,1.0,58.0,708
5672,92,0,92,1,0,42.0,1.0,58.0,709
5673,78,0,78,1,1,42.0,1.0,58.0,709
5674,100,0,100,2,2,42.0,1.0,58.0,709
5675,100,0,100,2,3,42.0,1.0,58.0,709
5676,42,30,72,3,4,42.0,1.0,58.0,709
5677,100,0,100,3,5,42.0,1.0,58.0,709
5678,0,100,100,3,6,42.0,1.0,58.0,709
5679,77,0,77,3,7,42.0,1.0,58.0,709
5680,15,16,31,1,0,42.0,1.0,58.0,710
5681,-8,84,76,1,1,42.0,1.0,58.0,710
5682,-21,65,44,2,2,42.0,1.0,58.0,710
5683,-1,79,78,2,3,42.0,1.0,58.0,710
5684,15,22,37,3,4,42.0,1.0,58.0,710
5685,-5,31,26,3,5,42.0,1.0,58.0,710
5686,13,17,30,3,6,42.0,1.0,58.0,710
5687,-2,34,32,3,7,42.0,1.0,58.0,710
5688,39,54,93,1,0,42.0,1.0,58.0,711
5689,0,100,100,1,1,42.0,1.0,58.0,711
5690,87,0,87,2,2,42.0,1.0,58.0,711
5691,6,13,19,2,3,42.0,1.0,58.0,711
5692,65,28,93,3,4,42.0,1.0,58.0,711
5693,-62,93,31,3,5,42.0,1.0,58.0,711
5694,88,8,96,3,6,42.0,1.0,58.0,711
5695,79,0,79,3,7,42.0,1.0,58.0,711
5696,75,25,100,1,0,42.0,1.0,58.0,712
5697,44,56,100,1,1,42.0,1.0,58.0,712
5698,67,23,90,2,2,42.0,1.0,58.0,712
5699,29,45,74,2,3,42.0,1.0,58.0,712
5700,38,62,100,3,4,42.0,1.0,58.0,712
5701,44,47,91,3,5,42.0,1.0,58.0,712
5702,46,54,100,3,6,42.0,1.0,58.0,712
5703,81,19,100,3,7,42.0,1.0,58.0,712
5704,28,71,99,1,0,42.0,1.0,58.0,713
5705,7,93,100,1,1,42.0,1.0,58.0,713
5706,22,37,59,2,2,42.0,1.0,58.0,713
5707,11,40,51,2,3,42.0,1.0,58.0,713
5708,27,27,54,3,4,42.0,1.0,58.0,713
5709,3,50,53,3,5,42.0,1.0,58.0,713
5710,17,83,100,3,6,42.0,1.0,58.0,713
5711,12,42,54,3,7,42.0,1.0,58.0,713
5712,-15,50,35,1,0,42.0,1.0,58.0,714
5713,-8,92,84,1,1,42.0,1.0,58.0,714
5714,18,13,31,2,2,42.0,1.0,58.0,714
5715,9,64,73,2,3,42.0,1.0,58.0,714
5716,2,19,21,3,4,42.0,1.0,58.0,714
5717,-16,84,68,3,5,42.0,1.0,58.0,714
5718,-40,78,38,3,6,42.0,1.0,58.0,714
5719,7,22,29,3,7,42.0,1.0,58.0,714
5720,-27,68,41,1,0,42.0,1.0,58.0,715
5721,-11,50,39,1,1,42.0,1.0,58.0,715
5722,3,28,31,2,2,42.0,1.0,58.0,715
5723,-7,49,42,2,3,42.0,1.0,58.0,715
5724,25,49,74,3,4,42.0,1.0,58.0,715
5725,10,50,60,3,5,42.0,1.0,58.0,715
5726,14,42,56,3,6,42.0,1.0,58.0,715
5727,0,38,38,3,7,42.0,1.0,58.0,715
5728,71,27,98,1,0,42.0,1.0,58.0,716
5729,67,33,100,1,1,42.0,1.0,58.0,716
5730,72,28,100,2,2,42.0,1.0,58.0,716
5731,8,92,100,2,3,42.0,1.0,58.0,716
5732,30,70,100,3,4,42.0,1.0,58.0,716
5733,81,19,100,3,5,42.0,1.0,58.0,716
5734,10,90,100,3,6,42.0,1.0,58.0,716
5735,85,15,100,3,7,42.0,1.0,58.0,716
5736,-60,94,34,1,0,42.0,1.0,58.0,717
5737,3,94,97,1,1,42.0,1.0,58.0,717
5738,0,29,29,2,2,42.0,1.0,58.0,717
5739,-16,37,21,2,3,42.0,1.0,58.0,717
5740,39,55,94,3,4,42.0,1.0,58.0,717
5741,6,50,56,3,5,42.0,1.0,58.0,717
5742,43,20,63,3,6,42.0,1.0,58.0,717
5743,-9,69,60,3,7,42.0,1.0,58.0,717
5744,0,50,50,1,0,42.0,1.0,58.0,718
5745,10,56,66,1,1,42.0,1.0,58.0,718
5746,-1,51,50,2,2,42.0,1.0,58.0,718
5747,-43,70,27,2,3,42.0,1.0,58.0,718
5748,0,62,62,3,4,42.0,1.0,58.0,718
5749,4,55,59,3,5,42.0,1.0,58.0,718
5750,5,27,32,3,6,42.0,1.0,58.0,718
5751,9,10,19,3,7,42.0,1.0,58.0,718
5752,47,35,82,1,0,43.0,1.0,57.0,719
5753,20,66,86,1,1,43.0,1.0,57.0,719
5754,-20,61,41,2,2,43.0,1.0,57.0,719
5755,20,65,85,2,3,43.0,1.0,57.0,719
5756,58,26,84,3,4,43.0,1.0,57.0,719
5757,69,22,91,3,5,43.0,1.0,57.0,719
5758,45,37,82,3,6,43.0,1.0,57.0,719
5759,35,42,77,3,7,43.0,1.0,57.0,719
5760,37,50,87,1,0,43.0,1.0,57.0,720
5761,16,84,100,1,1,43.0,1.0,57.0,720
5762,50,18,68,2,2,43.0,1.0,57.0,720
5763,-29,50,21,2,3,43.0,1.0,57.0,720
5764,25,50,75,3,4,43.0,1.0,57.0,720
5765,43,43,86,3,5,43.0,1.0,57.0,720
5766,46,44,90,3,6,43.0,1.0,57.0,720
5767,48,32,80,3,7,43.0,1.0,57.0,720
5768,0,0,0,1,0,43.0,1.0,57.0,721
5769,0,0,0,1,1,43.0,1.0,57.0,721
5770,21,78,99,2,2,43.0,1.0,57.0,721
5771,0,0,0,2,3,43.0,1.0,57.0,721
5772,23,77,100,3,4,43.0,1.0,57.0,721
5773,90,0,90,3,5,43.0,1.0,57.0,721
5774,0,0,0,3,6,43.0,1.0,57.0,721
5775,0,0,0,3,7,43.0,1.0,57.0,721
5776,13,17,30,1,0,43.0,1.0,57.0,722
5777,6,56,62,1,1,43.0,1.0,57.0,722
5778,50,33,83,2,2,43.0,1.0,57.0,722
5779,0,100,100,2,3,43.0,1.0,57.0,722
5780,23,70,93,3,4,43.0,1.0,57.0,722
5781,16,51,67,3,5,43.0,1.0,57.0,722
5782,9,91,100,3,6,43.0,1.0,57.0,722
5783,-88,100,12,3,7,43.0,1.0,57.0,722
5784,42,40,82,1,0,43.0,1.0,57.0,723
5785,9,76,85,1,1,43.0,1.0,57.0,723
5786,24,43,67,2,2,43.0,1.0,57.0,723
5787,30,35,65,2,3,43.0,1.0,57.0,723
5788,61,39,100,3,4,43.0,1.0,57.0,723
5789,40,40,80,3,5,43.0,1.0,57.0,723
5790,47,44,91,3,6,43.0,1.0,57.0,723
5791,-18,40,22,3,7,43.0,1.0,57.0,723
5792,64,36,100,1,0,43.0,1.0,57.0,724
5793,63,37,100,1,1,43.0,1.0,57.0,724
5794,37,63,100,2,2,43.0,1.0,57.0,724
5795,50,50,100,2,3,43.0,1.0,57.0,724
5796,33,67,100,3,4,43.0,1.0,57.0,724
5797,62,38,100,3,5,43.0,1.0,57.0,724
5798,30,70,100,3,6,43.0,1.0,57.0,724
5799,-8,8,0,3,7,43.0,1.0,57.0,724
5800,1,12,13,1,0,43.0,1.0,57.0,725
5801,72,17,89,1,1,43.0,1.0,57.0,725
5802,47,24,71,2,2,43.0,1.0,57.0,725
5803,53,23,76,2,3,43.0,1.0,57.0,725
5804,43,57,100,3,4,43.0,1.0,57.0,725
5805,0,100,100,3,5,43.0,1.0,57.0,725
5806,55,19,74,3,6,43.0,1.0,57.0,725
5807,-12,12,0,3,7,43.0,1.0,57.0,725
5808,-7,36,29,1,0,43.0,1.0,57.0,726
5809,4,28,32,1,1,43.0,1.0,57.0,726
5810,2,27,29,2,2,43.0,1.0,57.0,726
5811,-47,78,31,2,3,43.0,1.0,57.0,726
5812,-9,88,79,3,4,43.0,1.0,57.0,726
5813,9,25,34,3,5,43.0,1.0,57.0,726
5814,-13,50,37,3,6,43.0,1.0,57.0,726
5815,10,24,34,3,7,43.0,1.0,57.0,726
5816,31,45,76,1,0,43.0,1.0,57.0,727
5817,15,60,75,1,1,43.0,1.0,57.0,727
5818,30,40,70,2,2,43.0,1.0,57.0,727
5819,55,10,65,2,3,43.0,1.0,57.0,727
5820,11,65,76,3,4,43.0,1.0,57.0,727
5821,45,15,60,3,5,43.0,1.0,57.0,727
5822,10,40,50,3,6,43.0,1.0,57.0,727
5823,20,25,45,3,7,43.0,1.0,57.0,727
5824,23,50,73,1,0,43.0,1.0,57.0,728
5825,86,4,90,1,1,43.0,1.0,57.0,728
5826,7,78,85,2,2,43.0,1.0,57.0,728
5827,37,52,89,2,3,43.0,1.0,57.0,728
5828,4,92,96,3,4,43.0,1.0,57.0,728
5829,50,50,100,3,5,43.0,1.0,57.0,728
5830,77,7,84,3,6,43.0,1.0,57.0,728
5831,85,4,89,3,7,43.0,1.0,57.0,728
5832,0,50,50,1,0,43.0,1.0,57.0,729
5833,0,50,50,1,1,43.0,1.0,57.0,729
5834,0,50,50,2,2,43.0,1.0,57.0,729
5835,0,50,50,2,3,43.0,1.0,57.0,729
5836,2,74,76,3,4,43.0,1.0,57.0,729
5837,-11,52,41,3,5,43.0,1.0,57.0,729
5838,0,50,50,3,6,43.0,1.0,57.0,729
5839,8,42,50,3,7,43.0,1.0,57.0,729
5840,-4,35,31,1,0,43.0,1.0,57.0,730
5841,-5,73,68,1,1,43.0,1.0,57.0,730
5842,25,41,66,2,2,43.0,1.0,57.0,730
5843,-17,57,40,2,3,43.0,1.0,57.0,730
5844,-6,72,66,3,4,43.0,1.0,57.0,730
5845,-2,58,56,3,5,43.0,1.0,57.0,730
5846,-58,87,29,3,6,43.0,1.0,57.0,730
5847,4,33,37,3,7,43.0,1.0,57.0,730
5848,0,50,50,1,0,43.0,1.0,57.0,731
5849,9,50,59,1,1,43.0,1.0,57.0,731
5850,-25,55,30,2,2,43.0,1.0,57.0,731
5851,-29,50,21,2,3,43.0,1.0,57.0,731
5852,0,50,50,3,4,43.0,1.0,57.0,731
5853,2,55,57,3,5,43.0,1.0,57.0,731
5854,-20,50,30,3,6,43.0,1.0,57.0,731
5855,6,14,20,3,7,43.0,1.0,57.0,731
5856,0,0,0,1,0,44.0,1.0,56.0,732
5857,-11,11,0,1,1,44.0,1.0,56.0,732
5858,7,3,10,2,2,44.0,1.0,56.0,732
5859,2,85,87,2,3,44.0,1.0,56.0,732
5860,6,75,81,3,4,44.0,1.0,56.0,732
5861,10,4,14,3,5,44.0,1.0,56.0,732
5862,-4,4,0,3,6,44.0,1.0,56.0,732
5863,0,0,0,3,7,44.0,1.0,56.0,732
5864,26,0,26,1,0,44.0,1.0,56.0,733
5865,0,100,100,1,1,44.0,1.0,56.0,733
5866,30,41,71,2,2,44.0,1.0,56.0,733
5867,11,70,81,2,3,44.0,1.0,56.0,733
5868,-8,71,63,3,4,44.0,1.0,56.0,733
5869,98,2,100,3,5,44.0,1.0,56.0,733
5870,36,22,58,3,6,44.0,1.0,56.0,733
5871,23,77,100,3,7,44.0,1.0,56.0,733
5872,0,0,0,1,0,44.0,1.0,56.0,734
5873,15,25,40,1,1,44.0,1.0,56.0,734
5874,0,0,0,2,2,44.0,1.0,56.0,734
5875,100,0,100,2,3,44.0,1.0,56.0,734
5876,71,29,100,3,4,44.0,1.0,56.0,734
5877,27,0,27,3,5,44.0,1.0,56.0,734
5878,0,100,100,3,6,44.0,1.0,56.0,734
5879,0,0,0,3,7,44.0,1.0,56.0,734
5880,11,67,78,1,0,44.0,1.0,56.0,735
5881,15,59,74,1,1,44.0,1.0,56.0,735
5882,59,5,64,2,2,44.0,1.0,56.0,735
5883,32,31,63,2,3,44.0,1.0,56.0,735
5884,20,56,76,3,4,44.0,1.0,56.0,735
5885,47,32,79,3,5,44.0,1.0,56.0,735
5886,75,0,75,3,6,44.0,1.0,56.0,735
5887,68,0,68,3,7,44.0,1.0,56.0,735
5888,-2,12,10,1,0,44.0,1.0,56.0,736
5889,-7,38,31,1,1,44.0,1.0,56.0,736
5890,-1,25,24,2,2,44.0,1.0,56.0,736
5891,31,10,41,2,3,44.0,1.0,56.0,736
5892,3,38,41,3,4,44.0,1.0,56.0,736
5893,-1,34,33,3,5,44.0,1.0,56.0,736
5894,2,62,64,3,6,44.0,1.0,56.0,736
5895,6,14,20,3,7,44.0,1.0,56.0,736
5896,36,64,100,1,0,44.0,1.0,56.0,737
5897,0,100,100,1,1,44.0,1.0,56.0,737
5898,43,47,90,2,2,44.0,1.0,56.0,737
5899,95,5,100,2,3,44.0,1.0,56.0,737
5900,8,92,100,3,4,44.0,1.0,56.0,737
5901,19,81,100,3,5,44.0,1.0,56.0,737
5902,93,7,100,3,6,44.0,1.0,56.0,737
5903,95,5,100,3,7,44.0,1.0,56.0,737
5904,31,69,100,1,0,44.0,1.0,56.0,738
5905,0,100,100,1,1,44.0,1.0,56.0,738
5906,22,0,22,2,2,44.0,1.0,56.0,738
5907,12,88,100,2,3,44.0,1.0,56.0,738
5908,22,78,100,3,4,44.0,1.0,56.0,738
5909,100,0,100,3,5,44.0,1.0,56.0,738
5910,37,63,100,3,6,44.0,1.0,56.0,738
5911,50,50,100,3,7,44.0,1.0,56.0,738
5912,6,9,15,1,0,44.0,1.0,56.0,739
5913,-24,36,12,1,1,44.0,1.0,56.0,739
5914,16,62,78,2,2,44.0,1.0,56.0,739
5915,-58,77,19,2,3,44.0,1.0,56.0,739
5916,-37,65,28,3,4,44.0,1.0,56.0,739
5917,-11,13,2,3,5,44.0,1.0,56.0,739
5918,1,8,9,3,6,44.0,1.0,56.0,739
5919,-1,5,4,3,7,44.0,1.0,56.0,739
5920,8,70,78,1,0,44.0,1.0,56.0,740
5921,9,72,81,1,1,44.0,1.0,56.0,740
5922,14,44,58,2,2,44.0,1.0,56.0,740
5923,-14,71,57,2,3,44.0,1.0,56.0,740
5924,15,64,79,3,4,44.0,1.0,56.0,740
5925,26,53,79,3,5,44.0,1.0,56.0,740
5926,21,43,64,3,6,44.0,1.0,56.0,740
5927,40,26,66,3,7,44.0,1.0,56.0,740
5928,51,45,96,1,0,44.0,1.0,56.0,741
5929,-8,8,0,1,1,44.0,1.0,56.0,741
5930,6,53,59,2,2,44.0,1.0,56.0,741
5931,40,39,79,2,3,44.0,1.0,56.0,741
5932,3,61,64,3,4,44.0,1.0,56.0,741
5933,40,39,79,3,5,44.0,1.0,56.0,741
5934,11,46,57,3,6,44.0,1.0,56.0,741
5935,-4,45,41,3,7,44.0,1.0,56.0,741
5936,64,10,74,1,0,44.0,1.0,56.0,742
5937,-35,68,33,1,1,44.0,1.0,56.0,742
5938,64,16,80,2,2,44.0,1.0,56.0,742
5939,45,30,75,2,3,44.0,1.0,56.0,742
5940,3,75,78,3,4,44.0,1.0,56.0,742
5941,58,22,80,3,5,44.0,1.0,56.0,742
5942,52,36,88,3,6,44.0,1.0,56.0,742
5943,70,10,80,3,7,44.0,1.0,56.0,742
5944,3,61,64,1,0,44.0,1.0,56.0,743
5945,41,24,65,1,1,44.0,1.0,56.0,743
5946,21,50,71,2,2,44.0,1.0,56.0,743
5947,32,43,75,2,3,44.0,1.0,56.0,743
5948,23,50,73,3,4,44.0,1.0,56.0,743
5949,-17,57,40,3,5,44.0,1.0,56.0,743
5950,7,82,89,3,6,44.0,1.0,56.0,743
5951,-16,75,59,3,7,44.0,1.0,56.0,743
5952,24,64,88,1,0,44.0,1.0,56.0,744
5953,35,65,100,1,1,44.0,1.0,56.0,744
5954,44,41,85,2,2,44.0,1.0,56.0,744
5955,70,16,86,2,3,44.0,1.0,56.0,744
5956,48,30,78,3,4,44.0,1.0,56.0,744
5957,53,33,86,3,5,44.0,1.0,56.0,744
5958,79,21,100,3,6,44.0,1.0,56.0,744
5959,61,25,86,3,7,44.0,1.0,56.0,744
5960,7,66,73,1,0,45.0,1.0,55.0,745
5961,0,0,0,1,1,45.0,1.0,55.0,745
5962,0,0,0,2,2,45.0,1.0,55.0,745
5963,1,0,1,2,3,45.0,1.0,55.0,745
5964,-2,25,23,3,4,45.0,1.0,55.0,745
5965,0,0,0,3,5,45.0,1.0,55.0,745
5966,0,100,100,3,6,45.0,1.0,55.0,745
5967,0,0,0,3,7,45.0,1.0,55.0,745
5968,16,47,63,1,0,45.0,1.0,55.0,746
5969,11,55,66,1,1,45.0,1.0,55.0,746
5970,23,40,63,2,2,45.0,1.0,55.0,746
5971,18,40,58,2,3,45.0,1.0,55.0,746
5972,22,45,67,3,4,45.0,1.0,55.0,746
5973,18,43,61,3,5,45.0,1.0,55.0,746
5974,38,37,75,3,6,45.0,1.0,55.0,746
5975,8,32,40,3,7,45.0,1.0,55.0,746
5976,-4,45,41,1,0,45.0,1.0,55.0,747
5977,7,32,39,1,1,45.0,1.0,55.0,747
5978,-1,42,41,2,2,45.0,1.0,55.0,747
5979,17,0,17,2,3,45.0,1.0,55.0,747
5980,11,44,55,3,4,45.0,1.0,55.0,747
5981,8,47,55,3,5,45.0,1.0,55.0,747
5982,-9,97,88,3,6,45.0,1.0,55.0,747
5983,0,0,0,3,7,45.0,1.0,55.0,747
5984,10,90,100,1,0,45.0,1.0,55.0,748
5985,34,66,100,1,1,45.0,1.0,55.0,748
5986,38,62,100,2,2,45.0,1.0,55.0,748
5987,70,30,100,2,3,45.0,1.0,55.0,748
5988,19,81,100,3,4,45.0,1.0,55.0,748
5989,7,93,100,3,5,45.0,1.0,55.0,748
5990,37,63,100,3,6,45.0,1.0,55.0,748
5991,83,17,100,3,7,45.0,1.0,55.0,748
5992,22,41,63,1,0,45.0,1.0,55.0,749
5993,-3,66,63,1,1,45.0,1.0,55.0,749
5994,-8,8,0,2,2,45.0,1.0,55.0,749
5995,0,0,0,2,3,45.0,1.0,55.0,749
5996,1,35,36,3,4,45.0,1.0,55.0,749
5997,0,0,0,3,5,45.0,1.0,55.0,749
5998,23,3,26,3,6,45.0,1.0,55.0,749
5999,10,8,18,3,7,45.0,1.0,55.0,749
6000,89,11,100,1,0,45.0,1.0,55.0,750
6001,60,40,100,1,1,45.0,1.0,55.0,750
6002,30,58,88,2,2,45.0,1.0,55.0,750
6003,13,87,100,2,3,45.0,1.0,55.0,750
6004,48,52,100,3,4,45.0,1.0,55.0,750
6005,98,2,100,3,5,45.0,1.0,55.0,750
6006,21,79,100,3,6,45.0,1.0,55.0,750
6007,3,1,4,3,7,45.0,1.0,55.0,750
6008,3,54,57,1,0,45.0,1.0,55.0,751
6009,4,89,93,1,1,45.0,1.0,55.0,751
6010,2,43,45,2,2,45.0,1.0,55.0,751
6011,8,38,46,2,3,45.0,1.0,55.0,751
6012,13,44,57,3,4,45.0,1.0,55.0,751
6013,10,45,55,3,5,45.0,1.0,55.0,751
6014,1,44,45,3,6,45.0,1.0,55.0,751
6015,0,56,56,3,7,45.0,1.0,55.0,751
6016,100,0,100,1,0,45.0,1.0,55.0,752
6017,100,0,100,1,1,45.0,1.0,55.0,752
6018,100,0,100,2,2,45.0,1.0,55.0,752
6019,100,0,100,2,3,45.0,1.0,55.0,752
6020,40,60,100,3,4,45.0,1.0,55.0,752
6021,75,25,100,3,5,45.0,1.0,55.0,752
6022,5,95,100,3,6,45.0,1.0,55.0,752
6023,100,0,100,3,7,45.0,1.0,55.0,752
6024,17,50,67,1,0,45.0,1.0,55.0,753
6025,23,16,39,1,1,45.0,1.0,55.0,753
6026,65,13,78,2,2,45.0,1.0,55.0,753
6027,-53,78,25,2,3,45.0,1.0,55.0,753
6028,14,50,64,3,4,45.0,1.0,55.0,753
6029,-12,74,62,3,5,45.0,1.0,55.0,753
6030,-3,69,66,3,6,45.0,1.0,55.0,753
6031,5,24,29,3,7,45.0,1.0,55.0,753
6032,54,46,100,1,0,45.0,1.0,55.0,754
6033,36,64,100,1,1,45.0,1.0,55.0,754
6034,74,26,100,2,2,45.0,1.0,55.0,754
6035,75,25,100,2,3,45.0,1.0,55.0,754
6036,52,48,100,3,4,45.0,1.0,55.0,754
6037,42,58,100,3,5,45.0,1.0,55.0,754
6038,19,81,100,3,6,45.0,1.0,55.0,754
6039,100,0,100,3,7,45.0,1.0,55.0,754
6040,38,62,100,1,0,45.0,1.0,55.0,755
6041,0,100,100,1,1,45.0,1.0,55.0,755
6042,0,0,0,2,2,45.0,1.0,55.0,755
6043,100,0,100,2,3,45.0,1.0,55.0,755
6044,54,46,100,3,4,45.0,1.0,55.0,755
6045,100,0,100,3,5,45.0,1.0,55.0,755
6046,33,67,100,3,6,45.0,1.0,55.0,755
6047,97,3,100,3,7,45.0,1.0,55.0,755
6048,-20,44,24,1,0,45.0,1.0,55.0,756
6049,69,26,95,1,1,45.0,1.0,55.0,756
6050,-51,70,19,2,2,45.0,1.0,55.0,756
6051,62,25,87,2,3,45.0,1.0,55.0,756
6052,-12,32,20,3,4,45.0,1.0,55.0,756
6053,-12,35,23,3,5,45.0,1.0,55.0,756
6054,7,93,100,3,6,45.0,1.0,55.0,756
6055,-52,63,11,3,7,45.0,1.0,55.0,756
6056,0,90,90,1,0,45.0,1.0,55.0,757
6057,0,100,100,1,1,45.0,1.0,55.0,757
6058,75,0,75,2,2,45.0,1.0,55.0,757
6059,0,25,25,2,3,45.0,1.0,55.0,757
6060,5,85,90,3,4,45.0,1.0,55.0,757
6061,75,10,85,3,5,45.0,1.0,55.0,757
6062,5,90,95,3,6,45.0,1.0,55.0,757
6063,5,10,15,3,7,45.0,1.0,55.0,757
6064,10,60,70,1,0,45.0,1.0,55.0,758
6065,20,50,70,1,1,45.0,1.0,55.0,758
6066,20,35,55,2,2,45.0,1.0,55.0,758
6067,5,55,60,2,3,45.0,1.0,55.0,758
6068,12,50,62,3,4,45.0,1.0,55.0,758
6069,0,50,50,3,5,45.0,1.0,55.0,758
6070,21,45,66,3,6,45.0,1.0,55.0,758
6071,17,40,57,3,7,45.0,1.0,55.0,758
6072,-16,16,0,1,0,45.0,1.0,55.0,759
6073,29,71,100,1,1,45.0,1.0,55.0,759
6074,-53,53,0,2,2,45.0,1.0,55.0,759
6075,34,66,100,2,3,45.0,1.0,55.0,759
6076,48,52,100,3,4,45.0,1.0,55.0,759
6077,55,45,100,3,5,45.0,1.0,55.0,759
6078,-69,69,0,3,6,45.0,1.0,55.0,759
6079,0,0,0,3,7,45.0,1.0,55.0,759
6080,46,41,87,1,0,45.0,1.0,55.0,760
6081,24,62,86,1,1,45.0,1.0,55.0,760
6082,-28,42,14,2,2,45.0,1.0,55.0,760
6083,49,34,83,2,3,45.0,1.0,55.0,760
6084,39,57,96,3,4,45.0,1.0,55.0,760
6085,50,31,81,3,5,45.0,1.0,55.0,760
6086,61,39,100,3,6,45.0,1.0,55.0,760
6087,73,5,78,3,7,45.0,1.0,55.0,760
6088,36,37,73,1,0,45.0,1.0,55.0,761
6089,11,71,82,1,1,45.0,1.0,55.0,761
6090,20,47,67,2,2,45.0,1.0,55.0,761
6091,29,36,65,2,3,45.0,1.0,55.0,761
6092,16,65,81,3,4,45.0,1.0,55.0,761
6093,58,34,92,3,5,45.0,1.0,55.0,761
6094,11,89,100,3,6,45.0,1.0,55.0,761
6095,21,61,82,3,7,45.0,1.0,55.0,761
6096,-22,84,62,1,0,45.0,1.0,55.0,762
6097,45,38,83,1,1,45.0,1.0,55.0,762
6098,26,37,63,2,2,45.0,1.0,55.0,762
6099,8,56,64,2,3,45.0,1.0,55.0,762
6100,30,39,69,3,4,45.0,1.0,55.0,762
6101,14,38,52,3,5,45.0,1.0,55.0,762
6102,-2,60,58,3,6,45.0,1.0,55.0,762
6103,-5,34,29,3,7,45.0,1.0,55.0,762
6104,9,29,38,1,0,45.0,1.0,55.0,763
6105,6,78,84,1,1,45.0,1.0,55.0,763
6106,-12,51,39,2,2,45.0,1.0,55.0,763
6107,12,57,69,2,3,45.0,1.0,55.0,763
6108,1,64,65,3,4,45.0,1.0,55.0,763
6109,21,45,66,3,5,45.0,1.0,55.0,763
6110,7,51,58,3,6,45.0,1.0,55.0,763
6111,37,30,67,3,7,45.0,1.0,55.0,763
6112,16,52,68,1,0,45.0,1.0,55.0,764
6113,4,96,100,1,1,45.0,1.0,55.0,764
6114,90,10,100,2,2,45.0,1.0,55.0,764
6115,100,0,100,2,3,45.0,1.0,55.0,764
6116,31,69,100,3,4,45.0,1.0,55.0,764
6117,91,9,100,3,5,45.0,1.0,55.0,764
6118,62,38,100,3,6,45.0,1.0,55.0,764
6119,77,22,99,3,7,45.0,1.0,55.0,764
6120,-2,61,59,1,0,45.0,1.0,55.0,765
6121,0,50,50,1,1,45.0,1.0,55.0,765
6122,3,46,49,2,2,45.0,1.0,55.0,765
6123,8,22,30,2,3,45.0,1.0,55.0,765
6124,10,66,76,3,4,45.0,1.0,55.0,765
6125,29,29,58,3,5,45.0,1.0,55.0,765
6126,39,29,68,3,6,45.0,1.0,55.0,765
6127,16,22,38,3,7,45.0,1.0,55.0,765
6128,-11,38,27,1,0,45.0,1.0,55.0,766
6129,7,77,84,1,1,45.0,1.0,55.0,766
6130,27,62,89,2,2,45.0,1.0,55.0,766
6131,47,34,81,2,3,45.0,1.0,55.0,766
6132,-17,28,11,3,4,45.0,1.0,55.0,766
6133,-9,38,29,3,5,45.0,1.0,55.0,766
6134,7,88,95,3,6,45.0,1.0,55.0,766
6135,58,20,78,3,7,45.0,1.0,55.0,766
6136,0,50,50,1,0,45.0,1.0,55.0,767
6137,17,55,72,1,1,45.0,1.0,55.0,767
6138,0,50,50,2,2,45.0,1.0,55.0,767
6139,-2,28,26,2,3,45.0,1.0,55.0,767
6140,29,50,79,3,4,45.0,1.0,55.0,767
6141,0,50,50,3,5,45.0,1.0,55.0,767
6142,10,78,88,3,6,45.0,1.0,55.0,767
6143,27,23,50,3,7,45.0,1.0,55.0,767
6144,45,50,95,1,0,45.0,1.0,55.0,768
6145,4,91,95,1,1,45.0,1.0,55.0,768
6146,68,22,90,2,2,45.0,1.0,55.0,768
6147,65,20,85,2,3,45.0,1.0,55.0,768
6148,40,50,90,3,4,45.0,1.0,55.0,768
6149,40,50,90,3,5,45.0,1.0,55.0,768
6150,5,90,95,3,6,45.0,1.0,55.0,768
6151,65,30,95,3,7,45.0,1.0,55.0,768
6152,6,56,62,1,0,45.0,1.0,55.0,769
6153,-2,29,27,1,1,45.0,1.0,55.0,769
6154,-1,54,53,2,2,45.0,1.0,55.0,769
6155,9,18,27,2,3,45.0,1.0,55.0,769
6156,7,74,81,3,4,45.0,1.0,55.0,769
6157,14,54,68,3,5,45.0,1.0,55.0,769
6158,-6,87,81,3,6,45.0,1.0,55.0,769
6159,-1,39,38,3,7,45.0,1.0,55.0,769
6160,26,50,76,1,0,45.0,1.0,55.0,770
6161,10,75,85,1,1,45.0,1.0,55.0,770
6162,50,0,50,2,2,45.0,1.0,55.0,770
6163,25,43,68,2,3,45.0,1.0,55.0,770
6164,6,73,79,3,4,45.0,1.0,55.0,770
6165,12,50,62,3,5,45.0,1.0,55.0,770
6166,19,20,39,3,6,45.0,1.0,55.0,770
6167,52,30,82,3,7,45.0,1.0,55.0,770
6168,8,48,56,1,0,46.0,1.0,54.0,771
6169,-2,21,19,1,1,46.0,1.0,54.0,771
6170,20,39,59,2,2,46.0,1.0,54.0,771
6171,4,21,25,2,3,46.0,1.0,54.0,771
6172,6,54,60,3,4,46.0,1.0,54.0,771
6173,-5,25,20,3,5,46.0,1.0,54.0,771
6174,-7,31,24,3,6,46.0,1.0,54.0,771
6175,-12,27,15,3,7,46.0,1.0,54.0,771
6176,1,8,9,1,0,46.0,1.0,54.0,772
6177,-3,93,90,1,1,46.0,1.0,54.0,772
6178,10,69,79,2,2,46.0,1.0,54.0,772
6179,-1,17,16,2,3,46.0,1.0,54.0,772
6180,9,76,85,3,4,46.0,1.0,54.0,772
6181,56,29,85,3,5,46.0,1.0,54.0,772
6182,31,58,89,3,6,46.0,1.0,54.0,772
6183,-2,9,7,3,7,46.0,1.0,54.0,772
6184,0,100,100,1,0,46.0,1.0,54.0,773
6185,100,0,100,1,1,46.0,1.0,54.0,773
6186,0,0,0,2,2,46.0,1.0,54.0,773
6187,-14,14,0,2,3,46.0,1.0,54.0,773
6188,61,39,100,3,4,46.0,1.0,54.0,773
6189,100,0,100,3,5,46.0,1.0,54.0,773
6190,4,96,100,3,6,46.0,1.0,54.0,773
6191,-5,5,0,3,7,46.0,1.0,54.0,773
6192,41,59,100,1,0,46.0,1.0,54.0,774
6193,20,80,100,1,1,46.0,1.0,54.0,774
6194,-34,34,0,2,2,46.0,1.0,54.0,774
6195,53,47,100,2,3,46.0,1.0,54.0,774
6196,34,66,100,3,4,46.0,1.0,54.0,774
6197,52,48,100,3,5,46.0,1.0,54.0,774
6198,29,71,100,3,6,46.0,1.0,54.0,774
6199,70,30,100,3,7,46.0,1.0,54.0,774
6200,-5,76,71,1,0,46.0,1.0,54.0,775
6201,100,0,100,1,1,46.0,1.0,54.0,775
6202,40,58,98,2,2,46.0,1.0,54.0,775
6203,-33,37,4,2,3,46.0,1.0,54.0,775
6204,0,63,63,3,4,46.0,1.0,54.0,775
6205,98,0,98,3,5,46.0,1.0,54.0,775
6206,2,96,98,3,6,46.0,1.0,54.0,775
6207,59,3,62,3,7,46.0,1.0,54.0,775
6208,-21,70,49,1,0,46.0,1.0,54.0,776
6209,-13,96,83,1,1,46.0,1.0,54.0,776
6210,6,24,30,2,2,46.0,1.0,54.0,776
6211,10,41,51,2,3,46.0,1.0,54.0,776
6212,-21,72,51,3,4,46.0,1.0,54.0,776
6213,0,60,60,3,5,46.0,1.0,54.0,776
6214,0,31,31,3,6,46.0,1.0,54.0,776
6215,-1,1,0,3,7,46.0,1.0,54.0,776
6216,72,12,84,1,0,46.0,1.0,54.0,777
6217,40,23,63,1,1,46.0,1.0,54.0,777
6218,43,25,68,2,2,46.0,1.0,54.0,777
6219,23,70,93,2,3,46.0,1.0,54.0,777
6220,42,0,42,3,4,46.0,1.0,54.0,777
6221,45,17,62,3,5,46.0,1.0,54.0,777
6222,-14,87,73,3,6,46.0,1.0,54.0,777
6223,66,16,82,3,7,46.0,1.0,54.0,777
6224,70,30,100,1,0,46.0,1.0,54.0,778
6225,99,1,100,1,1,46.0,1.0,54.0,778
6226,75,25,100,2,2,46.0,1.0,54.0,778
6227,0,100,100,2,3,46.0,1.0,54.0,778
6228,78,21,99,3,4,46.0,1.0,54.0,778
6229,4,95,99,3,5,46.0,1.0,54.0,778
6230,21,79,100,3,6,46.0,1.0,54.0,778
6231,-1,2,1,3,7,46.0,1.0,54.0,778
6232,38,61,99,1,0,46.0,1.0,54.0,779
6233,63,20,83,1,1,46.0,1.0,54.0,779
6234,11,89,100,2,2,46.0,1.0,54.0,779
6235,15,85,100,2,3,46.0,1.0,54.0,779
6236,38,62,100,3,4,46.0,1.0,54.0,779
6237,44,56,100,3,5,46.0,1.0,54.0,779
6238,37,63,100,3,6,46.0,1.0,54.0,779
6239,52,40,92,3,7,46.0,1.0,54.0,779
6240,26,61,87,1,0,46.0,1.0,54.0,780
6241,78,22,100,1,1,46.0,1.0,54.0,780
6242,58,40,98,2,2,46.0,1.0,54.0,780
6243,-34,42,8,2,3,46.0,1.0,54.0,780
6244,44,54,98,3,4,46.0,1.0,54.0,780
6245,49,50,99,3,5,46.0,1.0,54.0,780
6246,55,45,100,3,6,46.0,1.0,54.0,780
6247,70,30,100,3,7,46.0,1.0,54.0,780
6248,59,39,98,1,0,46.0,1.0,54.0,781
6249,42,46,88,1,1,46.0,1.0,54.0,781
6250,23,38,61,2,2,46.0,1.0,54.0,781
6251,43,33,76,2,3,46.0,1.0,54.0,781
6252,51,18,69,3,4,46.0,1.0,54.0,781
6253,64,33,97,3,5,46.0,1.0,54.0,781
6254,-17,42,25,3,6,46.0,1.0,54.0,781
6255,53,40,93,3,7,46.0,1.0,54.0,781
6256,-1,17,16,1,0,46.0,1.0,54.0,782
6257,-13,78,65,1,1,46.0,1.0,54.0,782
6258,10,22,32,2,2,46.0,1.0,54.0,782
6259,48,20,68,2,3,46.0,1.0,54.0,782
6260,0,34,34,3,4,46.0,1.0,54.0,782
6261,13,37,50,3,5,46.0,1.0,54.0,782
6262,0,0,0,3,6,46.0,1.0,54.0,782
6263,0,0,0,3,7,46.0,1.0,54.0,782
6264,29,61,90,1,0,47.0,1.0,53.0,783
6265,60,33,93,1,1,47.0,1.0,53.0,783
6266,53,39,92,2,2,47.0,1.0,53.0,783
6267,63,32,95,2,3,47.0,1.0,53.0,783
6268,28,72,100,3,4,47.0,1.0,53.0,783
6269,43,50,93,3,5,47.0,1.0,53.0,783
6270,69,27,96,3,6,47.0,1.0,53.0,783
6271,68,31,99,3,7,47.0,1.0,53.0,783
6272,2,71,73,1,0,47.0,1.0,53.0,784
6273,0,100,100,1,1,47.0,1.0,53.0,784
6274,26,29,55,2,2,47.0,1.0,53.0,784
6275,3,15,18,2,3,47.0,1.0,53.0,784
6276,-2,19,17,3,4,47.0,1.0,53.0,784
6277,9,38,47,3,5,47.0,1.0,53.0,784
6278,17,18,35,3,6,47.0,1.0,53.0,784
6279,18,26,44,3,7,47.0,1.0,53.0,784
6280,2,65,67,1,0,47.0,1.0,53.0,785
6281,2,70,72,1,1,47.0,1.0,53.0,785
6282,-14,50,36,2,2,47.0,1.0,53.0,785
6283,19,36,55,2,3,47.0,1.0,53.0,785
6284,-2,78,76,3,4,47.0,1.0,53.0,785
6285,0,50,50,3,5,47.0,1.0,53.0,785
6286,-2,95,93,3,6,47.0,1.0,53.0,785
6287,-1,14,13,3,7,47.0,1.0,53.0,785
6288,77,8,85,1,0,47.0,1.0,53.0,786
6289,5,73,78,1,1,47.0,1.0,53.0,786
6290,11,73,84,2,2,47.0,1.0,53.0,786
6291,1,77,78,2,3,47.0,1.0,53.0,786
6292,59,40,99,3,4,47.0,1.0,53.0,786
6293,0,50,50,3,5,47.0,1.0,53.0,786
6294,42,50,92,3,6,47.0,1.0,53.0,786
6295,48,32,80,3,7,47.0,1.0,53.0,786
6296,-18,18,0,1,0,47.0,1.0,53.0,787
6297,-20,20,0,1,1,47.0,1.0,53.0,787
6298,-21,21,0,2,2,47.0,1.0,53.0,787
6299,-10,44,34,2,3,47.0,1.0,53.0,787
6300,3,24,27,3,4,47.0,1.0,53.0,787
6301,0,0,0,3,5,47.0,1.0,53.0,787
6302,-17,17,0,3,6,47.0,1.0,53.0,787
6303,-8,8,0,3,7,47.0,1.0,53.0,787
6304,57,43,100,1,0,47.0,1.0,53.0,788
6305,-3,3,0,1,1,47.0,1.0,53.0,788
6306,68,32,100,2,2,47.0,1.0,53.0,788
6307,63,37,100,2,3,47.0,1.0,53.0,788
6308,49,51,100,3,4,47.0,1.0,53.0,788
6309,82,18,100,3,5,47.0,1.0,53.0,788
6310,71,29,100,3,6,47.0,1.0,53.0,788
6311,76,24,100,3,7,47.0,1.0,53.0,788
6312,100,0,100,1,0,47.0,1.0,53.0,789
6313,32,68,100,1,1,47.0,1.0,53.0,789
6314,64,36,100,2,2,47.0,1.0,53.0,789
6315,0,0,0,2,3,47.0,1.0,53.0,789
6316,0,100,100,3,4,47.0,1.0,53.0,789
6317,100,0,100,3,5,47.0,1.0,53.0,789
6318,82,18,100,3,6,47.0,1.0,53.0,789
6319,100,0,100,3,7,47.0,1.0,53.0,789
6320,-19,50,31,1,0,47.0,1.0,53.0,790
6321,11,64,75,1,1,47.0,1.0,53.0,790
6322,-3,73,70,2,2,47.0,1.0,53.0,790
6323,19,21,40,2,3,47.0,1.0,53.0,790
6324,-30,50,20,3,4,47.0,1.0,53.0,790
6325,-1,70,69,3,5,47.0,1.0,53.0,790
6326,7,68,75,3,6,47.0,1.0,53.0,790
6327,-14,34,20,3,7,47.0,1.0,53.0,790
6328,10,0,10,1,0,47.0,1.0,53.0,791
6329,0,0,0,1,1,47.0,1.0,53.0,791
6330,0,50,50,2,2,47.0,1.0,53.0,791
6331,10,90,100,2,3,47.0,1.0,53.0,791
6332,3,42,45,3,4,47.0,1.0,53.0,791
6333,62,0,62,3,5,47.0,1.0,53.0,791
6334,0,100,100,3,6,47.0,1.0,53.0,791
6335,0,0,0,3,7,47.0,1.0,53.0,791
6336,44,39,83,1,0,47.0,1.0,53.0,792
6337,19,65,84,1,1,47.0,1.0,53.0,792
6338,38,43,81,2,2,47.0,1.0,53.0,792
6339,56,28,84,2,3,47.0,1.0,53.0,792
6340,15,68,83,3,4,47.0,1.0,53.0,792
6341,7,77,84,3,5,47.0,1.0,53.0,792
6342,50,37,87,3,6,47.0,1.0,53.0,792
6343,-12,31,19,3,7,47.0,1.0,53.0,792
6344,-2,63,61,1,0,48.0,1.0,52.0,793
6345,0,0,0,1,1,48.0,1.0,52.0,793
6346,79,0,79,2,2,48.0,1.0,52.0,793
6347,36,34,70,2,3,48.0,1.0,52.0,793
6348,0,100,100,3,4,48.0,1.0,52.0,793
6349,0,0,0,3,5,48.0,1.0,52.0,793
6350,0,100,100,3,6,48.0,1.0,52.0,793
6351,100,0,100,3,7,48.0,1.0,52.0,793
6352,40,49,89,1,0,48.0,1.0,52.0,794
6353,0,100,100,1,1,48.0,1.0,52.0,794
6354,0,50,50,2,2,48.0,1.0,52.0,794
6355,67,25,92,2,3,48.0,1.0,52.0,794
6356,-13,63,50,3,4,48.0,1.0,52.0,794
6357,4,76,80,3,5,48.0,1.0,52.0,794
6358,50,50,100,3,6,48.0,1.0,52.0,794
6359,84,0,84,3,7,48.0,1.0,52.0,794
6360,0,100,100,1,0,48.0,1.0,52.0,795
6361,0,100,100,1,1,48.0,1.0,52.0,795
6362,35,28,63,2,2,48.0,1.0,52.0,795
6363,26,50,76,2,3,48.0,1.0,52.0,795
6364,9,75,84,3,4,48.0,1.0,52.0,795
6365,19,50,69,3,5,48.0,1.0,52.0,795
6366,25,75,100,3,6,48.0,1.0,52.0,795
6367,50,10,60,3,7,48.0,1.0,52.0,795
6368,2,89,91,1,0,48.0,1.0,52.0,796
6369,3,77,80,1,1,48.0,1.0,52.0,796
6370,26,48,74,2,2,48.0,1.0,52.0,796
6371,11,5,16,2,3,48.0,1.0,52.0,796
6372,33,56,89,3,4,48.0,1.0,52.0,796
6373,64,25,89,3,5,48.0,1.0,52.0,796
6374,4,12,16,3,6,48.0,1.0,52.0,796
6375,60,20,80,3,7,48.0,1.0,52.0,796
6376,48,52,100,1,0,48.0,1.0,52.0,797
6377,30,67,97,1,1,48.0,1.0,52.0,797
6378,34,24,58,2,2,48.0,1.0,52.0,797
6379,38,10,48,2,3,48.0,1.0,52.0,797
6380,7,72,79,3,4,48.0,1.0,52.0,797
6381,24,50,74,3,5,48.0,1.0,52.0,797
6382,-91,91,0,3,6,48.0,1.0,52.0,797
6383,14,6,20,3,7,48.0,1.0,52.0,797
6384,65,35,100,1,0,48.0,1.0,52.0,798
6385,70,30,100,1,1,48.0,1.0,52.0,798
6386,52,48,100,2,2,48.0,1.0,52.0,798
6387,51,49,100,2,3,48.0,1.0,52.0,798
6388,24,76,100,3,4,48.0,1.0,52.0,798
6389,75,25,100,3,5,48.0,1.0,52.0,798
6390,100,0,100,3,6,48.0,1.0,52.0,798
6391,100,0,100,3,7,48.0,1.0,52.0,798
6392,9,22,31,1,0,48.0,1.0,52.0,799
6393,16,0,16,1,1,48.0,1.0,52.0,799
6394,13,0,13,2,2,48.0,1.0,52.0,799
6395,20,58,78,2,3,48.0,1.0,52.0,799
6396,30,32,62,3,4,48.0,1.0,52.0,799
6397,22,9,31,3,5,48.0,1.0,52.0,799
6398,28,35,63,3,6,48.0,1.0,52.0,799
6399,24,0,24,3,7,48.0,1.0,52.0,799
6400,24,51,75,1,0,48.0,1.0,52.0,800
6401,10,25,35,1,1,48.0,1.0,52.0,800
6402,6,49,55,2,2,48.0,1.0,52.0,800
6403,25,15,40,2,3,48.0,1.0,52.0,800
6404,5,60,65,3,4,48.0,1.0,52.0,800
6405,30,55,85,3,5,48.0,1.0,52.0,800
6406,30,20,50,3,6,48.0,1.0,52.0,800
6407,25,15,40,3,7,48.0,1.0,52.0,800
6408,0,50,50,1,0,48.0,1.0,52.0,801
6409,18,39,57,1,1,48.0,1.0,52.0,801
6410,59,9,68,2,2,48.0,1.0,52.0,801
6411,18,27,45,2,3,48.0,1.0,52.0,801
6412,12,49,61,3,4,48.0,1.0,52.0,801
6413,2,57,59,3,5,48.0,1.0,52.0,801
6414,22,42,64,3,6,48.0,1.0,52.0,801
6415,32,23,55,3,7,48.0,1.0,52.0,801
6416,50,50,100,1,0,48.0,1.0,52.0,802
6417,42,58,100,1,1,48.0,1.0,52.0,802
6418,53,47,100,2,2,48.0,1.0,52.0,802
6419,84,16,100,2,3,48.0,1.0,52.0,802
6420,50,50,100,3,4,48.0,1.0,52.0,802
6421,58,42,100,3,5,48.0,1.0,52.0,802
6422,95,5,100,3,6,48.0,1.0,52.0,802
6423,89,11,100,3,7,48.0,1.0,52.0,802
6424,1,42,43,1,0,48.0,1.0,52.0,803
6425,9,3,12,1,1,48.0,1.0,52.0,803
6426,7,1,8,2,2,48.0,1.0,52.0,803
6427,-23,55,32,2,3,48.0,1.0,52.0,803
6428,-10,60,50,3,4,48.0,1.0,52.0,803
6429,-4,31,27,3,5,48.0,1.0,52.0,803
6430,19,63,82,3,6,48.0,1.0,52.0,803
6431,-9,28,19,3,7,48.0,1.0,52.0,803
6432,73,27,100,1,0,48.0,1.0,52.0,804
6433,-39,39,0,1,1,48.0,1.0,52.0,804
6434,52,48,100,2,2,48.0,1.0,52.0,804
6435,32,68,100,2,3,48.0,1.0,52.0,804
6436,5,95,100,3,4,48.0,1.0,52.0,804
6437,64,36,100,3,5,48.0,1.0,52.0,804
6438,63,37,100,3,6,48.0,1.0,52.0,804
6439,96,4,100,3,7,48.0,1.0,52.0,804
6440,-21,50,29,1,0,48.0,1.0,52.0,805
6441,0,62,62,1,1,48.0,1.0,52.0,805
6442,29,0,29,2,2,48.0,1.0,52.0,805
6443,-6,8,2,2,3,48.0,1.0,52.0,805
6444,1,64,65,3,4,48.0,1.0,52.0,805
6445,0,50,50,3,5,48.0,1.0,52.0,805
6446,5,4,9,3,6,48.0,1.0,52.0,805
6447,82,0,82,3,7,48.0,1.0,52.0,805
6448,-22,48,26,1,0,48.0,1.0,52.0,806
6449,-14,48,34,1,1,48.0,1.0,52.0,806
6450,41,35,76,2,2,48.0,1.0,52.0,806
6451,55,16,71,2,3,48.0,1.0,52.0,806
6452,15,51,66,3,4,48.0,1.0,52.0,806
6453,64,0,64,3,5,48.0,1.0,52.0,806
6454,56,14,70,3,6,48.0,1.0,52.0,806
6455,23,0,23,3,7,48.0,1.0,52.0,806
6456,-27,53,26,1,0,49.0,1.0,51.0,807
6457,0,100,100,1,1,49.0,1.0,51.0,807
6458,54,6,60,2,2,49.0,1.0,51.0,807
6459,69,8,77,2,3,49.0,1.0,51.0,807
6460,25,53,78,3,4,49.0,1.0,51.0,807
6461,16,47,63,3,5,49.0,1.0,51.0,807
6462,16,84,100,3,6,49.0,1.0,51.0,807
6463,79,9,88,3,7,49.0,1.0,51.0,807
6464,39,47,86,1,0,49.0,1.0,51.0,808
6465,31,22,53,1,1,49.0,1.0,51.0,808
6466,48,36,84,2,2,49.0,1.0,51.0,808
6467,35,53,88,2,3,49.0,1.0,51.0,808
6468,25,75,100,3,4,49.0,1.0,51.0,808
6469,13,63,76,3,5,49.0,1.0,51.0,808
6470,100,0,100,3,6,49.0,1.0,51.0,808
6471,93,7,100,3,7,49.0,1.0,51.0,808
6472,96,4,100,1,0,49.0,1.0,51.0,809
6473,71,29,100,1,1,49.0,1.0,51.0,809
6474,49,51,100,2,2,49.0,1.0,51.0,809
6475,21,79,100,2,3,49.0,1.0,51.0,809
6476,12,88,100,3,4,49.0,1.0,51.0,809
6477,6,94,100,3,5,49.0,1.0,51.0,809
6478,44,56,100,3,6,49.0,1.0,51.0,809
6479,87,13,100,3,7,49.0,1.0,51.0,809
6480,-3,53,50,1,0,49.0,1.0,51.0,810
6481,14,83,97,1,1,49.0,1.0,51.0,810
6482,5,50,55,2,2,49.0,1.0,51.0,810
6483,24,26,50,2,3,49.0,1.0,51.0,810
6484,0,50,50,3,4,49.0,1.0,51.0,810
6485,24,50,74,3,5,49.0,1.0,51.0,810
6486,0,50,50,3,6,49.0,1.0,51.0,810
6487,1,14,15,3,7,49.0,1.0,51.0,810
6488,-28,39,11,1,0,49.0,1.0,51.0,811
6489,-22,22,0,1,1,49.0,1.0,51.0,811
6490,-13,25,12,2,2,49.0,1.0,51.0,811
6491,-1,6,5,2,3,49.0,1.0,51.0,811
6492,29,20,49,3,4,49.0,1.0,51.0,811
6493,78,22,100,3,5,49.0,1.0,51.0,811
6494,0,100,100,3,6,49.0,1.0,51.0,811
6495,10,4,14,3,7,49.0,1.0,51.0,811
6496,10,50,60,1,0,49.0,1.0,51.0,812
6497,34,63,97,1,1,49.0,1.0,51.0,812
6498,0,50,50,2,2,49.0,1.0,51.0,812
6499,32,50,82,2,3,49.0,1.0,51.0,812
6500,48,50,98,3,4,49.0,1.0,51.0,812
6501,13,50,63,3,5,49.0,1.0,51.0,812
6502,53,38,91,3,6,49.0,1.0,51.0,812
6503,13,50,63,3,7,49.0,1.0,51.0,812
6504,70,30,100,1,0,49.0,1.0,51.0,813
6505,2,98,100,1,1,49.0,1.0,51.0,813
6506,100,0,100,2,2,49.0,1.0,51.0,813
6507,75,22,97,2,3,49.0,1.0,51.0,813
6508,16,66,82,3,4,49.0,1.0,51.0,813
6509,49,51,100,3,5,49.0,1.0,51.0,813
6510,72,28,100,3,6,49.0,1.0,51.0,813
6511,87,13,100,3,7,49.0,1.0,51.0,813
6512,22,50,72,1,0,49.0,1.0,51.0,814
6513,17,70,87,1,1,49.0,1.0,51.0,814
6514,55,30,85,2,2,49.0,1.0,51.0,814
6515,-48,48,0,2,3,49.0,1.0,51.0,814
6516,26,52,78,3,4,49.0,1.0,51.0,814
6517,44,38,82,3,5,49.0,1.0,51.0,814
6518,47,28,75,3,6,49.0,1.0,51.0,814
6519,76,12,88,3,7,49.0,1.0,51.0,814
6520,27,66,93,1,0,49.0,1.0,51.0,815
6521,-3,100,97,1,1,49.0,1.0,51.0,815
6522,47,50,97,2,2,49.0,1.0,51.0,815
6523,85,7,92,2,3,49.0,1.0,51.0,815
6524,52,37,89,3,4,49.0,1.0,51.0,815
6525,53,36,89,3,5,49.0,1.0,51.0,815
6526,-43,50,7,3,6,49.0,1.0,51.0,815
6527,43,50,93,3,7,49.0,1.0,51.0,815
6528,0,50,50,1,0,49.0,1.0,51.0,816
6529,-15,50,35,1,1,49.0,1.0,51.0,816
6530,-17,50,33,2,2,49.0,1.0,51.0,816
6531,25,50,75,2,3,49.0,1.0,51.0,816
6532,-19,50,31,3,4,49.0,1.0,51.0,816
6533,-45,62,17,3,5,49.0,1.0,51.0,816
6534,22,50,72,3,6,49.0,1.0,51.0,816
6535,41,50,91,3,7,49.0,1.0,51.0,816
6536,78,22,100,1,0,49.0,1.0,51.0,817
6537,100,0,100,1,1,49.0,1.0,51.0,817
6538,100,0,100,2,2,49.0,1.0,51.0,817
6539,-48,65,17,2,3,49.0,1.0,51.0,817
6540,36,64,100,3,4,49.0,1.0,51.0,817
6541,90,10,100,3,5,49.0,1.0,51.0,817
6542,58,42,100,3,6,49.0,1.0,51.0,817
6543,-39,39,0,3,7,49.0,1.0,51.0,817
6544,19,30,49,1,0,49.0,1.0,51.0,818
6545,63,14,77,1,1,49.0,1.0,51.0,818
6546,20,0,20,2,2,49.0,1.0,51.0,818
6547,-15,33,18,2,3,49.0,1.0,51.0,818
6548,14,57,71,3,4,49.0,1.0,51.0,818
6549,15,38,53,3,5,49.0,1.0,51.0,818
6550,22,39,61,3,6,49.0,1.0,51.0,818
6551,-5,86,81,3,7,49.0,1.0,51.0,818
6552,44,23,67,1,0,49.0,1.0,51.0,819
6553,8,64,72,1,1,49.0,1.0,51.0,819
6554,8,57,65,2,2,49.0,1.0,51.0,819
6555,11,62,73,2,3,49.0,1.0,51.0,819
6556,32,47,79,3,4,49.0,1.0,51.0,819
6557,23,34,57,3,5,49.0,1.0,51.0,819
6558,-2,65,63,3,6,49.0,1.0,51.0,819
6559,60,11,71,3,7,49.0,1.0,51.0,819
6560,85,15,100,1,0,49.0,1.0,51.0,820
6561,100,0,100,1,1,49.0,1.0,51.0,820
6562,36,64,100,2,2,49.0,1.0,51.0,820
6563,54,46,100,2,3,49.0,1.0,51.0,820
6564,36,64,100,3,4,49.0,1.0,51.0,820
6565,76,24,100,3,5,49.0,1.0,51.0,820
6566,23,77,100,3,6,49.0,1.0,51.0,820
6567,100,0,100,3,7,49.0,1.0,51.0,820
6568,-4,75,71,1,0,49.0,1.0,51.0,821
6569,0,100,100,1,1,49.0,1.0,51.0,821
6570,18,32,50,2,2,49.0,1.0,51.0,821
6571,0,50,50,2,3,49.0,1.0,51.0,821
6572,-5,5,0,3,4,49.0,1.0,51.0,821
6573,23,77,100,3,5,49.0,1.0,51.0,821
6574,2,50,52,3,6,49.0,1.0,51.0,821
6575,-11,11,0,3,7,49.0,1.0,51.0,821
6576,-22,98,76,1,0,49.0,1.0,51.0,822
6577,1,99,100,1,1,49.0,1.0,51.0,822
6578,-8,96,88,2,2,49.0,1.0,51.0,822
6579,6,87,93,2,3,49.0,1.0,51.0,822
6580,59,27,86,3,4,49.0,1.0,51.0,822
6581,-58,77,19,3,5,49.0,1.0,51.0,822
6582,58,28,86,3,6,49.0,1.0,51.0,822
6583,17,3,20,3,7,49.0,1.0,51.0,822
6584,-8,90,82,1,0,49.0,1.0,51.0,823
6585,20,80,100,1,1,49.0,1.0,51.0,823
6586,30,0,30,2,2,49.0,1.0,51.0,823
6587,4,12,16,2,3,49.0,1.0,51.0,823
6588,65,35,100,3,4,49.0,1.0,51.0,823
6589,82,18,100,3,5,49.0,1.0,51.0,823
6590,58,42,100,3,6,49.0,1.0,51.0,823
6591,70,30,100,3,7,49.0,1.0,51.0,823
6592,40,53,93,1,0,49.0,1.0,51.0,824
6593,22,65,87,1,1,49.0,1.0,51.0,824
6594,0,100,100,2,2,49.0,1.0,51.0,824
6595,22,78,100,2,3,49.0,1.0,51.0,824
6596,7,93,100,3,4,49.0,1.0,51.0,824
6597,46,54,100,3,5,49.0,1.0,51.0,824
6598,32,68,100,3,6,49.0,1.0,51.0,824
6599,84,10,94,3,7,49.0,1.0,51.0,824
6600,54,14,68,1,0,49.0,1.0,51.0,825
6601,-57,100,43,1,1,49.0,1.0,51.0,825
6602,-23,100,77,2,2,49.0,1.0,51.0,825
6603,0,100,100,2,3,49.0,1.0,51.0,825
6604,-15,40,25,3,4,49.0,1.0,51.0,825
6605,33,67,100,3,5,49.0,1.0,51.0,825
6606,-13,13,0,3,6,49.0,1.0,51.0,825
6607,53,13,66,3,7,49.0,1.0,51.0,825
6608,24,0,24,1,0,49.0,1.0,51.0,826
6609,-49,69,20,1,1,49.0,1.0,51.0,826
6610,47,39,86,2,2,49.0,1.0,51.0,826
6611,0,100,100,2,3,49.0,1.0,51.0,826
6612,0,72,72,3,4,49.0,1.0,51.0,826
6613,6,24,30,3,5,49.0,1.0,51.0,826
6614,-32,100,68,3,6,49.0,1.0,51.0,826
6615,0,0,0,3,7,49.0,1.0,51.0,826
6616,0,52,52,1,0,49.0,1.0,51.0,827
6617,9,32,41,1,1,49.0,1.0,51.0,827
6618,33,43,76,2,2,49.0,1.0,51.0,827
6619,6,11,17,2,3,49.0,1.0,51.0,827
6620,-1,45,44,3,4,49.0,1.0,51.0,827
6621,72,6,78,3,5,49.0,1.0,51.0,827
6622,-10,53,43,3,6,49.0,1.0,51.0,827
6623,37,8,45,3,7,49.0,1.0,51.0,827
6624,-44,46,2,1,0,49.0,1.0,51.0,828
6625,0,0,0,1,1,49.0,1.0,51.0,828
6626,0,0,0,2,2,49.0,1.0,51.0,828
6627,0,45,45,2,3,49.0,1.0,51.0,828
6628,-1,46,45,3,4,49.0,1.0,51.0,828
6629,-2,49,47,3,5,49.0,1.0,51.0,828
6630,-73,75,2,3,6,49.0,1.0,51.0,828
6631,-1,5,4,3,7,49.0,1.0,51.0,828
6632,15,85,100,1,0,49.0,1.0,51.0,829
6633,15,85,100,1,1,49.0,1.0,51.0,829
6634,75,25,100,2,2,49.0,1.0,51.0,829
6635,31,69,100,2,3,49.0,1.0,51.0,829
6636,25,75,100,3,4,49.0,1.0,51.0,829
6637,20,80,100,3,5,49.0,1.0,51.0,829
6638,-100,100,0,3,6,49.0,1.0,51.0,829
6639,100,0,100,3,7,49.0,1.0,51.0,829
6640,22,37,59,1,0,49.0,1.0,51.0,830
6641,33,27,60,1,1,49.0,1.0,51.0,830
6642,9,50,59,2,2,49.0,1.0,51.0,830
6643,-1,64,63,2,3,49.0,1.0,51.0,830
6644,4,57,61,3,4,49.0,1.0,51.0,830
6645,34,29,63,3,5,49.0,1.0,51.0,830
6646,27,38,65,3,6,49.0,1.0,51.0,830
6647,40,23,63,3,7,49.0,1.0,51.0,830
6648,27,42,69,1,0,49.0,1.0,51.0,831
6649,23,64,87,1,1,49.0,1.0,51.0,831
6650,19,25,44,2,2,49.0,1.0,51.0,831
6651,17,4,21,2,3,49.0,1.0,51.0,831
6652,20,67,87,3,4,49.0,1.0,51.0,831
6653,26,30,56,3,5,49.0,1.0,51.0,831
6654,52,14,66,3,6,49.0,1.0,51.0,831
6655,26,5,31,3,7,49.0,1.0,51.0,831
6656,2,1,3,1,0,49.0,1.0,51.0,832
6657,39,61,100,1,1,49.0,1.0,51.0,832
6658,4,96,100,2,2,49.0,1.0,51.0,832
6659,0,100,100,2,3,49.0,1.0,51.0,832
6660,69,31,100,3,4,49.0,1.0,51.0,832
6661,48,52,100,3,5,49.0,1.0,51.0,832
6662,0,100,100,3,6,49.0,1.0,51.0,832
6663,32,53,85,3,7,49.0,1.0,51.0,832
6664,49,49,98,1,0,49.0,1.0,51.0,833
6665,0,1,1,1,1,49.0,1.0,51.0,833
6666,41,59,100,2,2,49.0,1.0,51.0,833
6667,11,89,100,2,3,49.0,1.0,51.0,833
6668,-32,32,0,3,4,49.0,1.0,51.0,833
6669,32,68,100,3,5,49.0,1.0,51.0,833
6670,73,27,100,3,6,49.0,1.0,51.0,833
6671,85,15,100,3,7,49.0,1.0,51.0,833
6672,-43,70,27,1,0,49.0,1.0,51.0,834
6673,-13,48,35,1,1,49.0,1.0,51.0,834
6674,34,31,65,2,2,49.0,1.0,51.0,834
6675,6,26,32,2,3,49.0,1.0,51.0,834
6676,-5,70,65,3,4,49.0,1.0,51.0,834
6677,3,32,35,3,5,49.0,1.0,51.0,834
6678,7,62,69,3,6,49.0,1.0,51.0,834
6679,10,23,33,3,7,49.0,1.0,51.0,834
6680,3,84,87,1,0,49.0,1.0,51.0,835
6681,-81,93,12,1,1,49.0,1.0,51.0,835
6682,69,5,74,2,2,49.0,1.0,51.0,835
6683,36,3,39,2,3,49.0,1.0,51.0,835
6684,14,59,73,3,4,49.0,1.0,51.0,835
6685,41,36,77,3,5,49.0,1.0,51.0,835
6686,36,36,72,3,6,49.0,1.0,51.0,835
6687,23,14,37,3,7,49.0,1.0,51.0,835
6688,5,49,54,1,0,50.0,2.0,50.0,836
6689,14,85,99,1,1,50.0,2.0,50.0,836
6690,0,50,50,2,2,50.0,2.0,50.0,836
6691,0,50,50,2,3,50.0,2.0,50.0,836
6692,14,36,50,3,4,50.0,2.0,50.0,836
6693,54,16,70,3,5,50.0,2.0,50.0,836
6694,-13,13,0,3,6,50.0,2.0,50.0,836
6695,-2,20,18,3,7,50.0,2.0,50.0,836
6696,0,50,50,1,0,50.0,2.0,50.0,837
6697,0,50,50,1,1,50.0,2.0,50.0,837
6698,0,50,50,2,2,50.0,2.0,50.0,837
6699,0,50,50,2,3,50.0,2.0,50.0,837
6700,0,50,50,3,4,50.0,2.0,50.0,837
6701,0,50,50,3,5,50.0,2.0,50.0,837
6702,0,50,50,3,6,50.0,2.0,50.0,837
6703,0,50,50,3,7,50.0,2.0,50.0,837
6704,41,59,100,1,0,50.0,2.0,50.0,838
6705,0,100,100,1,1,50.0,2.0,50.0,838
6706,50,50,100,2,2,50.0,2.0,50.0,838
6707,-38,38,0,2,3,50.0,2.0,50.0,838
6708,60,40,100,3,4,50.0,2.0,50.0,838
6709,100,0,100,3,5,50.0,2.0,50.0,838
6710,3,97,100,3,6,50.0,2.0,50.0,838
6711,90,10,100,3,7,50.0,2.0,50.0,838
6712,6,90,96,1,0,50.0,2.0,50.0,839
6713,13,63,76,1,1,50.0,2.0,50.0,839
6714,78,1,79,2,2,50.0,2.0,50.0,839
6715,17,75,92,2,3,50.0,2.0,50.0,839
6716,28,63,91,3,4,50.0,2.0,50.0,839
6717,0,50,50,3,5,50.0,2.0,50.0,839
6718,-29,50,21,3,6,50.0,2.0,50.0,839
6719,0,0,0,3,7,50.0,2.0,50.0,839
6720,21,79,100,1,0,50.0,2.0,50.0,840
6721,84,15,99,1,1,50.0,2.0,50.0,840
6722,50,50,100,2,2,50.0,2.0,50.0,840
6723,50,50,100,2,3,50.0,2.0,50.0,840
6724,57,43,100,3,4,50.0,2.0,50.0,840
6725,58,42,100,3,5,50.0,2.0,50.0,840
6726,90,10,100,3,6,50.0,2.0,50.0,840
6727,0,2,2,3,7,50.0,2.0,50.0,840
6728,16,49,65,1,0,50.0,2.0,50.0,841
6729,4,11,15,1,1,50.0,2.0,50.0,841
6730,17,51,68,2,2,50.0,2.0,50.0,841
6731,3,63,66,2,3,50.0,2.0,50.0,841
6732,25,50,75,3,4,50.0,2.0,50.0,841
6733,-13,63,50,3,5,50.0,2.0,50.0,841
6734,-1,52,51,3,6,50.0,2.0,50.0,841
6735,-9,35,26,3,7,50.0,2.0,50.0,841
6736,-6,82,76,1,0,50.0,2.0,50.0,842
6737,2,85,87,1,1,50.0,2.0,50.0,842
6738,-6,72,66,2,2,50.0,2.0,50.0,842
6739,50,28,78,2,3,50.0,2.0,50.0,842
6740,49,34,83,3,4,50.0,2.0,50.0,842
6741,34,50,84,3,5,50.0,2.0,50.0,842
6742,41,35,76,3,6,50.0,2.0,50.0,842
6743,49,34,83,3,7,50.0,2.0,50.0,842
6744,94,6,100,1,0,50.0,2.0,50.0,843
6745,50,50,100,1,1,50.0,2.0,50.0,843
6746,50,50,100,2,2,50.0,2.0,50.0,843
6747,9,90,99,2,3,50.0,2.0,50.0,843
6748,15,85,100,3,4,50.0,2.0,50.0,843
6749,-4,4,0,3,5,50.0,2.0,50.0,843
6750,66,34,100,3,6,50.0,2.0,50.0,843
6751,81,19,100,3,7,50.0,2.0,50.0,843
6752,1,99,100,1,0,50.0,2.0,50.0,844
6753,4,96,100,1,1,50.0,2.0,50.0,844
6754,38,49,87,2,2,50.0,2.0,50.0,844
6755,35,15,50,2,3,50.0,2.0,50.0,844
6756,2,89,91,3,4,50.0,2.0,50.0,844
6757,76,23,99,3,5,50.0,2.0,50.0,844
6758,3,19,22,3,6,50.0,2.0,50.0,844
6759,9,15,24,3,7,50.0,2.0,50.0,844
6760,96,4,100,1,0,50.0,2.0,50.0,845
6761,74,26,100,1,1,50.0,2.0,50.0,845
6762,100,0,100,2,2,50.0,2.0,50.0,845
6763,74,26,100,2,3,50.0,2.0,50.0,845
6764,6,94,100,3,4,50.0,2.0,50.0,845
6765,89,11,100,3,5,50.0,2.0,50.0,845
6766,89,11,100,3,6,50.0,2.0,50.0,845
6767,94,6,100,3,7,50.0,2.0,50.0,845
6768,75,23,98,1,0,50.0,2.0,50.0,846
6769,16,76,92,1,1,50.0,2.0,50.0,846
6770,25,60,85,2,2,50.0,2.0,50.0,846
6771,24,76,100,2,3,50.0,2.0,50.0,846
6772,24,76,100,3,4,50.0,2.0,50.0,846
6773,88,11,99,3,5,50.0,2.0,50.0,846
6774,50,50,100,3,6,50.0,2.0,50.0,846
6775,93,6,99,3,7,50.0,2.0,50.0,846
6776,0,50,50,1,0,50.0,2.0,50.0,847
6777,0,0,0,1,1,50.0,2.0,50.0,847
6778,0,50,50,2,2,50.0,2.0,50.0,847
6779,0,50,50,2,3,50.0,2.0,50.0,847
6780,0,50,50,3,4,50.0,2.0,50.0,847
6781,0,50,50,3,5,50.0,2.0,50.0,847
6782,0,50,50,3,6,50.0,2.0,50.0,847
6783,0,0,0,3,7,50.0,2.0,50.0,847
6784,100,0,100,1,0,50.0,2.0,50.0,848
6785,25,75,100,1,1,50.0,2.0,50.0,848
6786,-10,10,0,2,2,50.0,2.0,50.0,848
6787,50,50,100,2,3,50.0,2.0,50.0,848
6788,50,50,100,3,4,50.0,2.0,50.0,848
6789,50,50,100,3,5,50.0,2.0,50.0,848
6790,-9,100,91,3,6,50.0,2.0,50.0,848
6791,0,0,0,3,7,50.0,2.0,50.0,848
6792,50,50,100,1,0,50.0,2.0,50.0,849
6793,48,52,100,1,1,50.0,2.0,50.0,849
6794,50,50,100,2,2,50.0,2.0,50.0,849
6795,50,50,100,2,3,50.0,2.0,50.0,849
6796,66,34,100,3,4,50.0,2.0,50.0,849
6797,74,26,100,3,5,50.0,2.0,50.0,849
6798,58,42,100,3,6,50.0,2.0,50.0,849
6799,69,31,100,3,7,50.0,2.0,50.0,849
6800,100,0,100,1,0,50.0,2.0,50.0,850
6801,100,0,100,1,1,50.0,2.0,50.0,850
6802,89,11,100,2,2,50.0,2.0,50.0,850
6803,100,0,100,2,3,50.0,2.0,50.0,850
6804,26,74,100,3,4,50.0,2.0,50.0,850
6805,100,0,100,3,5,50.0,2.0,50.0,850
6806,100,0,100,3,6,50.0,2.0,50.0,850
6807,100,0,100,3,7,50.0,2.0,50.0,850
6808,100,0,100,1,0,50.0,2.0,50.0,851
6809,0,0,0,1,1,50.0,2.0,50.0,851
6810,100,0,100,2,2,50.0,2.0,50.0,851
6811,74,24,98,2,3,50.0,2.0,50.0,851
6812,66,34,100,3,4,50.0,2.0,50.0,851
6813,74,26,100,3,5,50.0,2.0,50.0,851
6814,3,0,3,3,6,50.0,2.0,50.0,851
6815,100,0,100,3,7,50.0,2.0,50.0,851
6816,19,80,99,1,0,50.0,2.0,50.0,852
6817,26,74,100,1,1,50.0,2.0,50.0,852
6818,-8,27,19,2,2,50.0,2.0,50.0,852
6819,32,50,82,2,3,50.0,2.0,50.0,852
6820,-3,17,14,3,4,50.0,2.0,50.0,852
6821,6,79,85,3,5,50.0,2.0,50.0,852
6822,-36,50,14,3,6,50.0,2.0,50.0,852
6823,4,16,20,3,7,50.0,2.0,50.0,852
6824,75,25,100,1,0,50.0,2.0,50.0,853
6825,76,24,100,1,1,50.0,2.0,50.0,853
6826,50,50,100,2,2,50.0,2.0,50.0,853
6827,70,23,93,2,3,50.0,2.0,50.0,853
6828,38,62,100,3,4,50.0,2.0,50.0,853
6829,51,49,100,3,5,50.0,2.0,50.0,853
6830,50,50,100,3,6,50.0,2.0,50.0,853
6831,50,0,50,3,7,50.0,2.0,50.0,853
6832,2,46,48,1,0,50.0,2.0,50.0,854
6833,-2,52,50,1,1,50.0,2.0,50.0,854
6834,0,47,47,2,2,50.0,2.0,50.0,854
6835,-14,48,34,2,3,50.0,2.0,50.0,854
6836,0,50,50,3,4,50.0,2.0,50.0,854
6837,25,23,48,3,5,50.0,2.0,50.0,854
6838,0,100,100,3,6,50.0,2.0,50.0,854
6839,2,10,12,3,7,50.0,2.0,50.0,854
6840,-24,74,50,1,0,50.0,2.0,50.0,855
6841,0,100,100,1,1,50.0,2.0,50.0,855
6842,49,0,49,2,2,50.0,2.0,50.0,855
6843,0,50,50,2,3,50.0,2.0,50.0,855
6844,-1,51,50,3,4,50.0,2.0,50.0,855
6845,50,0,50,3,5,50.0,2.0,50.0,855
6846,-8,58,50,3,6,50.0,2.0,50.0,855
6847,50,0,50,3,7,50.0,2.0,50.0,855
6848,0,50,50,1,0,50.0,2.0,50.0,856
6849,0,50,50,1,1,50.0,2.0,50.0,856
6850,0,50,50,2,2,50.0,2.0,50.0,856
6851,0,50,50,2,3,50.0,2.0,50.0,856
6852,53,24,77,3,4,50.0,2.0,50.0,856
6853,51,26,77,3,5,50.0,2.0,50.0,856
6854,0,50,50,3,6,50.0,2.0,50.0,856
6855,0,50,50,3,7,50.0,2.0,50.0,856
6856,2,51,53,1,0,50.0,2.0,50.0,857
6857,-14,84,70,1,1,50.0,2.0,50.0,857
6858,-24,62,38,2,2,50.0,2.0,50.0,857
6859,7,46,53,2,3,50.0,2.0,50.0,857
6860,6,56,62,3,4,50.0,2.0,50.0,857
6861,11,32,43,3,5,50.0,2.0,50.0,857
6862,-4,86,82,3,6,50.0,2.0,50.0,857
6863,29,33,62,3,7,50.0,2.0,50.0,857
6864,5,45,50,1,0,50.0,2.0,50.0,858
6865,44,32,76,1,1,50.0,2.0,50.0,858
6866,0,50,50,2,2,50.0,2.0,50.0,858
6867,0,50,50,2,3,50.0,2.0,50.0,858
6868,-13,42,29,3,4,50.0,2.0,50.0,858
6869,-1,16,15,3,5,50.0,2.0,50.0,858
6870,-10,43,33,3,6,50.0,2.0,50.0,858
6871,2,22,24,3,7,50.0,2.0,50.0,858
6872,50,0,50,1,0,50.0,2.0,50.0,859
6873,-4,79,75,1,1,50.0,2.0,50.0,859
6874,0,50,50,2,2,50.0,2.0,50.0,859
6875,-100,100,0,2,3,50.0,2.0,50.0,859
6876,36,27,63,3,4,50.0,2.0,50.0,859
6877,0,100,100,3,5,50.0,2.0,50.0,859
6878,0,100,100,3,6,50.0,2.0,50.0,859
6879,-14,64,50,3,7,50.0,2.0,50.0,859
6880,71,29,100,1,0,50.0,2.0,50.0,860
6881,100,0,100,1,1,50.0,2.0,50.0,860
6882,0,0,0,2,2,50.0,2.0,50.0,860
6883,50,50,100,2,3,50.0,2.0,50.0,860
6884,60,40,100,3,4,50.0,2.0,50.0,860
6885,38,62,100,3,5,50.0,2.0,50.0,860
6886,50,50,100,3,6,50.0,2.0,50.0,860
6887,100,0,100,3,7,50.0,2.0,50.0,860
6888,0,50,50,1,0,50.0,2.0,50.0,861
6889,85,15,100,1,1,50.0,2.0,50.0,861
6890,-14,30,16,2,2,50.0,2.0,50.0,861
6891,-54,61,7,2,3,50.0,2.0,50.0,861
6892,31,24,55,3,4,50.0,2.0,50.0,861
6893,-4,23,19,3,5,50.0,2.0,50.0,861
6894,8,19,27,3,6,50.0,2.0,50.0,861
6895,-7,26,19,3,7,50.0,2.0,50.0,861
6896,4,76,80,1,0,50.0,2.0,50.0,862
6897,16,34,50,1,1,50.0,2.0,50.0,862
6898,-25,90,65,2,2,50.0,2.0,50.0,862
6899,-4,72,68,2,3,50.0,2.0,50.0,862
6900,-10,74,64,3,4,50.0,2.0,50.0,862
6901,4,70,74,3,5,50.0,2.0,50.0,862
6902,-2,65,63,3,6,50.0,2.0,50.0,862
6903,-19,69,50,3,7,50.0,2.0,50.0,862
6904,1,57,58,1,0,50.0,2.0,50.0,863
6905,11,19,30,1,1,50.0,2.0,50.0,863
6906,-16,56,40,2,2,50.0,2.0,50.0,863
6907,-23,61,38,2,3,50.0,2.0,50.0,863
6908,-9,70,61,3,4,50.0,2.0,50.0,863
6909,1,63,64,3,5,50.0,2.0,50.0,863
6910,51,31,82,3,6,50.0,2.0,50.0,863
6911,7,21,28,3,7,50.0,2.0,50.0,863
6912,42,58,100,1,0,50.0,2.0,50.0,864
6913,1,75,76,1,1,50.0,2.0,50.0,864
6914,-25,27,2,2,2,50.0,2.0,50.0,864
6915,-34,39,5,2,3,50.0,2.0,50.0,864
6916,0,50,50,3,4,50.0,2.0,50.0,864
6917,0,50,50,3,5,50.0,2.0,50.0,864
6918,6,50,56,3,6,50.0,2.0,50.0,864
6919,-12,25,13,3,7,50.0,2.0,50.0,864
6920,89,11,100,1,0,50.0,2.0,50.0,865
6921,92,8,100,1,1,50.0,2.0,50.0,865
6922,74,26,100,2,2,50.0,2.0,50.0,865
6923,75,25,100,2,3,50.0,2.0,50.0,865
6924,40,60,100,3,4,50.0,2.0,50.0,865
6925,50,50,100,3,5,50.0,2.0,50.0,865
6926,95,5,100,3,6,50.0,2.0,50.0,865
6927,99,1,100,3,7,50.0,2.0,50.0,865
6928,39,50,89,1,0,50.0,2.0,50.0,866
6929,23,65,88,1,1,50.0,2.0,50.0,866
6930,-23,37,14,2,2,50.0,2.0,50.0,866
6931,38,50,88,2,3,50.0,2.0,50.0,866
6932,20,63,83,3,4,50.0,2.0,50.0,866
6933,4,75,79,3,5,50.0,2.0,50.0,866
6934,-56,63,7,3,6,50.0,2.0,50.0,866
6935,57,32,89,3,7,50.0,2.0,50.0,866
6936,14,16,30,1,0,50.0,2.0,50.0,867
6937,-17,33,16,1,1,50.0,2.0,50.0,867
6938,7,19,26,2,2,50.0,2.0,50.0,867
6939,24,11,35,2,3,50.0,2.0,50.0,867
6940,11,65,76,3,4,50.0,2.0,50.0,867
6941,13,23,36,3,5,50.0,2.0,50.0,867
6942,-26,34,8,3,6,50.0,2.0,50.0,867
6943,2,13,15,3,7,50.0,2.0,50.0,867
6944,0,0,0,1,0,50.0,2.0,50.0,868
6945,100,0,100,1,1,50.0,2.0,50.0,868
6946,0,0,0,2,2,50.0,2.0,50.0,868
6947,0,0,0,2,3,50.0,2.0,50.0,868
6948,-50,100,50,3,4,50.0,2.0,50.0,868
6949,0,0,0,3,5,50.0,2.0,50.0,868
6950,0,0,0,3,6,50.0,2.0,50.0,868
6951,-1,1,0,3,7,50.0,2.0,50.0,868
6952,50,50,100,1,0,50.0,2.0,50.0,869
6953,29,71,100,1,1,50.0,2.0,50.0,869
6954,64,36,100,2,2,50.0,2.0,50.0,869
6955,63,37,100,2,3,50.0,2.0,50.0,869
6956,50,50,100,3,4,50.0,2.0,50.0,869
6957,50,50,100,3,5,50.0,2.0,50.0,869
6958,57,43,100,3,6,50.0,2.0,50.0,869
6959,65,35,100,3,7,50.0,2.0,50.0,869
6960,-2,29,27,1,0,50.0,2.0,50.0,870
6961,-4,24,20,1,1,50.0,2.0,50.0,870
6962,13,37,50,2,2,50.0,2.0,50.0,870
6963,12,77,89,2,3,50.0,2.0,50.0,870
6964,16,76,92,3,4,50.0,2.0,50.0,870
6965,80,13,93,3,5,50.0,2.0,50.0,870
6966,0,26,26,3,6,50.0,2.0,50.0,870
6967,2,25,27,3,7,50.0,2.0,50.0,870
6968,50,50,100,1,0,50.0,2.0,50.0,871
6969,0,50,50,1,1,50.0,2.0,50.0,871
6970,0,50,50,2,2,50.0,2.0,50.0,871
6971,0,50,50,2,3,50.0,2.0,50.0,871
6972,50,50,100,3,4,50.0,2.0,50.0,871
6973,50,50,100,3,5,50.0,2.0,50.0,871
6974,100,0,100,3,6,50.0,2.0,50.0,871
6975,100,0,100,3,7,50.0,2.0,50.0,871
6976,50,50,100,1,0,50.0,2.0,50.0,872
6977,75,25,100,1,1,50.0,2.0,50.0,872
6978,-50,50,0,2,2,50.0,2.0,50.0,872
6979,-70,70,0,2,3,50.0,2.0,50.0,872
6980,30,70,100,3,4,50.0,2.0,50.0,872
6981,100,0,100,3,5,50.0,2.0,50.0,872
6982,100,0,100,3,6,50.0,2.0,50.0,872
6983,100,0,100,3,7,50.0,2.0,50.0,872
6984,19,10,29,1,0,50.0,2.0,50.0,873
6985,5,7,12,1,1,50.0,2.0,50.0,873
6986,26,24,50,2,2,50.0,2.0,50.0,873
6987,7,19,26,2,3,50.0,2.0,50.0,873
6988,23,73,96,3,4,50.0,2.0,50.0,873
6989,2,69,71,3,5,50.0,2.0,50.0,873
6990,11,78,89,3,6,50.0,2.0,50.0,873
6991,25,25,50,3,7,50.0,2.0,50.0,873
6992,50,50,100,1,0,50.0,2.0,50.0,874
6993,50,50,100,1,1,50.0,2.0,50.0,874
6994,50,50,100,2,2,50.0,2.0,50.0,874
6995,-50,50,0,2,3,50.0,2.0,50.0,874
6996,46,54,100,3,4,50.0,2.0,50.0,874
6997,59,41,100,3,5,50.0,2.0,50.0,874
6998,23,77,100,3,6,50.0,2.0,50.0,874
6999,100,0,100,3,7,50.0,2.0,50.0,874
7000,73,20,93,1,0,50.0,2.0,50.0,875
7001,59,41,100,1,1,50.0,2.0,50.0,875
7002,45,26,71,2,2,50.0,2.0,50.0,875
7003,-24,74,50,2,3,50.0,2.0,50.0,875
7004,16,78,94,3,4,50.0,2.0,50.0,875
7005,15,35,50,3,5,50.0,2.0,50.0,875
7006,58,36,94,3,6,50.0,2.0,50.0,875
7007,31,19,50,3,7,50.0,2.0,50.0,875
7008,0,0,0,1,0,50.0,2.0,50.0,876
7009,0,0,0,1,1,50.0,2.0,50.0,876
7010,100,0,100,2,2,50.0,2.0,50.0,876
7011,56,0,56,2,3,50.0,2.0,50.0,876
7012,75,25,100,3,4,50.0,2.0,50.0,876
7013,100,0,100,3,5,50.0,2.0,50.0,876
7014,100,0,100,3,6,50.0,2.0,50.0,876
7015,0,0,0,3,7,50.0,2.0,50.0,876
7016,0,50,50,1,0,50.0,2.0,50.0,877
7017,0,100,100,1,1,50.0,2.0,50.0,877
7018,-1,51,50,2,2,50.0,2.0,50.0,877
7019,0,50,50,2,3,50.0,2.0,50.0,877
7020,-4,54,50,3,4,50.0,2.0,50.0,877
7021,0,50,50,3,5,50.0,2.0,50.0,877
7022,0,50,50,3,6,50.0,2.0,50.0,877
7023,0,50,50,3,7,50.0,2.0,50.0,877
7024,-2,67,65,1,0,50.0,2.0,50.0,878
7025,4,67,71,1,1,50.0,2.0,50.0,878
7026,-13,50,37,2,2,50.0,2.0,50.0,878
7027,-9,98,89,2,3,50.0,2.0,50.0,878
7028,0,50,50,3,4,50.0,2.0,50.0,878
7029,7,20,27,3,5,50.0,2.0,50.0,878
7030,0,50,50,3,6,50.0,2.0,50.0,878
7031,0,0,0,3,7,50.0,2.0,50.0,878
7032,6,94,100,1,0,50.0,2.0,50.0,879
7033,5,95,100,1,1,50.0,2.0,50.0,879
7034,0,0,0,2,2,50.0,2.0,50.0,879
7035,0,100,100,2,3,50.0,2.0,50.0,879
7036,100,0,100,3,4,50.0,2.0,50.0,879
7037,100,0,100,3,5,50.0,2.0,50.0,879
7038,40,60,100,3,6,50.0,2.0,50.0,879
7039,100,0,100,3,7,50.0,2.0,50.0,879
7040,0,0,0,1,0,50.0,2.0,50.0,880
7041,0,0,0,1,1,50.0,2.0,50.0,880
7042,-50,50,0,2,2,50.0,2.0,50.0,880
7043,25,0,25,2,3,50.0,2.0,50.0,880
7044,27,50,77,3,4,50.0,2.0,50.0,880
7045,0,0,0,3,5,50.0,2.0,50.0,880
7046,0,50,50,3,6,50.0,2.0,50.0,880
7047,-50,50,0,3,7,50.0,2.0,50.0,880
7048,14,0,14,1,0,50.0,2.0,50.0,881
7049,11,62,73,1,1,50.0,2.0,50.0,881
7050,53,0,53,2,2,50.0,2.0,50.0,881
7051,-50,50,0,2,3,50.0,2.0,50.0,881
7052,19,50,69,3,4,50.0,2.0,50.0,881
7053,7,76,83,3,5,50.0,2.0,50.0,881
7054,11,89,100,3,6,50.0,2.0,50.0,881
7055,85,0,85,3,7,50.0,2.0,50.0,881
7056,0,53,53,1,0,50.0,2.0,50.0,882
7057,0,100,100,1,1,50.0,2.0,50.0,882
7058,-1,51,50,2,2,50.0,2.0,50.0,882
7059,0,50,50,2,3,50.0,2.0,50.0,882
7060,0,50,50,3,4,50.0,2.0,50.0,882
7061,-1,65,64,3,5,50.0,2.0,50.0,882
7062,4,61,65,3,6,50.0,2.0,50.0,882
7063,22,28,50,3,7,50.0,2.0,50.0,882
7064,65,35,100,1,0,50.0,2.0,50.0,883
7065,87,12,99,1,1,50.0,2.0,50.0,883
7066,100,0,100,2,2,50.0,2.0,50.0,883
7067,50,50,100,2,3,50.0,2.0,50.0,883
7068,11,89,100,3,4,50.0,2.0,50.0,883
7069,99,1,100,3,5,50.0,2.0,50.0,883
7070,99,1,100,3,6,50.0,2.0,50.0,883
7071,90,10,100,3,7,50.0,2.0,50.0,883
7072,0,50,50,1,0,50.0,2.0,50.0,884
7073,-28,78,50,1,1,50.0,2.0,50.0,884
7074,7,43,50,2,2,50.0,2.0,50.0,884
7075,5,45,50,2,3,50.0,2.0,50.0,884
7076,27,67,94,3,4,50.0,2.0,50.0,884
7077,16,34,50,3,5,50.0,2.0,50.0,884
7078,59,41,100,3,6,50.0,2.0,50.0,884
7079,38,29,67,3,7,50.0,2.0,50.0,884
7080,25,0,25,1,0,50.0,2.0,50.0,885
7081,0,100,100,1,1,50.0,2.0,50.0,885
7082,0,50,50,2,2,50.0,2.0,50.0,885
7083,0,0,0,2,3,50.0,2.0,50.0,885
7084,1,77,78,3,4,50.0,2.0,50.0,885
7085,28,51,79,3,5,50.0,2.0,50.0,885
7086,3,47,50,3,6,50.0,2.0,50.0,885
7087,0,0,0,3,7,50.0,2.0,50.0,885
7088,0,100,100,1,0,50.0,2.0,50.0,886
7089,100,0,100,1,1,50.0,2.0,50.0,886
7090,100,0,100,2,2,50.0,2.0,50.0,886
7091,0,100,100,2,3,50.0,2.0,50.0,886
7092,0,100,100,3,4,50.0,2.0,50.0,886
7093,97,3,100,3,5,50.0,2.0,50.0,886
7094,0,100,100,3,6,50.0,2.0,50.0,886
7095,0,0,0,3,7,50.0,2.0,50.0,886
7096,0,50,50,1,0,50.0,2.0,50.0,887
7097,-1,14,13,1,1,50.0,2.0,50.0,887
7098,-40,50,10,2,2,50.0,2.0,50.0,887
7099,1,27,28,2,3,50.0,2.0,50.0,887
7100,0,50,50,3,4,50.0,2.0,50.0,887
7101,-28,39,11,3,5,50.0,2.0,50.0,887
7102,-18,50,32,3,6,50.0,2.0,50.0,887
7103,2,7,9,3,7,50.0,2.0,50.0,887
7104,-4,11,7,1,0,50.0,2.0,50.0,888
7105,-19,23,4,1,1,50.0,2.0,50.0,888
7106,3,1,4,2,2,50.0,2.0,50.0,888
7107,4,8,12,2,3,50.0,2.0,50.0,888
7108,33,15,48,3,4,50.0,2.0,50.0,888
7109,0,7,7,3,5,50.0,2.0,50.0,888
7110,-56,63,7,3,6,50.0,2.0,50.0,888
7111,-18,20,2,3,7,50.0,2.0,50.0,888
7112,51,27,78,1,0,50.0,2.0,50.0,889
7113,5,84,89,1,1,50.0,2.0,50.0,889
7114,69,8,77,2,2,50.0,2.0,50.0,889
7115,-1,82,81,2,3,50.0,2.0,50.0,889
7116,4,75,79,3,4,50.0,2.0,50.0,889
7117,54,23,77,3,5,50.0,2.0,50.0,889
7118,4,76,80,3,6,50.0,2.0,50.0,889
7119,47,21,68,3,7,50.0,2.0,50.0,889
7120,27,50,77,1,0,50.0,2.0,50.0,890
7121,46,27,73,1,1,50.0,2.0,50.0,890
7122,27,50,77,2,2,50.0,2.0,50.0,890
7123,29,50,79,2,3,50.0,2.0,50.0,890
7124,25,50,75,3,4,50.0,2.0,50.0,890
7125,36,50,86,3,5,50.0,2.0,50.0,890
7126,63,37,100,3,6,50.0,2.0,50.0,890
7127,79,2,81,3,7,50.0,2.0,50.0,890
7128,50,0,50,1,0,50.0,2.0,50.0,891
7129,22,41,63,1,1,50.0,2.0,50.0,891
7130,0,74,74,2,2,50.0,2.0,50.0,891
7131,10,0,10,2,3,50.0,2.0,50.0,891
7132,2,86,88,3,4,50.0,2.0,50.0,891
7133,52,0,52,3,5,50.0,2.0,50.0,891
7134,0,50,50,3,6,50.0,2.0,50.0,891
7135,-11,40,29,3,7,50.0,2.0,50.0,891
7136,13,31,44,1,0,50.0,2.0,50.0,892
7137,-31,86,55,1,1,50.0,2.0,50.0,892
7138,-21,90,69,2,2,50.0,2.0,50.0,892
7139,2,64,66,2,3,50.0,2.0,50.0,892
7140,8,57,65,3,4,50.0,2.0,50.0,892
7141,-10,60,50,3,5,50.0,2.0,50.0,892
7142,-30,86,56,3,6,50.0,2.0,50.0,892
7143,-2,39,37,3,7,50.0,2.0,50.0,892
7144,51,23,74,1,0,50.0,2.0,50.0,893
7145,32,34,66,1,1,50.0,2.0,50.0,893
7146,41,20,61,2,2,50.0,2.0,50.0,893
7147,55,24,79,2,3,50.0,2.0,50.0,893
7148,24,50,74,3,4,50.0,2.0,50.0,893
7149,52,23,75,3,5,50.0,2.0,50.0,893
7150,57,34,91,3,6,50.0,2.0,50.0,893
7151,-5,21,16,3,7,50.0,2.0,50.0,893
7152,-4,4,0,1,0,50.0,2.0,50.0,894
7153,0,0,0,1,1,50.0,2.0,50.0,894
7154,-25,75,50,2,2,50.0,2.0,50.0,894
7155,62,0,62,2,3,50.0,2.0,50.0,894
7156,-1,51,50,3,4,50.0,2.0,50.0,894
7157,-25,50,25,3,5,50.0,2.0,50.0,894
7158,5,61,66,3,6,50.0,2.0,50.0,894
7159,30,20,50,3,7,50.0,2.0,50.0,894
7160,7,24,31,1,0,50.0,2.0,50.0,895
7161,-4,90,86,1,1,50.0,2.0,50.0,895
7162,0,50,50,2,2,50.0,2.0,50.0,895
7163,-6,40,34,2,3,50.0,2.0,50.0,895
7164,0,66,66,3,4,50.0,2.0,50.0,895
7165,9,58,67,3,5,50.0,2.0,50.0,895
7166,0,50,50,3,6,50.0,2.0,50.0,895
7167,3,32,35,3,7,50.0,2.0,50.0,895
7168,50,50,100,1,0,50.0,2.0,50.0,896
7169,50,50,100,1,1,50.0,2.0,50.0,896
7170,98,0,98,2,2,50.0,2.0,50.0,896
7171,50,50,100,2,3,50.0,2.0,50.0,896
7172,0,100,100,3,4,50.0,2.0,50.0,896
7173,50,50,100,3,5,50.0,2.0,50.0,896
7174,50,50,100,3,6,50.0,2.0,50.0,896
7175,100,0,100,3,7,50.0,2.0,50.0,896
7176,0,50,50,1,0,50.0,2.0,50.0,897
7177,0,90,90,1,1,50.0,2.0,50.0,897
7178,4,0,4,2,2,50.0,2.0,50.0,897
7179,24,26,50,2,3,50.0,2.0,50.0,897
7180,0,50,50,3,4,50.0,2.0,50.0,897
7181,0,50,50,3,5,50.0,2.0,50.0,897
7182,3,72,75,3,6,50.0,2.0,50.0,897
7183,3,0,3,3,7,50.0,2.0,50.0,897
7184,100,0,100,1,0,50.0,2.0,50.0,898
7185,100,0,100,1,1,50.0,2.0,50.0,898
7186,-9,51,42,2,2,50.0,2.0,50.0,898
7187,10,52,62,2,3,50.0,2.0,50.0,898
7188,11,53,64,3,4,50.0,2.0,50.0,898
7189,46,53,99,3,5,50.0,2.0,50.0,898
7190,17,83,100,3,6,50.0,2.0,50.0,898
7191,24,0,24,3,7,50.0,2.0,50.0,898
7192,5,70,75,1,0,50.0,2.0,50.0,899
7193,0,100,100,1,1,50.0,2.0,50.0,899
7194,17,10,27,2,2,50.0,2.0,50.0,899
7195,9,10,19,2,3,50.0,2.0,50.0,899
7196,13,61,74,3,4,50.0,2.0,50.0,899
7197,19,60,79,3,5,50.0,2.0,50.0,899
7198,0,100,100,3,6,50.0,2.0,50.0,899
7199,25,0,25,3,7,50.0,2.0,50.0,899
7200,88,0,88,1,0,50.0,2.0,50.0,900
7201,81,5,86,1,1,50.0,2.0,50.0,900
7202,68,5,73,2,2,50.0,2.0,50.0,900
7203,72,10,82,2,3,50.0,2.0,50.0,900
7204,44,40,84,3,4,50.0,2.0,50.0,900
7205,61,25,86,3,5,50.0,2.0,50.0,900
7206,10,85,95,3,6,50.0,2.0,50.0,900
7207,55,26,81,3,7,50.0,2.0,50.0,900
7208,1,84,85,1,0,50.0,2.0,50.0,901
7209,13,72,85,1,1,50.0,2.0,50.0,901
7210,76,0,76,2,2,50.0,2.0,50.0,901
7211,7,14,21,2,3,50.0,2.0,50.0,901
7212,10,69,79,3,4,50.0,2.0,50.0,901
7213,33,50,83,3,5,50.0,2.0,50.0,901
7214,58,15,73,3,6,50.0,2.0,50.0,901
7215,78,0,78,3,7,50.0,2.0,50.0,901
7216,74,16,90,1,0,50.0,2.0,50.0,902
7217,67,20,87,1,1,50.0,2.0,50.0,902
7218,-10,23,13,2,2,50.0,2.0,50.0,902
7219,57,20,77,2,3,50.0,2.0,50.0,902
7220,14,63,77,3,4,50.0,2.0,50.0,902
7221,76,18,94,3,5,50.0,2.0,50.0,902
7222,18,69,87,3,6,50.0,2.0,50.0,902
7223,81,10,91,3,7,50.0,2.0,50.0,902
7224,12,76,88,1,0,50.0,2.0,50.0,903
7225,0,100,100,1,1,50.0,2.0,50.0,903
7226,51,24,75,2,2,50.0,2.0,50.0,903
7227,-24,100,76,2,3,50.0,2.0,50.0,903
7228,24,76,100,3,4,50.0,2.0,50.0,903
7229,62,0,62,3,5,50.0,2.0,50.0,903
7230,38,50,88,3,6,50.0,2.0,50.0,903
7231,24,0,24,3,7,50.0,2.0,50.0,903
7232,5,0,5,1,0,50.0,2.0,50.0,904
7233,2,50,52,1,1,50.0,2.0,50.0,904
7234,0,50,50,2,2,50.0,2.0,50.0,904
7235,-2,52,50,2,3,50.0,2.0,50.0,904
7236,-3,22,19,3,4,50.0,2.0,50.0,904
7237,0,50,50,3,5,50.0,2.0,50.0,904
7238,0,50,50,3,6,50.0,2.0,50.0,904
7239,1,18,19,3,7,50.0,2.0,50.0,904
7240,49,26,75,1,0,50.0,2.0,50.0,905
7241,27,50,77,1,1,50.0,2.0,50.0,905
7242,52,23,75,2,2,50.0,2.0,50.0,905
7243,50,25,75,2,3,50.0,2.0,50.0,905
7244,25,50,75,3,4,50.0,2.0,50.0,905
7245,25,50,75,3,5,50.0,2.0,50.0,905
7246,53,22,75,3,6,50.0,2.0,50.0,905
7247,61,14,75,3,7,50.0,2.0,50.0,905
7248,25,50,75,1,0,50.0,2.0,50.0,906
7249,0,100,100,1,1,50.0,2.0,50.0,906
7250,50,0,50,2,2,50.0,2.0,50.0,906
7251,-46,82,36,2,3,50.0,2.0,50.0,906
7252,0,50,50,3,4,50.0,2.0,50.0,906
7253,40,51,91,3,5,50.0,2.0,50.0,906
7254,58,42,100,3,6,50.0,2.0,50.0,906
7255,50,0,50,3,7,50.0,2.0,50.0,906
7256,-1,66,65,1,0,50.0,2.0,50.0,907
7257,0,100,100,1,1,50.0,2.0,50.0,907
7258,28,36,64,2,2,50.0,2.0,50.0,907
7259,7,62,69,2,3,50.0,2.0,50.0,907
7260,-7,74,67,3,4,50.0,2.0,50.0,907
7261,-3,34,31,3,5,50.0,2.0,50.0,907
7262,-10,75,65,3,6,50.0,2.0,50.0,907
7263,20,3,23,3,7,50.0,2.0,50.0,907
7264,48,40,88,1,0,50.0,2.0,50.0,908
7265,100,0,100,1,1,50.0,2.0,50.0,908
7266,10,0,10,2,2,50.0,2.0,50.0,908
7267,54,21,75,2,3,50.0,2.0,50.0,908
7268,71,13,84,3,4,50.0,2.0,50.0,908
7269,20,80,100,3,5,50.0,2.0,50.0,908
7270,0,100,100,3,6,50.0,2.0,50.0,908
7271,85,0,85,3,7,50.0,2.0,50.0,908
7272,30,70,100,1,0,50.0,2.0,50.0,909
7273,1,99,100,1,1,50.0,2.0,50.0,909
7274,61,38,99,2,2,50.0,2.0,50.0,909
7275,16,84,100,2,3,50.0,2.0,50.0,909
7276,36,64,100,3,4,50.0,2.0,50.0,909
7277,56,43,99,3,5,50.0,2.0,50.0,909
7278,-42,42,0,3,6,50.0,2.0,50.0,909
7279,69,17,86,3,7,50.0,2.0,50.0,909
7280,17,40,57,1,0,50.0,2.0,50.0,910
7281,37,13,50,1,1,50.0,2.0,50.0,910
7282,-8,58,50,2,2,50.0,2.0,50.0,910
7283,-4,88,84,2,3,50.0,2.0,50.0,910
7284,34,52,86,3,4,50.0,2.0,50.0,910
7285,32,50,82,3,5,50.0,2.0,50.0,910
7286,53,23,76,3,6,50.0,2.0,50.0,910
7287,32,40,72,3,7,50.0,2.0,50.0,910
7288,0,0,0,1,0,50.0,2.0,50.0,911
7289,0,0,0,1,1,50.0,2.0,50.0,911
7290,0,0,0,2,2,50.0,2.0,50.0,911
7291,0,100,100,2,3,50.0,2.0,50.0,911
7292,0,50,50,3,4,50.0,2.0,50.0,911
7293,0,0,0,3,5,50.0,2.0,50.0,911
7294,-100,100,0,3,6,50.0,2.0,50.0,911
7295,0,0,0,3,7,50.0,2.0,50.0,911
7296,-12,68,56,1,0,50.0,2.0,50.0,912
7297,0,0,0,1,1,50.0,2.0,50.0,912
7298,0,50,50,2,2,50.0,2.0,50.0,912
7299,-37,76,39,2,3,50.0,2.0,50.0,912
7300,0,50,50,3,4,50.0,2.0,50.0,912
7301,5,45,50,3,5,50.0,2.0,50.0,912
7302,5,45,50,3,6,50.0,2.0,50.0,912
7303,25,25,50,3,7,50.0,2.0,50.0,912
7304,55,24,79,1,0,50.0,2.0,50.0,913
7305,0,50,50,1,1,50.0,2.0,50.0,913
7306,10,50,60,2,2,50.0,2.0,50.0,913
7307,27,50,77,2,3,50.0,2.0,50.0,913
7308,0,50,50,3,4,50.0,2.0,50.0,913
7309,0,50,50,3,5,50.0,2.0,50.0,913
7310,25,25,50,3,6,50.0,2.0,50.0,913
7311,37,50,87,3,7,50.0,2.0,50.0,913
7312,3,14,17,1,0,50.0,2.0,50.0,914
7313,-8,18,10,1,1,50.0,2.0,50.0,914
7314,32,50,82,2,2,50.0,2.0,50.0,914
7315,-9,96,87,2,3,50.0,2.0,50.0,914
7316,0,77,77,3,4,50.0,2.0,50.0,914
7317,13,37,50,3,5,50.0,2.0,50.0,914
7318,-2,38,36,3,6,50.0,2.0,50.0,914
7319,0,50,50,3,7,50.0,2.0,50.0,914
7320,0,100,100,1,0,50.0,2.0,50.0,915
7321,3,97,100,1,1,50.0,2.0,50.0,915
7322,-8,27,19,2,2,50.0,2.0,50.0,915
7323,34,32,66,2,3,50.0,2.0,50.0,915
7324,-28,59,31,3,4,50.0,2.0,50.0,915
7325,-12,51,39,3,5,50.0,2.0,50.0,915
7326,78,22,100,3,6,50.0,2.0,50.0,915
7327,0,0,0,3,7,50.0,2.0,50.0,915
7328,-1,1,0,1,0,50.0,2.0,50.0,916
7329,93,5,98,1,1,50.0,2.0,50.0,916
7330,-2,52,50,2,2,50.0,2.0,50.0,916
7331,-85,90,5,2,3,50.0,2.0,50.0,916
7332,0,62,62,3,4,50.0,2.0,50.0,916
7333,2,3,5,3,5,50.0,2.0,50.0,916
7334,0,0,0,3,6,50.0,2.0,50.0,916
7335,7,0,7,3,7,50.0,2.0,50.0,916
7336,0,50,50,1,0,50.0,2.0,50.0,917
7337,0,50,50,1,1,50.0,2.0,50.0,917
7338,0,50,50,2,2,50.0,2.0,50.0,917
7339,0,50,50,2,3,50.0,2.0,50.0,917
7340,6,51,57,3,4,50.0,2.0,50.0,917
7341,-6,62,56,3,5,50.0,2.0,50.0,917
7342,0,100,100,3,6,50.0,2.0,50.0,917
7343,1,29,30,3,7,50.0,2.0,50.0,917
7344,50,50,100,1,0,50.0,2.0,50.0,918
7345,47,21,68,1,1,50.0,2.0,50.0,918
7346,43,50,93,2,2,50.0,2.0,50.0,918
7347,-67,67,0,2,3,50.0,2.0,50.0,918
7348,26,74,100,3,4,50.0,2.0,50.0,918
7349,37,13,50,3,5,50.0,2.0,50.0,918
7350,9,91,100,3,6,50.0,2.0,50.0,918
7351,100,0,100,3,7,50.0,2.0,50.0,918
7352,15,75,90,1,0,50.0,2.0,50.0,919
7353,0,100,100,1,1,50.0,2.0,50.0,919
7354,-17,31,14,2,2,50.0,2.0,50.0,919
7355,-23,35,12,2,3,50.0,2.0,50.0,919
7356,-5,30,25,3,4,50.0,2.0,50.0,919
7357,-4,25,21,3,5,50.0,2.0,50.0,919
7358,55,45,100,3,6,50.0,2.0,50.0,919
7359,6,74,80,3,7,50.0,2.0,50.0,919
7360,22,66,88,1,0,50.0,2.0,50.0,920
7361,78,3,81,1,1,50.0,2.0,50.0,920
7362,22,51,73,2,2,50.0,2.0,50.0,920
7363,51,27,78,2,3,50.0,2.0,50.0,920
7364,19,64,83,3,4,50.0,2.0,50.0,920
7365,64,12,76,3,5,50.0,2.0,50.0,920
7366,30,50,80,3,6,50.0,2.0,50.0,920
7367,12,12,24,3,7,50.0,2.0,50.0,920
7368,23,1,24,1,0,50.0,2.0,50.0,921
7369,10,22,32,1,1,50.0,2.0,50.0,921
7370,43,33,76,2,2,50.0,2.0,50.0,921
7371,-62,86,24,2,3,50.0,2.0,50.0,921
7372,33,41,74,3,4,50.0,2.0,50.0,921
7373,79,0,79,3,5,50.0,2.0,50.0,921
7374,-41,76,35,3,6,50.0,2.0,50.0,921
7375,54,22,76,3,7,50.0,2.0,50.0,921
7376,0,100,100,1,0,50.0,2.0,50.0,922
7377,0,100,100,1,1,50.0,2.0,50.0,922
7378,0,0,0,2,2,50.0,2.0,50.0,922
7379,0,0,0,2,3,50.0,2.0,50.0,922
7380,0,50,50,3,4,50.0,2.0,50.0,922
7381,0,0,0,3,5,50.0,2.0,50.0,922
7382,0,100,100,3,6,50.0,2.0,50.0,922
7383,50,0,50,3,7,50.0,2.0,50.0,922
7384,0,50,50,1,0,50.0,2.0,50.0,923
7385,0,50,50,1,1,50.0,2.0,50.0,923
7386,0,50,50,2,2,50.0,2.0,50.0,923
7387,0,50,50,2,3,50.0,2.0,50.0,923
7388,10,80,90,3,4,50.0,2.0,50.0,923
7389,-19,49,30,3,5,50.0,2.0,50.0,923
7390,3,77,80,3,6,50.0,2.0,50.0,923
7391,-1,51,50,3,7,50.0,2.0,50.0,923
7392,26,50,76,1,0,50.0,2.0,50.0,924
7393,32,50,82,1,1,50.0,2.0,50.0,924
7394,23,33,56,2,2,50.0,2.0,50.0,924
7395,62,13,75,2,3,50.0,2.0,50.0,924
7396,45,50,95,3,4,50.0,2.0,50.0,924
7397,0,32,32,3,5,50.0,2.0,50.0,924
7398,17,63,80,3,6,50.0,2.0,50.0,924
7399,23,8,31,3,7,50.0,2.0,50.0,924
7400,0,100,100,1,0,50.0,2.0,50.0,925
7401,0,100,100,1,1,50.0,2.0,50.0,925
7402,100,0,100,2,2,50.0,2.0,50.0,925
7403,-100,100,0,2,3,50.0,2.0,50.0,925
7404,28,72,100,3,4,50.0,2.0,50.0,925
7405,-36,36,0,3,5,50.0,2.0,50.0,925
7406,29,71,100,3,6,50.0,2.0,50.0,925
7407,100,0,100,3,7,50.0,2.0,50.0,925
7408,1,49,50,1,0,50.0,2.0,50.0,926
7409,21,36,57,1,1,50.0,2.0,50.0,926
7410,21,28,49,2,2,50.0,2.0,50.0,926
7411,-21,71,50,2,3,50.0,2.0,50.0,926
7412,-1,50,49,3,4,50.0,2.0,50.0,926
7413,1,49,50,3,5,50.0,2.0,50.0,926
7414,22,72,94,3,6,50.0,2.0,50.0,926
7415,37,12,49,3,7,50.0,2.0,50.0,926
7416,-1,38,37,1,0,50.0,2.0,50.0,927
7417,3,72,75,1,1,50.0,2.0,50.0,927
7418,0,50,50,2,2,50.0,2.0,50.0,927
7419,-26,65,39,2,3,50.0,2.0,50.0,927
7420,1,63,64,3,4,50.0,2.0,50.0,927
7421,0,50,50,3,5,50.0,2.0,50.0,927
7422,25,40,65,3,6,50.0,2.0,50.0,927
7423,-7,50,43,3,7,50.0,2.0,50.0,927
7424,51,49,100,1,0,50.0,2.0,50.0,928
7425,38,62,100,1,1,50.0,2.0,50.0,928
7426,50,50,100,2,2,50.0,2.0,50.0,928
7427,24,76,100,2,3,50.0,2.0,50.0,928
7428,74,26,100,3,4,50.0,2.0,50.0,928
7429,51,49,100,3,5,50.0,2.0,50.0,928
7430,69,31,100,3,6,50.0,2.0,50.0,928
7431,50,50,100,3,7,50.0,2.0,50.0,928
7432,15,50,65,1,0,50.0,2.0,50.0,929
7433,20,45,65,1,1,50.0,2.0,50.0,929
7434,10,50,60,2,2,50.0,2.0,50.0,929
7435,25,50,75,2,3,50.0,2.0,50.0,929
7436,5,85,90,3,4,50.0,2.0,50.0,929
7437,40,36,76,3,5,50.0,2.0,50.0,929
7438,-6,80,74,3,6,50.0,2.0,50.0,929
7439,-16,16,0,3,7,50.0,2.0,50.0,929
7440,0,50,50,1,0,50.0,2.0,50.0,930
7441,26,24,50,1,1,50.0,2.0,50.0,930
7442,0,50,50,2,2,50.0,2.0,50.0,930
7443,25,32,57,2,3,50.0,2.0,50.0,930
7444,0,50,50,3,4,50.0,2.0,50.0,930
7445,3,47,50,3,5,50.0,2.0,50.0,930
7446,0,50,50,3,6,50.0,2.0,50.0,930
7447,0,50,50,3,7,50.0,2.0,50.0,930
7448,24,76,100,1,0,50.0,2.0,50.0,931
7449,92,8,100,1,1,50.0,2.0,50.0,931
7450,35,65,100,2,2,50.0,2.0,50.0,931
7451,0,100,100,2,3,50.0,2.0,50.0,931
7452,20,80,100,3,4,50.0,2.0,50.0,931
7453,73,27,100,3,5,50.0,2.0,50.0,931
7454,11,89,100,3,6,50.0,2.0,50.0,931
7455,50,50,100,3,7,50.0,2.0,50.0,931
7456,38,62,100,1,0,50.0,2.0,50.0,932
7457,21,79,100,1,1,50.0,2.0,50.0,932
7458,70,30,100,2,2,50.0,2.0,50.0,932
7459,94,6,100,2,3,50.0,2.0,50.0,932
7460,60,40,100,3,4,50.0,2.0,50.0,932
7461,100,0,100,3,5,50.0,2.0,50.0,932
7462,32,68,100,3,6,50.0,2.0,50.0,932
7463,95,5,100,3,7,50.0,2.0,50.0,932
7464,70,30,100,1,0,50.0,2.0,50.0,933
7465,0,100,100,1,1,50.0,2.0,50.0,933
7466,35,15,50,2,2,50.0,2.0,50.0,933
7467,42,58,100,2,3,50.0,2.0,50.0,933
7468,19,81,100,3,4,50.0,2.0,50.0,933
7469,50,50,100,3,5,50.0,2.0,50.0,933
7470,100,0,100,3,6,50.0,2.0,50.0,933
7471,80,20,100,3,7,50.0,2.0,50.0,933
7472,77,23,100,1,0,50.0,2.0,50.0,934
7473,91,9,100,1,1,50.0,2.0,50.0,934
7474,50,50,100,2,2,50.0,2.0,50.0,934
7475,50,50,100,2,3,50.0,2.0,50.0,934
7476,63,37,100,3,4,50.0,2.0,50.0,934
7477,50,50,100,3,5,50.0,2.0,50.0,934
7478,50,50,100,3,6,50.0,2.0,50.0,934
7479,99,1,100,3,7,50.0,2.0,50.0,934
7480,0,100,100,1,0,50.0,2.0,50.0,935
7481,0,0,0,1,1,50.0,2.0,50.0,935
7482,-3,21,18,2,2,50.0,2.0,50.0,935
7483,-95,95,0,2,3,50.0,2.0,50.0,935
7484,0,100,100,3,4,50.0,2.0,50.0,935
7485,-38,38,0,3,5,50.0,2.0,50.0,935
7486,0,0,0,3,6,50.0,2.0,50.0,935
7487,5,24,29,3,7,50.0,2.0,50.0,935
7488,-1,41,40,1,0,50.0,2.0,50.0,936
7489,2,89,91,1,1,50.0,2.0,50.0,936
7490,-1,23,22,2,2,50.0,2.0,50.0,936
7491,50,21,71,2,3,50.0,2.0,50.0,936
7492,5,62,67,3,4,50.0,2.0,50.0,936
7493,18,40,58,3,5,50.0,2.0,50.0,936
7494,-8,72,64,3,6,50.0,2.0,50.0,936
7495,53,25,78,3,7,50.0,2.0,50.0,936
7496,83,12,95,1,0,50.0,2.0,50.0,937
7497,88,2,90,1,1,50.0,2.0,50.0,937
7498,45,50,95,2,2,50.0,2.0,50.0,937
7499,5,95,100,2,3,50.0,2.0,50.0,937
7500,4,96,100,3,4,50.0,2.0,50.0,937
7501,77,23,100,3,5,50.0,2.0,50.0,937
7502,9,91,100,3,6,50.0,2.0,50.0,937
7503,97,0,97,3,7,50.0,2.0,50.0,937
7504,34,34,68,1,0,50.0,2.0,50.0,938
7505,13,69,82,1,1,50.0,2.0,50.0,938
7506,-9,69,60,2,2,50.0,2.0,50.0,938
7507,4,72,76,2,3,50.0,2.0,50.0,938
7508,54,37,91,3,4,50.0,2.0,50.0,938
7509,65,23,88,3,5,50.0,2.0,50.0,938
7510,41,37,78,3,6,50.0,2.0,50.0,938
7511,47,38,85,3,7,50.0,2.0,50.0,938
7512,39,50,89,1,0,50.0,2.0,50.0,939
7513,23,76,99,1,1,50.0,2.0,50.0,939
7514,23,50,73,2,2,50.0,2.0,50.0,939
7515,78,12,90,2,3,50.0,2.0,50.0,939
7516,47,46,93,3,4,50.0,2.0,50.0,939
7517,40,50,90,3,5,50.0,2.0,50.0,939
7518,22,74,96,3,6,50.0,2.0,50.0,939
7519,29,50,79,3,7,50.0,2.0,50.0,939
7520,47,36,83,1,0,50.0,2.0,50.0,940
7521,17,83,100,1,1,50.0,2.0,50.0,940
7522,21,58,79,2,2,50.0,2.0,50.0,940
7523,39,41,80,2,3,50.0,2.0,50.0,940
7524,30,58,88,3,4,50.0,2.0,50.0,940
7525,36,50,86,3,5,50.0,2.0,50.0,940
7526,28,72,100,3,6,50.0,2.0,50.0,940
7527,33,50,83,3,7,50.0,2.0,50.0,940
7528,16,0,16,1,0,50.0,2.0,50.0,941
7529,0,50,50,1,1,50.0,2.0,50.0,941
7530,-4,87,83,2,2,50.0,2.0,50.0,941
7531,12,68,80,2,3,50.0,2.0,50.0,941
7532,-1,24,23,3,4,50.0,2.0,50.0,941
7533,0,50,50,3,5,50.0,2.0,50.0,941
7534,0,38,38,3,6,50.0,2.0,50.0,941
7535,10,50,60,3,7,50.0,2.0,50.0,941
7536,89,0,89,1,0,50.0,2.0,50.0,942
7537,8,91,99,1,1,50.0,2.0,50.0,942
7538,65,24,89,2,2,50.0,2.0,50.0,942
7539,63,25,88,2,3,50.0,2.0,50.0,942
7540,10,90,100,3,4,50.0,2.0,50.0,942
7541,88,0,88,3,5,50.0,2.0,50.0,942
7542,80,12,92,3,6,50.0,2.0,50.0,942
7543,91,0,91,3,7,50.0,2.0,50.0,942
7544,19,56,75,1,0,50.0,2.0,50.0,943
7545,37,63,100,1,1,50.0,2.0,50.0,943
7546,38,1,39,2,2,50.0,2.0,50.0,943
7547,32,4,36,2,3,50.0,2.0,50.0,943
7548,7,52,59,3,4,50.0,2.0,50.0,943
7549,54,5,59,3,5,50.0,2.0,50.0,943
7550,5,93,98,3,6,50.0,2.0,50.0,943
7551,11,22,33,3,7,50.0,2.0,50.0,943
7552,50,50,100,1,0,50.0,2.0,50.0,944
7553,100,0,100,1,1,50.0,2.0,50.0,944
7554,0,50,50,2,2,50.0,2.0,50.0,944
7555,0,50,50,2,3,50.0,2.0,50.0,944
7556,0,100,100,3,4,50.0,2.0,50.0,944
7557,50,50,100,3,5,50.0,2.0,50.0,944
7558,100,0,100,3,6,50.0,2.0,50.0,944
7559,100,0,100,3,7,50.0,2.0,50.0,944
7560,5,89,94,1,0,50.0,2.0,50.0,945
7561,52,0,52,1,1,50.0,2.0,50.0,945
7562,63,1,64,2,2,50.0,2.0,50.0,945
7563,61,1,62,2,3,50.0,2.0,50.0,945
7564,2,90,92,3,4,50.0,2.0,50.0,945
7565,-20,90,70,3,5,50.0,2.0,50.0,945
7566,10,90,100,3,6,50.0,2.0,50.0,945
7567,66,0,66,3,7,50.0,2.0,50.0,945
7568,60,40,100,1,0,50.0,2.0,50.0,946
7569,0,100,100,1,1,50.0,2.0,50.0,946
7570,10,80,90,2,2,50.0,2.0,50.0,946
7571,2,63,65,2,3,50.0,2.0,50.0,946
7572,32,65,97,3,4,50.0,2.0,50.0,946
7573,0,100,100,3,5,50.0,2.0,50.0,946
7574,0,100,100,3,6,50.0,2.0,50.0,946
7575,76,8,84,3,7,50.0,2.0,50.0,946
7576,100,0,100,1,0,50.0,2.0,50.0,947
7577,97,3,100,1,1,50.0,2.0,50.0,947
7578,100,0,100,2,2,50.0,2.0,50.0,947
7579,67,33,100,2,3,50.0,2.0,50.0,947
7580,37,63,100,3,4,50.0,2.0,50.0,947
7581,100,0,100,3,5,50.0,2.0,50.0,947
7582,64,36,100,3,6,50.0,2.0,50.0,947
7583,100,0,100,3,7,50.0,2.0,50.0,947
7584,0,50,50,1,0,50.0,2.0,50.0,948
7585,15,75,90,1,1,50.0,2.0,50.0,948
7586,-20,50,30,2,2,50.0,2.0,50.0,948
7587,25,50,75,2,3,50.0,2.0,50.0,948
7588,45,50,95,3,4,50.0,2.0,50.0,948
7589,49,41,90,3,5,50.0,2.0,50.0,948
7590,45,30,75,3,6,50.0,2.0,50.0,948
7591,50,25,75,3,7,50.0,2.0,50.0,948
7592,0,50,50,1,0,50.0,2.0,50.0,949
7593,100,0,100,1,1,50.0,2.0,50.0,949
7594,0,0,0,2,2,50.0,2.0,50.0,949
7595,-25,50,25,2,3,50.0,2.0,50.0,949
7596,0,100,100,3,4,50.0,2.0,50.0,949
7597,25,25,50,3,5,50.0,2.0,50.0,949
7598,25,0,25,3,6,50.0,2.0,50.0,949
7599,0,0,0,3,7,50.0,2.0,50.0,949
7600,-33,83,50,1,0,50.0,2.0,50.0,950
7601,19,50,69,1,1,50.0,2.0,50.0,950
7602,0,50,50,2,2,50.0,2.0,50.0,950
7603,-9,59,50,2,3,50.0,2.0,50.0,950
7604,1,65,66,3,4,50.0,2.0,50.0,950
7605,20,50,70,3,5,50.0,2.0,50.0,950
7606,0,50,50,3,6,50.0,2.0,50.0,950
7607,1,50,51,3,7,50.0,2.0,50.0,950
7608,5,60,65,1,0,50.0,2.0,50.0,951
7609,10,65,75,1,1,50.0,2.0,50.0,951
7610,0,25,25,2,2,50.0,2.0,50.0,951
7611,-8,73,65,2,3,50.0,2.0,50.0,951
7612,25,50,75,3,4,50.0,2.0,50.0,951
7613,0,50,50,3,5,50.0,2.0,50.0,951
7614,-10,35,25,3,6,50.0,2.0,50.0,951
7615,12,13,25,3,7,50.0,2.0,50.0,951
7616,79,10,89,1,0,50.0,2.0,50.0,952
7617,67,11,78,1,1,50.0,2.0,50.0,952
7618,50,50,100,2,2,50.0,2.0,50.0,952
7619,16,84,100,2,3,50.0,2.0,50.0,952
7620,5,95,100,3,4,50.0,2.0,50.0,952
7621,45,39,84,3,5,50.0,2.0,50.0,952
7622,50,25,75,3,6,50.0,2.0,50.0,952
7623,90,10,100,3,7,50.0,2.0,50.0,952
7624,0,100,100,1,0,50.0,2.0,50.0,953
7625,0,0,0,1,1,50.0,2.0,50.0,953
7626,0,0,0,2,2,50.0,2.0,50.0,953
7627,0,0,0,2,3,50.0,2.0,50.0,953
7628,-57,99,42,3,4,50.0,2.0,50.0,953
7629,0,0,0,3,5,50.0,2.0,50.0,953
7630,0,100,100,3,6,50.0,2.0,50.0,953
7631,0,0,0,3,7,50.0,2.0,50.0,953
7632,30,50,80,1,0,50.0,2.0,50.0,954
7633,60,32,92,1,1,50.0,2.0,50.0,954
7634,29,54,83,2,2,50.0,2.0,50.0,954
7635,31,50,81,2,3,50.0,2.0,50.0,954
7636,43,50,93,3,4,50.0,2.0,50.0,954
7637,39,50,89,3,5,50.0,2.0,50.0,954
7638,35,50,85,3,6,50.0,2.0,50.0,954
7639,75,16,91,3,7,50.0,2.0,50.0,954
7640,1,49,50,1,0,50.0,2.0,50.0,955
7641,2,10,12,1,1,50.0,2.0,50.0,955
7642,0,50,50,2,2,50.0,2.0,50.0,955
7643,25,50,75,2,3,50.0,2.0,50.0,955
7644,0,50,50,3,4,50.0,2.0,50.0,955
7645,0,50,50,3,5,50.0,2.0,50.0,955
7646,-38,50,12,3,6,50.0,2.0,50.0,955
7647,0,50,50,3,7,50.0,2.0,50.0,955
7648,17,69,86,1,0,50.0,2.0,50.0,956
7649,0,100,100,1,1,50.0,2.0,50.0,956
7650,13,7,20,2,2,50.0,2.0,50.0,956
7651,10,8,18,2,3,50.0,2.0,50.0,956
7652,32,49,81,3,4,50.0,2.0,50.0,956
7653,42,46,88,3,5,50.0,2.0,50.0,956
7654,15,49,64,3,6,50.0,2.0,50.0,956
7655,59,37,96,3,7,50.0,2.0,50.0,956
7656,12,88,100,1,0,50.0,2.0,50.0,957
7657,0,100,100,1,1,50.0,2.0,50.0,957
7658,50,0,50,2,2,50.0,2.0,50.0,957
7659,50,50,100,2,3,50.0,2.0,50.0,957
7660,-25,28,3,3,4,50.0,2.0,50.0,957
7661,26,50,76,3,5,50.0,2.0,50.0,957
7662,1,49,50,3,6,50.0,2.0,50.0,957
7663,-1,51,50,3,7,50.0,2.0,50.0,957
7664,0,50,50,1,0,50.0,2.0,50.0,958
7665,0,5,5,1,1,50.0,2.0,50.0,958
7666,0,50,50,2,2,50.0,2.0,50.0,958
7667,0,50,50,2,3,50.0,2.0,50.0,958
7668,30,65,95,3,4,50.0,2.0,50.0,958
7669,40,50,90,3,5,50.0,2.0,50.0,958
7670,40,40,80,3,6,50.0,2.0,50.0,958
7671,45,45,90,3,7,50.0,2.0,50.0,958
7672,0,0,0,1,0,50.0,2.0,50.0,959
7673,0,0,0,1,1,50.0,2.0,50.0,959
7674,30,50,80,2,2,50.0,2.0,50.0,959
7675,0,100,100,2,3,50.0,2.0,50.0,959
7676,7,43,50,3,4,50.0,2.0,50.0,959
7677,27,50,77,3,5,50.0,2.0,50.0,959
7678,8,12,20,3,6,50.0,2.0,50.0,959
7679,4,10,14,3,7,50.0,2.0,50.0,959
7680,15,85,100,1,0,50.0,2.0,50.0,960
7681,10,90,100,1,1,50.0,2.0,50.0,960
7682,100,0,100,2,2,50.0,2.0,50.0,960
7683,100,0,100,2,3,50.0,2.0,50.0,960
7684,100,0,100,3,4,50.0,2.0,50.0,960
7685,75,25,100,3,5,50.0,2.0,50.0,960
7686,75,25,100,3,6,50.0,2.0,50.0,960
7687,0,100,100,3,7,50.0,2.0,50.0,960
7688,15,53,68,1,0,50.0,2.0,50.0,961
7689,38,62,100,1,1,50.0,2.0,50.0,961
7690,49,0,49,2,2,50.0,2.0,50.0,961
7691,49,0,49,2,3,50.0,2.0,50.0,961
7692,15,85,100,3,4,50.0,2.0,50.0,961
7693,46,26,72,3,5,50.0,2.0,50.0,961
7694,9,40,49,3,6,50.0,2.0,50.0,961
7695,0,0,0,3,7,50.0,2.0,50.0,961
7696,14,50,64,1,0,50.0,2.0,50.0,962
7697,35,37,72,1,1,50.0,2.0,50.0,962
7698,22,44,66,2,2,50.0,2.0,50.0,962
7699,31,33,64,2,3,50.0,2.0,50.0,962
7700,10,50,60,3,4,50.0,2.0,50.0,962
7701,3,59,62,3,5,50.0,2.0,50.0,962
7702,28,50,78,3,6,50.0,2.0,50.0,962
7703,32,40,72,3,7,50.0,2.0,50.0,962
7704,50,50,100,1,0,50.0,2.0,50.0,963
7705,-50,50,0,1,1,50.0,2.0,50.0,963
7706,0,0,0,2,2,50.0,2.0,50.0,963
7707,19,81,100,2,3,50.0,2.0,50.0,963
7708,-50,50,0,3,4,50.0,2.0,50.0,963
7709,49,51,100,3,5,50.0,2.0,50.0,963
7710,-50,50,0,3,6,50.0,2.0,50.0,963
7711,0,0,0,3,7,50.0,2.0,50.0,963
7712,27,46,73,1,0,50.0,2.0,50.0,964
7713,-7,68,61,1,1,50.0,2.0,50.0,964
7714,23,5,28,2,2,50.0,2.0,50.0,964
7715,-7,34,27,2,3,50.0,2.0,50.0,964
7716,26,1,27,3,4,50.0,2.0,50.0,964
7717,29,3,32,3,5,50.0,2.0,50.0,964
7718,3,66,69,3,6,50.0,2.0,50.0,964
7719,30,1,31,3,7,50.0,2.0,50.0,964
7720,27,56,83,1,0,50.0,2.0,50.0,965
7721,0,100,100,1,1,50.0,2.0,50.0,965
7722,12,50,62,2,2,50.0,2.0,50.0,965
7723,3,75,78,2,3,50.0,2.0,50.0,965
7724,43,43,86,3,4,50.0,2.0,50.0,965
7725,19,49,68,3,5,50.0,2.0,50.0,965
7726,61,39,100,3,6,50.0,2.0,50.0,965
7727,52,25,77,3,7,50.0,2.0,50.0,965
7728,64,0,64,1,0,50.0,2.0,50.0,966
7729,-13,50,37,1,1,50.0,2.0,50.0,966
7730,-28,100,72,2,2,50.0,2.0,50.0,966
7731,17,50,67,2,3,50.0,2.0,50.0,966
7732,18,50,68,3,4,50.0,2.0,50.0,966
7733,-15,50,35,3,5,50.0,2.0,50.0,966
7734,19,0,19,3,6,50.0,2.0,50.0,966
7735,14,0,14,3,7,50.0,2.0,50.0,966
7736,11,79,90,1,0,50.0,2.0,50.0,967
7737,-1,91,90,1,1,50.0,2.0,50.0,967
7738,-4,13,9,2,2,50.0,2.0,50.0,967
7739,4,9,13,2,3,50.0,2.0,50.0,967
7740,0,40,40,3,4,50.0,2.0,50.0,967
7741,32,18,50,3,5,50.0,2.0,50.0,967
7742,-4,93,89,3,6,50.0,2.0,50.0,967
7743,-6,16,10,3,7,50.0,2.0,50.0,967
7744,-8,58,50,1,0,50.0,2.0,50.0,968
7745,5,45,50,1,1,50.0,2.0,50.0,968
7746,0,50,50,2,2,50.0,2.0,50.0,968
7747,0,50,50,2,3,50.0,2.0,50.0,968
7748,0,50,50,3,4,50.0,2.0,50.0,968
7749,-5,55,50,3,5,50.0,2.0,50.0,968
7750,0,50,50,3,6,50.0,2.0,50.0,968
7751,0,50,50,3,7,50.0,2.0,50.0,968
7752,24,58,82,1,0,50.0,2.0,50.0,969
7753,18,72,90,1,1,50.0,2.0,50.0,969
7754,11,51,62,2,2,50.0,2.0,50.0,969
7755,33,23,56,2,3,50.0,2.0,50.0,969
7756,39,54,93,3,4,50.0,2.0,50.0,969
7757,62,28,90,3,5,50.0,2.0,50.0,969
7758,14,40,54,3,6,50.0,2.0,50.0,969
7759,58,0,58,3,7,50.0,2.0,50.0,969
7760,0,50,50,1,0,50.0,2.0,50.0,970
7761,6,40,46,1,1,50.0,2.0,50.0,970
7762,3,43,46,2,2,50.0,2.0,50.0,970
7763,0,50,50,2,3,50.0,2.0,50.0,970
7764,25,20,45,3,4,50.0,2.0,50.0,970
7765,10,50,60,3,5,50.0,2.0,50.0,970
7766,0,0,0,3,6,50.0,2.0,50.0,970
7767,0,0,0,3,7,50.0,2.0,50.0,970
7768,5,50,55,1,0,50.0,2.0,50.0,971
7769,10,70,80,1,1,50.0,2.0,50.0,971
7770,15,75,90,2,2,50.0,2.0,50.0,971
7771,15,75,90,2,3,50.0,2.0,50.0,971
7772,65,10,75,3,4,50.0,2.0,50.0,971
7773,55,0,55,3,5,50.0,2.0,50.0,971
7774,40,50,90,3,6,50.0,2.0,50.0,971
7775,51,0,51,3,7,50.0,2.0,50.0,971
7776,0,50,50,1,0,50.0,2.0,50.0,972
7777,16,50,66,1,1,50.0,2.0,50.0,972
7778,50,0,50,2,2,50.0,2.0,50.0,972
7779,0,50,50,2,3,50.0,2.0,50.0,972
7780,16,50,66,3,4,50.0,2.0,50.0,972
7781,19,50,69,3,5,50.0,2.0,50.0,972
7782,5,45,50,3,6,50.0,2.0,50.0,972
7783,19,0,19,3,7,50.0,2.0,50.0,972
7784,50,35,85,1,0,50.0,2.0,50.0,973
7785,30,65,95,1,1,50.0,2.0,50.0,973
7786,14,21,35,2,2,50.0,2.0,50.0,973
7787,55,30,85,2,3,50.0,2.0,50.0,973
7788,13,60,73,3,4,50.0,2.0,50.0,973
7789,60,35,95,3,5,50.0,2.0,50.0,973
7790,6,94,100,3,6,50.0,2.0,50.0,973
7791,80,10,90,3,7,50.0,2.0,50.0,973
7792,16,50,66,1,0,50.0,2.0,50.0,974
7793,30,67,97,1,1,50.0,2.0,50.0,974
7794,-13,50,37,2,2,50.0,2.0,50.0,974
7795,22,50,72,2,3,50.0,2.0,50.0,974
7796,0,69,69,3,4,50.0,2.0,50.0,974
7797,17,56,73,3,5,50.0,2.0,50.0,974
7798,0,100,100,3,6,50.0,2.0,50.0,974
7799,18,50,68,3,7,50.0,2.0,50.0,974
7800,2,50,52,1,0,50.0,2.0,50.0,975
7801,0,100,100,1,1,50.0,2.0,50.0,975
7802,0,50,50,2,2,50.0,2.0,50.0,975
7803,0,50,50,2,3,50.0,2.0,50.0,975
7804,-50,100,50,3,4,50.0,2.0,50.0,975
7805,0,100,100,3,5,50.0,2.0,50.0,975
7806,6,42,48,3,6,50.0,2.0,50.0,975
7807,0,100,100,3,7,50.0,2.0,50.0,975
7808,45,45,90,1,0,50.0,2.0,50.0,976
7809,97,0,97,1,1,50.0,2.0,50.0,976
7810,41,44,85,2,2,50.0,2.0,50.0,976
7811,39,50,89,2,3,50.0,2.0,50.0,976
7812,10,75,85,3,4,50.0,2.0,50.0,976
7813,94,0,94,3,5,50.0,2.0,50.0,976
7814,56,44,100,3,6,50.0,2.0,50.0,976
7815,14,0,14,3,7,50.0,2.0,50.0,976
7816,50,50,100,1,0,50.0,2.0,50.0,977
7817,100,0,100,1,1,50.0,2.0,50.0,977
7818,35,65,100,2,2,50.0,2.0,50.0,977
7819,39,61,100,2,3,50.0,2.0,50.0,977
7820,77,23,100,3,4,50.0,2.0,50.0,977
7821,100,0,100,3,5,50.0,2.0,50.0,977
7822,50,50,100,3,6,50.0,2.0,50.0,977
7823,100,0,100,3,7,50.0,2.0,50.0,977
7824,0,50,50,1,0,50.0,2.0,50.0,978
7825,0,50,50,1,1,50.0,2.0,50.0,978
7826,0,50,50,2,2,50.0,2.0,50.0,978
7827,0,50,50,2,3,50.0,2.0,50.0,978
7828,0,50,50,3,4,50.0,2.0,50.0,978
7829,0,50,50,3,5,50.0,2.0,50.0,978
7830,0,50,50,3,6,50.0,2.0,50.0,978
7831,0,50,50,3,7,50.0,2.0,50.0,978
7832,86,14,100,1,0,50.0,2.0,50.0,979
7833,-29,29,0,1,1,50.0,2.0,50.0,979
7834,50,50,100,2,2,50.0,2.0,50.0,979
7835,34,66,100,2,3,50.0,2.0,50.0,979
7836,40,60,100,3,4,50.0,2.0,50.0,979
7837,62,38,100,3,5,50.0,2.0,50.0,979
7838,60,40,100,3,6,50.0,2.0,50.0,979
7839,50,50,100,3,7,50.0,2.0,50.0,979
7840,1,99,100,1,0,50.0,2.0,50.0,980
7841,0,100,100,1,1,50.0,2.0,50.0,980
7842,62,9,71,2,2,50.0,2.0,50.0,980
7843,-9,21,12,2,3,50.0,2.0,50.0,980
7844,21,49,70,3,4,50.0,2.0,50.0,980
7845,48,37,85,3,5,50.0,2.0,50.0,980
7846,1,97,98,3,6,50.0,2.0,50.0,980
7847,26,67,93,3,7,50.0,2.0,50.0,980
7848,55,45,100,1,0,50.0,2.0,50.0,981
7849,74,26,100,1,1,50.0,2.0,50.0,981
7850,74,26,100,2,2,50.0,2.0,50.0,981
7851,77,23,100,2,3,50.0,2.0,50.0,981
7852,41,59,100,3,4,50.0,2.0,50.0,981
7853,76,24,100,3,5,50.0,2.0,50.0,981
7854,73,27,100,3,6,50.0,2.0,50.0,981
7855,100,0,100,3,7,50.0,2.0,50.0,981
7856,33,45,78,1,0,50.0,2.0,50.0,982
7857,21,39,60,1,1,50.0,2.0,50.0,982
7858,23,61,84,2,2,50.0,2.0,50.0,982
7859,-8,31,23,2,3,50.0,2.0,50.0,982
7860,-1,82,81,3,4,50.0,2.0,50.0,982
7861,31,50,81,3,5,50.0,2.0,50.0,982
7862,56,33,89,3,6,50.0,2.0,50.0,982
7863,33,41,74,3,7,50.0,2.0,50.0,982
7864,-1,40,39,1,0,50.0,2.0,50.0,983
7865,2,50,52,1,1,50.0,2.0,50.0,983
7866,-12,62,50,2,2,50.0,2.0,50.0,983
7867,-11,50,39,2,3,50.0,2.0,50.0,983
7868,3,77,80,3,4,50.0,2.0,50.0,983
7869,-12,51,39,3,5,50.0,2.0,50.0,983
7870,-1,40,39,3,6,50.0,2.0,50.0,983
7871,0,24,24,3,7,50.0,2.0,50.0,983
7872,70,30,100,1,0,50.0,2.0,50.0,984
7873,41,59,100,1,1,50.0,2.0,50.0,984
7874,50,50,100,2,2,50.0,2.0,50.0,984
7875,50,50,100,2,3,50.0,2.0,50.0,984
7876,50,50,100,3,4,50.0,2.0,50.0,984
7877,39,61,100,3,5,50.0,2.0,50.0,984
7878,30,70,100,3,6,50.0,2.0,50.0,984
7879,40,60,100,3,7,50.0,2.0,50.0,984
7880,-10,50,40,1,0,50.0,2.0,50.0,985
7881,0,20,20,1,1,50.0,2.0,50.0,985
7882,30,20,50,2,2,50.0,2.0,50.0,985
7883,-10,50,40,2,3,50.0,2.0,50.0,985
7884,0,40,40,3,4,50.0,2.0,50.0,985
7885,1,50,51,3,5,50.0,2.0,50.0,985
7886,0,0,0,3,6,50.0,2.0,50.0,985
7887,0,0,0,3,7,50.0,2.0,50.0,985
7888,75,25,100,1,0,50.0,2.0,50.0,986
7889,0,100,100,1,1,50.0,2.0,50.0,986
7890,37,63,100,2,2,50.0,2.0,50.0,986
7891,12,88,100,2,3,50.0,2.0,50.0,986
7892,10,90,100,3,4,50.0,2.0,50.0,986
7893,12,88,100,3,5,50.0,2.0,50.0,986
7894,50,50,100,3,6,50.0,2.0,50.0,986
7895,100,0,100,3,7,50.0,2.0,50.0,986
7896,6,19,25,1,0,50.0,2.0,50.0,987
7897,14,0,14,1,1,50.0,2.0,50.0,987
7898,10,15,25,2,2,50.0,2.0,50.0,987
7899,-7,90,83,2,3,50.0,2.0,50.0,987
7900,-50,79,29,3,4,50.0,2.0,50.0,987
7901,-4,32,28,3,5,50.0,2.0,50.0,987
7902,-1,29,28,3,6,50.0,2.0,50.0,987
7903,-4,19,15,3,7,50.0,2.0,50.0,987
7904,38,61,99,1,0,50.0,2.0,50.0,988
7905,46,54,100,1,1,50.0,2.0,50.0,988
7906,68,32,100,2,2,50.0,2.0,50.0,988
7907,50,50,100,2,3,50.0,2.0,50.0,988
7908,23,77,100,3,4,50.0,2.0,50.0,988
7909,55,45,100,3,5,50.0,2.0,50.0,988
7910,28,72,100,3,6,50.0,2.0,50.0,988
7911,83,17,100,3,7,50.0,2.0,50.0,988
7912,25,75,100,1,0,50.0,2.0,50.0,989
7913,0,100,100,1,1,50.0,2.0,50.0,989
7914,63,0,63,2,2,50.0,2.0,50.0,989
7915,-100,100,0,2,3,50.0,2.0,50.0,989
7916,35,65,100,3,4,50.0,2.0,50.0,989
7917,92,0,92,3,5,50.0,2.0,50.0,989
7918,12,88,100,3,6,50.0,2.0,50.0,989
7919,0,0,0,3,7,50.0,2.0,50.0,989
7920,74,9,83,1,0,50.0,2.0,50.0,990
7921,3,85,88,1,1,50.0,2.0,50.0,990
7922,53,26,79,2,2,50.0,2.0,50.0,990
7923,39,11,50,2,3,50.0,2.0,50.0,990
7924,18,77,95,3,4,50.0,2.0,50.0,990
7925,63,15,78,3,5,50.0,2.0,50.0,990
7926,54,25,79,3,6,50.0,2.0,50.0,990
7927,65,13,78,3,7,50.0,2.0,50.0,990
7928,-12,22,10,1,0,50.0,2.0,50.0,991
7929,0,4,4,1,1,50.0,2.0,50.0,991
7930,37,50,87,2,2,50.0,2.0,50.0,991
7931,9,79,88,2,3,50.0,2.0,50.0,991
7932,0,50,50,3,4,50.0,2.0,50.0,991
7933,28,22,50,3,5,50.0,2.0,50.0,991
7934,-3,24,21,3,6,50.0,2.0,50.0,991
7935,6,78,84,3,7,50.0,2.0,50.0,991
7936,91,6,97,1,0,50.0,2.0,50.0,992
7937,74,14,88,1,1,50.0,2.0,50.0,992
7938,75,10,85,2,2,50.0,2.0,50.0,992
7939,-44,70,26,2,3,50.0,2.0,50.0,992
7940,19,70,89,3,4,50.0,2.0,50.0,992
7941,86,5,91,3,5,50.0,2.0,50.0,992
7942,65,25,90,3,6,50.0,2.0,50.0,992
7943,87,5,92,3,7,50.0,2.0,50.0,992
7944,50,50,100,1,0,50.0,2.0,50.0,993
7945,0,100,100,1,1,50.0,2.0,50.0,993
7946,93,0,93,2,2,50.0,2.0,50.0,993
7947,50,50,100,2,3,50.0,2.0,50.0,993
7948,50,50,100,3,4,50.0,2.0,50.0,993
7949,49,39,88,3,5,50.0,2.0,50.0,993
7950,100,0,100,3,6,50.0,2.0,50.0,993
7951,100,0,100,3,7,50.0,2.0,50.0,993
7952,13,87,100,1,0,50.0,2.0,50.0,994
7953,20,80,100,1,1,50.0,2.0,50.0,994
7954,-8,50,42,2,2,50.0,2.0,50.0,994
7955,46,50,96,2,3,50.0,2.0,50.0,994
7956,25,75,100,3,4,50.0,2.0,50.0,994
7957,30,50,80,3,5,50.0,2.0,50.0,994
7958,-23,50,27,3,6,50.0,2.0,50.0,994
7959,0,50,50,3,7,50.0,2.0,50.0,994
7960,12,76,88,1,0,50.0,2.0,50.0,995
7961,32,62,94,1,1,50.0,2.0,50.0,995
7962,59,0,59,2,2,50.0,2.0,50.0,995
7963,50,0,50,2,3,50.0,2.0,50.0,995
7964,25,65,90,3,4,50.0,2.0,50.0,995
7965,67,10,77,3,5,50.0,2.0,50.0,995
7966,8,90,98,3,6,50.0,2.0,50.0,995
7967,92,0,92,3,7,50.0,2.0,50.0,995
7968,84,16,100,1,0,50.0,2.0,50.0,996
7969,96,4,100,1,1,50.0,2.0,50.0,996
7970,50,50,100,2,2,50.0,2.0,50.0,996
7971,19,81,100,2,3,50.0,2.0,50.0,996
7972,25,75,100,3,4,50.0,2.0,50.0,996
7973,20,80,100,3,5,50.0,2.0,50.0,996
7974,100,0,100,3,6,50.0,2.0,50.0,996
7975,85,15,100,3,7,50.0,2.0,50.0,996
7976,0,0,0,1,0,50.0,2.0,50.0,997
7977,0,100,100,1,1,50.0,2.0,50.0,997
7978,-69,69,0,2,2,50.0,2.0,50.0,997
7979,24,10,34,2,3,50.0,2.0,50.0,997
7980,5,95,100,3,4,50.0,2.0,50.0,997
7981,0,50,50,3,5,50.0,2.0,50.0,997
7982,-2,100,98,3,6,50.0,2.0,50.0,997
7983,0,0,0,3,7,50.0,2.0,50.0,997
7984,13,37,50,1,0,50.0,2.0,50.0,998
7985,26,37,63,1,1,50.0,2.0,50.0,998
7986,28,34,62,2,2,50.0,2.0,50.0,998
7987,18,49,67,2,3,50.0,2.0,50.0,998
7988,29,35,64,3,4,50.0,2.0,50.0,998
7989,31,30,61,3,5,50.0,2.0,50.0,998
7990,27,50,77,3,6,50.0,2.0,50.0,998
7991,36,26,62,3,7,50.0,2.0,50.0,998
7992,0,0,0,1,0,50.0,2.0,50.0,999
7993,0,50,50,1,1,50.0,2.0,50.0,999
7994,0,50,50,2,2,50.0,2.0,50.0,999
7995,0,50,50,2,3,50.0,2.0,50.0,999
7996,0,50,50,3,4,50.0,2.0,50.0,999
7997,50,0,50,3,5,50.0,2.0,50.0,999
7998,0,50,50,3,6,50.0,2.0,50.0,999
7999,0,0,0,3,7,50.0,2.0,50.0,999
8000,100,0,100,1,0,50.0,2.0,50.0,1000
8001,100,0,100,1,1,50.0,2.0,50.0,1000
8002,91,9,100,2,2,50.0,2.0,50.0,1000
8003,0,100,100,2,3,50.0,2.0,50.0,1000
8004,27,73,100,3,4,50.0,2.0,50.0,1000
8005,36,64,100,3,5,50.0,2.0,50.0,1000
8006,88,12,100,3,6,50.0,2.0,50.0,1000
8007,100,0,100,3,7,50.0,2.0,50.0,1000
8008,0,0,0,1,0,50.0,2.0,50.0,1001
8009,0,0,0,1,1,50.0,2.0,50.0,1001
8010,50,50,100,2,2,50.0,2.0,50.0,1001
8011,0,0,0,2,3,50.0,2.0,50.0,1001
8012,100,0,100,3,4,50.0,2.0,50.0,1001
8013,0,50,50,3,5,50.0,2.0,50.0,1001
8014,-50,50,0,3,6,50.0,2.0,50.0,1001
8015,50,0,50,3,7,50.0,2.0,50.0,1001
8016,32,50,82,1,0,50.0,2.0,50.0,1002
8017,35,65,100,1,1,50.0,2.0,50.0,1002
8018,49,1,50,2,2,50.0,2.0,50.0,1002
8019,73,13,86,2,3,50.0,2.0,50.0,1002
8020,22,14,36,3,4,50.0,2.0,50.0,1002
8021,0,0,0,3,5,50.0,2.0,50.0,1002
8022,17,76,93,3,6,50.0,2.0,50.0,1002
8023,30,0,30,3,7,50.0,2.0,50.0,1002
8024,15,25,40,1,0,50.0,2.0,50.0,1003
8025,8,4,12,1,1,50.0,2.0,50.0,1003
8026,0,50,50,2,2,50.0,2.0,50.0,1003
8027,28,62,90,2,3,50.0,2.0,50.0,1003
8028,62,4,66,3,4,50.0,2.0,50.0,1003
8029,64,0,64,3,5,50.0,2.0,50.0,1003
8030,87,5,92,3,6,50.0,2.0,50.0,1003
8031,47,3,50,3,7,50.0,2.0,50.0,1003
8032,50,50,100,1,0,50.0,2.0,50.0,1004
8033,25,75,100,1,1,50.0,2.0,50.0,1004
8034,81,19,100,2,2,50.0,2.0,50.0,1004
8035,-24,24,0,2,3,50.0,2.0,50.0,1004
8036,100,0,100,3,4,50.0,2.0,50.0,1004
8037,50,50,100,3,5,50.0,2.0,50.0,1004
8038,16,84,100,3,6,50.0,2.0,50.0,1004
8039,75,25,100,3,7,50.0,2.0,50.0,1004
8040,0,50,50,1,0,50.0,2.0,50.0,1005
8041,25,75,100,1,1,50.0,2.0,50.0,1005
8042,0,50,50,2,2,50.0,2.0,50.0,1005
8043,0,50,50,2,3,50.0,2.0,50.0,1005
8044,63,37,100,3,4,50.0,2.0,50.0,1005
8045,50,50,100,3,5,50.0,2.0,50.0,1005
8046,35,65,100,3,6,50.0,2.0,50.0,1005
8047,74,26,100,3,7,50.0,2.0,50.0,1005
8048,0,100,100,1,0,50.0,2.0,50.0,1006
8049,100,0,100,1,1,50.0,2.0,50.0,1006
8050,-77,77,0,2,2,50.0,2.0,50.0,1006
8051,100,0,100,2,3,50.0,2.0,50.0,1006
8052,0,100,100,3,4,50.0,2.0,50.0,1006
8053,100,0,100,3,5,50.0,2.0,50.0,1006
8054,50,50,100,3,6,50.0,2.0,50.0,1006
8055,-60,60,0,3,7,50.0,2.0,50.0,1006
8056,-1,55,54,1,0,50.0,2.0,50.0,1007
8057,-14,33,19,1,1,50.0,2.0,50.0,1007
8058,-10,31,21,2,2,50.0,2.0,50.0,1007
8059,61,6,67,2,3,50.0,2.0,50.0,1007
8060,3,57,60,3,4,50.0,2.0,50.0,1007
8061,-6,44,38,3,5,50.0,2.0,50.0,1007
8062,-2,13,11,3,6,50.0,2.0,50.0,1007
8063,-3,6,3,3,7,50.0,2.0,50.0,1007
8064,13,50,63,1,0,50.0,2.0,50.0,1008
8065,38,13,51,1,1,50.0,2.0,50.0,1008
8066,-25,63,38,2,2,50.0,2.0,50.0,1008
8067,13,50,63,2,3,50.0,2.0,50.0,1008
8068,13,50,63,3,4,50.0,2.0,50.0,1008
8069,13,50,63,3,5,50.0,2.0,50.0,1008
8070,-10,60,50,3,6,50.0,2.0,50.0,1008
8071,13,50,63,3,7,50.0,2.0,50.0,1008
8072,-5,87,82,1,0,50.0,2.0,50.0,1009
8073,8,0,8,1,1,50.0,2.0,50.0,1009
8074,-6,49,43,2,2,50.0,2.0,50.0,1009
8075,0,27,27,2,3,50.0,2.0,50.0,1009
8076,-8,53,45,3,4,50.0,2.0,50.0,1009
8077,-5,42,37,3,5,50.0,2.0,50.0,1009
8078,-5,52,47,3,6,50.0,2.0,50.0,1009
8079,11,0,11,3,7,50.0,2.0,50.0,1009
8080,-10,10,0,1,0,50.0,2.0,50.0,1010
8081,13,0,13,1,1,50.0,2.0,50.0,1010
8082,-10,49,39,2,2,50.0,2.0,50.0,1010
8083,-58,100,42,2,3,50.0,2.0,50.0,1010
8084,-13,69,56,3,4,50.0,2.0,50.0,1010
8085,14,34,48,3,5,50.0,2.0,50.0,1010
8086,-26,51,25,3,6,50.0,2.0,50.0,1010
8087,-13,33,20,3,7,50.0,2.0,50.0,1010
8088,0,25,25,1,0,50.0,2.0,50.0,1011
8089,-49,50,1,1,1,50.0,2.0,50.0,1011
8090,20,55,75,2,2,50.0,2.0,50.0,1011
8091,25,50,75,2,3,50.0,2.0,50.0,1011
8092,8,67,75,3,4,50.0,2.0,50.0,1011
8093,0,50,50,3,5,50.0,2.0,50.0,1011
8094,6,44,50,3,6,50.0,2.0,50.0,1011
8095,0,50,50,3,7,50.0,2.0,50.0,1011
8096,20,30,50,1,0,50.0,2.0,50.0,1012
8097,-2,16,14,1,1,50.0,2.0,50.0,1012
8098,10,50,60,2,2,50.0,2.0,50.0,1012
8099,11,50,61,2,3,50.0,2.0,50.0,1012
8100,4,49,53,3,4,50.0,2.0,50.0,1012
8101,21,50,71,3,5,50.0,2.0,50.0,1012
8102,1,27,28,3,6,50.0,2.0,50.0,1012
8103,8,50,58,3,7,50.0,2.0,50.0,1012
8104,-6,96,90,1,0,50.0,2.0,50.0,1013
8105,-3,94,91,1,1,50.0,2.0,50.0,1013
8106,0,50,50,2,2,50.0,2.0,50.0,1013
8107,-5,94,89,2,3,50.0,2.0,50.0,1013
8108,41,50,91,3,4,50.0,2.0,50.0,1013
8109,-11,50,39,3,5,50.0,2.0,50.0,1013
8110,-22,50,28,3,6,50.0,2.0,50.0,1013
8111,-38,50,12,3,7,50.0,2.0,50.0,1013
8112,0,0,0,1,0,50.0,2.0,50.0,1014
8113,7,93,100,1,1,50.0,2.0,50.0,1014
8114,0,50,50,2,2,50.0,2.0,50.0,1014
8115,50,50,100,2,3,50.0,2.0,50.0,1014
8116,-15,65,50,3,4,50.0,2.0,50.0,1014
8117,0,50,50,3,5,50.0,2.0,50.0,1014
8118,0,50,50,3,6,50.0,2.0,50.0,1014
8119,50,0,50,3,7,50.0,2.0,50.0,1014
8120,0,0,0,1,0,50.0,2.0,50.0,1015
8121,96,0,96,1,1,50.0,2.0,50.0,1015
8122,100,0,100,2,2,50.0,2.0,50.0,1015
8123,100,0,100,2,3,50.0,2.0,50.0,1015
8124,74,26,100,3,4,50.0,2.0,50.0,1015
8125,50,50,100,3,5,50.0,2.0,50.0,1015
8126,100,0,100,3,6,50.0,2.0,50.0,1015
8127,100,0,100,3,7,50.0,2.0,50.0,1015
8128,1,8,9,1,0,50.0,2.0,50.0,1016
8129,24,14,38,1,1,50.0,2.0,50.0,1016
8130,23,50,73,2,2,50.0,2.0,50.0,1016
8131,-16,100,84,2,3,50.0,2.0,50.0,1016
8132,-10,86,76,3,4,50.0,2.0,50.0,1016
8133,37,51,88,3,5,50.0,2.0,50.0,1016
8134,65,22,87,3,6,50.0,2.0,50.0,1016
8135,15,9,24,3,7,50.0,2.0,50.0,1016
8136,50,50,100,1,0,50.0,2.0,50.0,1017
8137,50,50,100,1,1,50.0,2.0,50.0,1017
8138,100,0,100,2,2,50.0,2.0,50.0,1017
8139,50,50,100,2,3,50.0,2.0,50.0,1017
8140,50,50,100,3,4,50.0,2.0,50.0,1017
8141,50,50,100,3,5,50.0,2.0,50.0,1017
8142,100,0,100,3,6,50.0,2.0,50.0,1017
8143,100,0,100,3,7,50.0,2.0,50.0,1017
8144,52,48,100,1,0,50.0,2.0,50.0,1018
8145,55,45,100,1,1,50.0,2.0,50.0,1018
8146,3,48,51,2,2,50.0,2.0,50.0,1018
8147,100,0,100,2,3,50.0,2.0,50.0,1018
8148,59,41,100,3,4,50.0,2.0,50.0,1018
8149,100,0,100,3,5,50.0,2.0,50.0,1018
8150,0,100,100,3,6,50.0,2.0,50.0,1018
8151,15,85,100,3,7,50.0,2.0,50.0,1018
8152,0,50,50,1,0,50.0,2.0,50.0,1019
8153,49,50,99,1,1,50.0,2.0,50.0,1019
8154,0,50,50,2,2,50.0,2.0,50.0,1019
8155,0,50,50,2,3,50.0,2.0,50.0,1019
8156,50,50,100,3,4,50.0,2.0,50.0,1019
8157,50,50,100,3,5,50.0,2.0,50.0,1019
8158,93,7,100,3,6,50.0,2.0,50.0,1019
8159,50,50,100,3,7,50.0,2.0,50.0,1019
8160,50,50,100,1,0,50.0,2.0,50.0,1020
8161,0,100,100,1,1,50.0,2.0,50.0,1020
8162,50,50,100,2,2,50.0,2.0,50.0,1020
8163,50,50,100,2,3,50.0,2.0,50.0,1020
8164,50,50,100,3,4,50.0,2.0,50.0,1020
8165,50,50,100,3,5,50.0,2.0,50.0,1020
8166,0,100,100,3,6,50.0,2.0,50.0,1020
8167,0,100,100,3,7,50.0,2.0,50.0,1020
8168,65,12,77,1,0,50.0,2.0,50.0,1021
8169,54,24,78,1,1,50.0,2.0,50.0,1021
8170,8,64,72,2,2,50.0,2.0,50.0,1021
8171,61,8,69,2,3,50.0,2.0,50.0,1021
8172,24,64,88,3,4,50.0,2.0,50.0,1021
8173,40,50,90,3,5,50.0,2.0,50.0,1021
8174,28,50,78,3,6,50.0,2.0,50.0,1021
8175,27,50,77,3,7,50.0,2.0,50.0,1021
8176,0,0,0,1,0,50.0,2.0,50.0,1022
8177,4,0,4,1,1,50.0,2.0,50.0,1022
8178,50,50,100,2,2,50.0,2.0,50.0,1022
8179,0,100,100,2,3,50.0,2.0,50.0,1022
8180,50,50,100,3,4,50.0,2.0,50.0,1022
8181,-1,17,16,3,5,50.0,2.0,50.0,1022
8182,12,2,14,3,6,50.0,2.0,50.0,1022
8183,0,0,0,3,7,50.0,2.0,50.0,1022
8184,25,50,75,1,0,50.0,2.0,50.0,1023
8185,-16,77,61,1,1,50.0,2.0,50.0,1023
8186,0,50,50,2,2,50.0,2.0,50.0,1023
8187,-2,52,50,2,3,50.0,2.0,50.0,1023
8188,33,50,83,3,4,50.0,2.0,50.0,1023
8189,0,50,50,3,5,50.0,2.0,50.0,1023
8190,-20,51,31,3,6,50.0,2.0,50.0,1023
8191,-5,55,50,3,7,50.0,2.0,50.0,1023
8192,25,75,100,1,0,50.0,2.0,50.0,1024
8193,23,77,100,1,1,50.0,2.0,50.0,1024
8194,88,12,100,2,2,50.0,2.0,50.0,1024
8195,88,12,100,2,3,50.0,2.0,50.0,1024
8196,36,64,100,3,4,50.0,2.0,50.0,1024
8197,82,18,100,3,5,50.0,2.0,50.0,1024
8198,0,100,100,3,6,50.0,2.0,50.0,1024
8199,49,51,100,3,7,50.0,2.0,50.0,1024
8200,-50,50,0,1,0,50.0,2.0,50.0,1025
8201,100,0,100,1,1,50.0,2.0,50.0,1025
8202,100,0,100,2,2,50.0,2.0,50.0,1025
8203,50,50,100,2,3,50.0,2.0,50.0,1025
8204,40,60,100,3,4,50.0,2.0,50.0,1025
8205,100,0,100,3,5,50.0,2.0,50.0,1025
8206,100,0,100,3,6,50.0,2.0,50.0,1025
8207,100,0,100,3,7,50.0,2.0,50.0,1025
8208,41,50,91,1,0,50.0,2.0,50.0,1026
8209,0,100,100,1,1,50.0,2.0,50.0,1026
8210,84,10,94,2,2,50.0,2.0,50.0,1026
8211,23,77,100,2,3,50.0,2.0,50.0,1026
8212,17,50,67,3,4,50.0,2.0,50.0,1026
8213,68,10,78,3,5,50.0,2.0,50.0,1026
8214,0,100,100,3,6,50.0,2.0,50.0,1026
8215,61,17,78,3,7,50.0,2.0,50.0,1026
8216,21,61,82,1,0,50.0,2.0,50.0,1027
8217,7,78,85,1,1,50.0,2.0,50.0,1027
8218,51,23,74,2,2,50.0,2.0,50.0,1027
8219,16,59,75,2,3,50.0,2.0,50.0,1027
8220,3,75,78,3,4,50.0,2.0,50.0,1027
8221,55,23,78,3,5,50.0,2.0,50.0,1027
8222,48,36,84,3,6,50.0,2.0,50.0,1027
8223,-2,25,23,3,7,50.0,2.0,50.0,1027
8224,0,50,50,1,0,50.0,2.0,50.0,1028
8225,10,90,100,1,1,50.0,2.0,50.0,1028
8226,50,0,50,2,2,50.0,2.0,50.0,1028
8227,-20,20,0,2,3,50.0,2.0,50.0,1028
8228,0,50,50,3,4,50.0,2.0,50.0,1028
8229,0,50,50,3,5,50.0,2.0,50.0,1028
8230,50,50,100,3,6,50.0,2.0,50.0,1028
8231,0,0,0,3,7,50.0,2.0,50.0,1028
8232,-33,83,50,1,0,50.0,2.0,50.0,1029
8233,-4,100,96,1,1,50.0,2.0,50.0,1029
8234,4,46,50,2,2,50.0,2.0,50.0,1029
8235,0,50,50,2,3,50.0,2.0,50.0,1029
8236,0,50,50,3,4,50.0,2.0,50.0,1029
8237,0,50,50,3,5,50.0,2.0,50.0,1029
8238,0,50,50,3,6,50.0,2.0,50.0,1029
8239,-49,99,50,3,7,50.0,2.0,50.0,1029
8240,-50,50,0,1,0,50.0,2.0,50.0,1030
8241,50,50,100,1,1,50.0,2.0,50.0,1030
8242,100,0,100,2,2,50.0,2.0,50.0,1030
8243,-50,50,0,2,3,50.0,2.0,50.0,1030
8244,34,66,100,3,4,50.0,2.0,50.0,1030
8245,50,50,100,3,5,50.0,2.0,50.0,1030
8246,50,50,100,3,6,50.0,2.0,50.0,1030
8247,50,50,100,3,7,50.0,2.0,50.0,1030
8248,7,14,21,1,0,50.0,2.0,50.0,1031
8249,-8,76,68,1,1,50.0,2.0,50.0,1031
8250,-11,75,64,2,2,50.0,2.0,50.0,1031
8251,0,67,67,2,3,50.0,2.0,50.0,1031
8252,3,32,35,3,4,50.0,2.0,50.0,1031
8253,38,32,70,3,5,50.0,2.0,50.0,1031
8254,82,9,91,3,6,50.0,2.0,50.0,1031
8255,51,22,73,3,7,50.0,2.0,50.0,1031
8256,50,50,100,1,0,50.0,2.0,50.0,1032
8257,50,50,100,1,1,50.0,2.0,50.0,1032
8258,98,2,100,2,2,50.0,2.0,50.0,1032
8259,25,75,100,2,3,50.0,2.0,50.0,1032
8260,24,76,100,3,4,50.0,2.0,50.0,1032
8261,100,0,100,3,5,50.0,2.0,50.0,1032
8262,96,4,100,3,6,50.0,2.0,50.0,1032
8263,100,0,100,3,7,50.0,2.0,50.0,1032
8264,39,59,98,1,0,50.0,2.0,50.0,1033
8265,-4,100,96,1,1,50.0,2.0,50.0,1033
8266,71,4,75,2,2,50.0,2.0,50.0,1033
8267,88,0,88,2,3,50.0,2.0,50.0,1033
8268,28,72,100,3,4,50.0,2.0,50.0,1033
8269,9,80,89,3,5,50.0,2.0,50.0,1033
8270,26,66,92,3,6,50.0,2.0,50.0,1033
8271,57,29,86,3,7,50.0,2.0,50.0,1033
8272,0,50,50,1,0,50.0,2.0,50.0,1034
8273,-10,50,40,1,1,50.0,2.0,50.0,1034
8274,0,50,50,2,2,50.0,2.0,50.0,1034
8275,0,50,50,2,3,50.0,2.0,50.0,1034
8276,0,50,50,3,4,50.0,2.0,50.0,1034
8277,0,50,50,3,5,50.0,2.0,50.0,1034
8278,0,25,25,3,6,50.0,2.0,50.0,1034
8279,-10,10,0,3,7,50.0,2.0,50.0,1034
8280,0,50,50,1,0,50.0,2.0,50.0,1035
8281,-50,100,50,1,1,50.0,2.0,50.0,1035
8282,0,50,50,2,2,50.0,2.0,50.0,1035
8283,0,50,50,2,3,50.0,2.0,50.0,1035
8284,0,50,50,3,4,50.0,2.0,50.0,1035
8285,-50,100,50,3,5,50.0,2.0,50.0,1035
8286,-1,50,49,3,6,50.0,2.0,50.0,1035
8287,0,50,50,3,7,50.0,2.0,50.0,1035
8288,27,63,90,1,0,50.0,2.0,50.0,1036
8289,34,57,91,1,1,50.0,2.0,50.0,1036
8290,65,25,90,2,2,50.0,2.0,50.0,1036
8291,67,24,91,2,3,50.0,2.0,50.0,1036
8292,25,63,88,3,4,50.0,2.0,50.0,1036
8293,50,40,90,3,5,50.0,2.0,50.0,1036
8294,16,74,90,3,6,50.0,2.0,50.0,1036
8295,86,4,90,3,7,50.0,2.0,50.0,1036
8296,100,0,100,1,0,50.0,2.0,50.0,1037
8297,100,0,100,1,1,50.0,2.0,50.0,1037
8298,53,47,100,2,2,50.0,2.0,50.0,1037
8299,47,53,100,2,3,50.0,2.0,50.0,1037
8300,0,0,0,3,4,50.0,2.0,50.0,1037
8301,49,51,100,3,5,50.0,2.0,50.0,1037
8302,51,49,100,3,6,50.0,2.0,50.0,1037
8303,100,0,100,3,7,50.0,2.0,50.0,1037
8304,53,22,75,1,0,50.0,2.0,50.0,1038
8305,42,49,91,1,1,50.0,2.0,50.0,1038
8306,43,13,56,2,2,50.0,2.0,50.0,1038
8307,-19,49,30,2,3,50.0,2.0,50.0,1038
8308,4,43,47,3,4,50.0,2.0,50.0,1038
8309,52,26,78,3,5,50.0,2.0,50.0,1038
8310,-1,28,27,3,6,50.0,2.0,50.0,1038
8311,26,0,26,3,7,50.0,2.0,50.0,1038
8312,0,50,50,1,0,50.0,2.0,50.0,1039
8313,0,100,100,1,1,50.0,2.0,50.0,1039
8314,-50,50,0,2,2,50.0,2.0,50.0,1039
8315,5,45,50,2,3,50.0,2.0,50.0,1039
8316,0,50,50,3,4,50.0,2.0,50.0,1039
8317,0,0,0,3,5,50.0,2.0,50.0,1039
8318,46,54,100,3,6,50.0,2.0,50.0,1039
8319,0,0,0,3,7,50.0,2.0,50.0,1039
8320,1,50,51,1,0,50.0,2.0,50.0,1040
8321,75,5,80,1,1,50.0,2.0,50.0,1040
8322,29,21,50,2,2,50.0,2.0,50.0,1040
8323,-23,72,49,2,3,50.0,2.0,50.0,1040
8324,-5,20,15,3,4,50.0,2.0,50.0,1040
8325,-3,50,47,3,5,50.0,2.0,50.0,1040
8326,33,15,48,3,6,50.0,2.0,50.0,1040
8327,-1,10,9,3,7,50.0,2.0,50.0,1040
8328,6,70,76,1,0,50.0,2.0,50.0,1041
8329,10,90,100,1,1,50.0,2.0,50.0,1041
8330,18,39,57,2,2,50.0,2.0,50.0,1041
8331,24,46,70,2,3,50.0,2.0,50.0,1041
8332,10,80,90,3,4,50.0,2.0,50.0,1041
8333,28,37,65,3,5,50.0,2.0,50.0,1041
8334,15,65,80,3,6,50.0,2.0,50.0,1041
8335,22,30,52,3,7,50.0,2.0,50.0,1041
8336,62,38,100,1,0,50.0,2.0,50.0,1042
8337,40,60,100,1,1,50.0,2.0,50.0,1042
8338,58,42,100,2,2,50.0,2.0,50.0,1042
8339,30,70,100,2,3,50.0,2.0,50.0,1042
8340,35,49,84,3,4,50.0,2.0,50.0,1042
8341,50,50,100,3,5,50.0,2.0,50.0,1042
8342,0,100,100,3,6,50.0,2.0,50.0,1042
8343,72,28,100,3,7,50.0,2.0,50.0,1042
8344,-9,34,25,1,0,50.0,2.0,50.0,1043
8345,34,46,80,1,1,50.0,2.0,50.0,1043
8346,-26,45,19,2,2,50.0,2.0,50.0,1043
8347,2,23,25,2,3,50.0,2.0,50.0,1043
8348,6,19,25,3,4,50.0,2.0,50.0,1043
8349,76,17,93,3,5,50.0,2.0,50.0,1043
8350,0,100,100,3,6,50.0,2.0,50.0,1043
8351,55,29,84,3,7,50.0,2.0,50.0,1043
8352,38,50,88,1,0,50.0,2.0,50.0,1044
8353,30,59,89,1,1,50.0,2.0,50.0,1044
8354,37,13,50,2,2,50.0,2.0,50.0,1044
8355,43,50,93,2,3,50.0,2.0,50.0,1044
8356,11,62,73,3,4,50.0,2.0,50.0,1044
8357,55,32,87,3,5,50.0,2.0,50.0,1044
8358,42,50,92,3,6,50.0,2.0,50.0,1044
8359,-3,50,47,3,7,50.0,2.0,50.0,1044
8360,100,0,100,1,0,50.0,2.0,50.0,1045
8361,100,0,100,1,1,50.0,2.0,50.0,1045
8362,91,9,100,2,2,50.0,2.0,50.0,1045
8363,51,49,100,2,3,50.0,2.0,50.0,1045
8364,50,50,100,3,4,50.0,2.0,50.0,1045
8365,50,50,100,3,5,50.0,2.0,50.0,1045
8366,0,100,100,3,6,50.0,2.0,50.0,1045
8367,0,0,0,3,7,50.0,2.0,50.0,1045
8368,31,45,76,1,0,50.0,2.0,50.0,1046
8369,14,58,72,1,1,50.0,2.0,50.0,1046
8370,8,79,87,2,2,50.0,2.0,50.0,1046
8371,0,0,0,2,3,50.0,2.0,50.0,1046
8372,40,38,78,3,4,50.0,2.0,50.0,1046
8373,9,47,56,3,5,50.0,2.0,50.0,1046
8374,7,46,53,3,6,50.0,2.0,50.0,1046
8375,0,37,37,3,7,50.0,2.0,50.0,1046
8376,-4,52,48,1,0,50.0,2.0,50.0,1047
8377,0,50,50,1,1,50.0,2.0,50.0,1047
8378,-7,51,44,2,2,50.0,2.0,50.0,1047
8379,2,48,50,2,3,50.0,2.0,50.0,1047
8380,-1,51,50,3,4,50.0,2.0,50.0,1047
8381,3,47,50,3,5,50.0,2.0,50.0,1047
8382,1,50,51,3,6,50.0,2.0,50.0,1047
8383,24,49,73,3,7,50.0,2.0,50.0,1047
8384,-1,50,49,1,0,50.0,2.0,50.0,1048
8385,-1,50,49,1,1,50.0,2.0,50.0,1048
8386,43,50,93,2,2,50.0,2.0,50.0,1048
8387,44,50,94,2,3,50.0,2.0,50.0,1048
8388,0,100,100,3,4,50.0,2.0,50.0,1048
8389,89,11,100,3,5,50.0,2.0,50.0,1048
8390,90,10,100,3,6,50.0,2.0,50.0,1048
8391,84,0,84,3,7,50.0,2.0,50.0,1048
8392,50,50,100,1,0,50.0,2.0,50.0,1049
8393,48,25,73,1,1,50.0,2.0,50.0,1049
8394,15,85,100,2,2,50.0,2.0,50.0,1049
8395,0,100,100,2,3,50.0,2.0,50.0,1049
8396,35,65,100,3,4,50.0,2.0,50.0,1049
8397,65,35,100,3,5,50.0,2.0,50.0,1049
8398,26,12,38,3,6,50.0,2.0,50.0,1049
8399,7,93,100,3,7,50.0,2.0,50.0,1049
8400,4,73,77,1,0,50.0,2.0,50.0,1050
8401,-14,64,50,1,1,50.0,2.0,50.0,1050
8402,-15,65,50,2,2,50.0,2.0,50.0,1050
8403,-10,10,0,2,3,50.0,2.0,50.0,1050
8404,-15,65,50,3,4,50.0,2.0,50.0,1050
8405,-15,65,50,3,5,50.0,2.0,50.0,1050
8406,-23,73,50,3,6,50.0,2.0,50.0,1050
8407,-36,65,29,3,7,50.0,2.0,50.0,1050
8408,20,50,70,1,0,50.0,2.0,50.0,1051
8409,38,62,100,1,1,50.0,2.0,50.0,1051
8410,89,11,100,2,2,50.0,2.0,50.0,1051
8411,50,0,50,2,3,50.0,2.0,50.0,1051
8412,15,60,75,3,4,50.0,2.0,50.0,1051
8413,46,50,96,3,5,50.0,2.0,50.0,1051
8414,95,5,100,3,6,50.0,2.0,50.0,1051
8415,94,2,96,3,7,50.0,2.0,50.0,1051
8416,-25,50,25,1,0,50.0,2.0,50.0,1052
8417,-15,50,35,1,1,50.0,2.0,50.0,1052
8418,-11,35,24,2,2,50.0,2.0,50.0,1052
8419,0,0,0,2,3,50.0,2.0,50.0,1052
8420,0,50,50,3,4,50.0,2.0,50.0,1052
8421,0,0,0,3,5,50.0,2.0,50.0,1052
8422,0,50,50,3,6,50.0,2.0,50.0,1052
8423,0,0,0,3,7,50.0,2.0,50.0,1052
8424,44,9,53,1,0,50.0,2.0,50.0,1053
8425,31,0,31,1,1,50.0,2.0,50.0,1053
8426,30,70,100,2,2,50.0,2.0,50.0,1053
8427,25,75,100,2,3,50.0,2.0,50.0,1053
8428,33,60,93,3,4,50.0,2.0,50.0,1053
8429,50,50,100,3,5,50.0,2.0,50.0,1053
8430,0,100,100,3,6,50.0,2.0,50.0,1053
8431,83,17,100,3,7,50.0,2.0,50.0,1053
8432,8,70,78,1,0,50.0,2.0,50.0,1054
8433,89,11,100,1,1,50.0,2.0,50.0,1054
8434,16,80,96,2,2,50.0,2.0,50.0,1054
8435,36,1,37,2,3,50.0,2.0,50.0,1054
8436,10,90,100,3,4,50.0,2.0,50.0,1054
8437,8,71,79,3,5,50.0,2.0,50.0,1054
8438,16,69,85,3,6,50.0,2.0,50.0,1054
8439,48,29,77,3,7,50.0,2.0,50.0,1054
8440,20,50,70,1,0,50.0,2.0,50.0,1055
8441,0,50,50,1,1,50.0,2.0,50.0,1055
8442,0,50,50,2,2,50.0,2.0,50.0,1055
8443,25,25,50,2,3,50.0,2.0,50.0,1055
8444,0,50,50,3,4,50.0,2.0,50.0,1055
8445,11,75,86,3,5,50.0,2.0,50.0,1055
8446,25,50,75,3,6,50.0,2.0,50.0,1055
8447,24,0,24,3,7,50.0,2.0,50.0,1055
8448,0,0,0,1,0,50.0,2.0,50.0,1056
8449,0,0,0,1,1,50.0,2.0,50.0,1056
8450,0,100,100,2,2,50.0,2.0,50.0,1056
8451,0,50,50,2,3,50.0,2.0,50.0,1056
8452,0,50,50,3,4,50.0,2.0,50.0,1056
8453,50,0,50,3,5,50.0,2.0,50.0,1056
8454,50,50,100,3,6,50.0,2.0,50.0,1056
8455,0,0,0,3,7,50.0,2.0,50.0,1056
8456,100,0,100,1,0,50.0,2.0,50.0,1057
8457,100,0,100,1,1,50.0,2.0,50.0,1057
8458,18,82,100,2,2,50.0,2.0,50.0,1057
8459,0,100,100,2,3,50.0,2.0,50.0,1057
8460,50,50,100,3,4,50.0,2.0,50.0,1057
8461,100,0,100,3,5,50.0,2.0,50.0,1057
8462,50,50,100,3,6,50.0,2.0,50.0,1057
8463,100,0,100,3,7,50.0,2.0,50.0,1057
8464,50,0,50,1,0,50.0,2.0,50.0,1058
8465,-42,65,23,1,1,50.0,2.0,50.0,1058
8466,25,25,50,2,2,50.0,2.0,50.0,1058
8467,15,85,100,2,3,50.0,2.0,50.0,1058
8468,19,30,49,3,4,50.0,2.0,50.0,1058
8469,85,15,100,3,5,50.0,2.0,50.0,1058
8470,20,80,100,3,6,50.0,2.0,50.0,1058
8471,0,50,50,3,7,50.0,2.0,50.0,1058
8472,23,11,34,1,0,50.0,2.0,50.0,1059
8473,5,63,68,1,1,50.0,2.0,50.0,1059
8474,26,24,50,2,2,50.0,2.0,50.0,1059
8475,-1,25,24,2,3,50.0,2.0,50.0,1059
8476,10,58,68,3,4,50.0,2.0,50.0,1059
8477,3,20,23,3,5,50.0,2.0,50.0,1059
8478,0,50,50,3,6,50.0,2.0,50.0,1059
8479,-2,24,22,3,7,50.0,2.0,50.0,1059
8480,16,74,90,1,0,50.0,2.0,50.0,1060
8481,-15,100,85,1,1,50.0,2.0,50.0,1060
8482,19,80,99,2,2,50.0,2.0,50.0,1060
8483,-16,100,84,2,3,50.0,2.0,50.0,1060
8484,-1,86,85,3,4,50.0,2.0,50.0,1060
8485,3,94,97,3,5,50.0,2.0,50.0,1060
8486,16,74,90,3,6,50.0,2.0,50.0,1060
8487,47,23,70,3,7,50.0,2.0,50.0,1060
8488,81,19,100,1,0,50.0,2.0,50.0,1061
8489,53,47,100,1,1,50.0,2.0,50.0,1061
8490,20,80,100,2,2,50.0,2.0,50.0,1061
8491,0,100,100,2,3,50.0,2.0,50.0,1061
8492,36,64,100,3,4,50.0,2.0,50.0,1061
8493,62,38,100,3,5,50.0,2.0,50.0,1061
8494,85,15,100,3,6,50.0,2.0,50.0,1061
8495,19,81,100,3,7,50.0,2.0,50.0,1061
8496,1,50,51,1,0,50.0,2.0,50.0,1062
8497,-12,62,50,1,1,50.0,2.0,50.0,1062
8498,4,72,76,2,2,50.0,2.0,50.0,1062
8499,16,49,65,2,3,50.0,2.0,50.0,1062
8500,29,50,79,3,4,50.0,2.0,50.0,1062
8501,4,49,53,3,5,50.0,2.0,50.0,1062
8502,0,50,50,3,6,50.0,2.0,50.0,1062
8503,-13,50,37,3,7,50.0,2.0,50.0,1062
8504,63,37,100,1,0,50.0,2.0,50.0,1063
8505,50,50,100,1,1,50.0,2.0,50.0,1063
8506,-45,50,5,2,2,50.0,2.0,50.0,1063
8507,-1,100,99,2,3,50.0,2.0,50.0,1063
8508,-68,100,32,3,4,50.0,2.0,50.0,1063
8509,2,50,52,3,5,50.0,2.0,50.0,1063
8510,-1,100,99,3,6,50.0,2.0,50.0,1063
8511,33,8,41,3,7,50.0,2.0,50.0,1063
8512,11,61,72,1,0,50.0,2.0,50.0,1064
8513,21,42,63,1,1,50.0,2.0,50.0,1064
8514,-6,64,58,2,2,50.0,2.0,50.0,1064
8515,9,64,73,2,3,50.0,2.0,50.0,1064
8516,2,61,63,3,4,50.0,2.0,50.0,1064
8517,-6,64,58,3,5,50.0,2.0,50.0,1064
8518,-20,61,41,3,6,50.0,2.0,50.0,1064
8519,-1,62,61,3,7,50.0,2.0,50.0,1064
8520,-28,78,50,1,0,50.0,2.0,50.0,1065
8521,-30,100,70,1,1,50.0,2.0,50.0,1065
8522,16,50,66,2,2,50.0,2.0,50.0,1065
8523,0,50,50,2,3,50.0,2.0,50.0,1065
8524,50,0,50,3,4,50.0,2.0,50.0,1065
8525,0,50,50,3,5,50.0,2.0,50.0,1065
8526,0,50,50,3,6,50.0,2.0,50.0,1065
8527,0,50,50,3,7,50.0,2.0,50.0,1065
8528,-7,12,5,1,0,50.0,2.0,50.0,1066
8529,-37,50,13,1,1,50.0,2.0,50.0,1066
8530,15,10,25,2,2,50.0,2.0,50.0,1066
8531,4,77,81,2,3,50.0,2.0,50.0,1066
8532,7,70,77,3,4,50.0,2.0,50.0,1066
8533,22,1,23,3,5,50.0,2.0,50.0,1066
8534,78,0,78,3,6,50.0,2.0,50.0,1066
8535,72,0,72,3,7,50.0,2.0,50.0,1066
8536,26,15,41,1,0,50.0,2.0,50.0,1067
8537,28,22,50,1,1,50.0,2.0,50.0,1067
8538,7,67,74,2,2,50.0,2.0,50.0,1067
8539,10,90,100,2,3,50.0,2.0,50.0,1067
8540,19,50,69,3,4,50.0,2.0,50.0,1067
8541,0,50,50,3,5,50.0,2.0,50.0,1067
8542,0,68,68,3,6,50.0,2.0,50.0,1067
8543,14,28,42,3,7,50.0,2.0,50.0,1067
8544,50,50,100,1,0,50.0,2.0,50.0,1068
8545,8,92,100,1,1,50.0,2.0,50.0,1068
8546,50,50,100,2,2,50.0,2.0,50.0,1068
8547,0,50,50,2,3,50.0,2.0,50.0,1068
8548,0,50,50,3,4,50.0,2.0,50.0,1068
8549,0,50,50,3,5,50.0,2.0,50.0,1068
8550,10,90,100,3,6,50.0,2.0,50.0,1068
8551,50,0,50,3,7,50.0,2.0,50.0,1068
8552,4,78,82,1,0,50.0,2.0,50.0,1069
8553,98,2,100,1,1,50.0,2.0,50.0,1069
8554,0,0,0,2,2,50.0,2.0,50.0,1069
8555,0,100,100,2,3,50.0,2.0,50.0,1069
8556,-16,16,0,3,4,50.0,2.0,50.0,1069
8557,2,12,14,3,5,50.0,2.0,50.0,1069
8558,95,0,95,3,6,50.0,2.0,50.0,1069
8559,-34,46,12,3,7,50.0,2.0,50.0,1069
8560,50,50,100,1,0,50.0,2.0,50.0,1070
8561,-50,50,0,1,1,50.0,2.0,50.0,1070
8562,50,50,100,2,2,50.0,2.0,50.0,1070
8563,50,50,100,2,3,50.0,2.0,50.0,1070
8564,50,50,100,3,4,50.0,2.0,50.0,1070
8565,50,50,100,3,5,50.0,2.0,50.0,1070
8566,50,50,100,3,6,50.0,2.0,50.0,1070
8567,50,50,100,3,7,50.0,2.0,50.0,1070
8568,36,58,94,1,0,50.0,2.0,50.0,1071
8569,47,53,100,1,1,50.0,2.0,50.0,1071
8570,-1,100,99,2,2,50.0,2.0,50.0,1071
8571,0,100,100,2,3,50.0,2.0,50.0,1071
8572,52,38,90,3,4,50.0,2.0,50.0,1071
8573,77,0,77,3,5,50.0,2.0,50.0,1071
8574,28,72,100,3,6,50.0,2.0,50.0,1071
8575,31,24,55,3,7,50.0,2.0,50.0,1071
8576,4,46,50,1,0,50.0,2.0,50.0,1072
8577,18,74,92,1,1,50.0,2.0,50.0,1072
8578,16,56,72,2,2,50.0,2.0,50.0,1072
8579,23,77,100,2,3,50.0,2.0,50.0,1072
8580,45,45,90,3,4,50.0,2.0,50.0,1072
8581,59,19,78,3,5,50.0,2.0,50.0,1072
8582,10,0,10,3,6,50.0,2.0,50.0,1072
8583,33,17,50,3,7,50.0,2.0,50.0,1072
8584,21,50,71,1,0,50.0,2.0,50.0,1073
8585,23,50,73,1,1,50.0,2.0,50.0,1073
8586,-29,49,20,2,2,50.0,2.0,50.0,1073
8587,24,68,92,2,3,50.0,2.0,50.0,1073
8588,68,25,93,3,4,50.0,2.0,50.0,1073
8589,17,79,96,3,5,50.0,2.0,50.0,1073
8590,85,0,85,3,6,50.0,2.0,50.0,1073
8591,-2,10,8,3,7,50.0,2.0,50.0,1073
8592,4,50,54,1,0,50.0,2.0,50.0,1074
8593,0,85,85,1,1,50.0,2.0,50.0,1074
8594,7,43,50,2,2,50.0,2.0,50.0,1074
8595,21,24,45,2,3,50.0,2.0,50.0,1074
8596,10,40,50,3,4,50.0,2.0,50.0,1074
8597,18,25,43,3,5,50.0,2.0,50.0,1074
8598,8,36,44,3,6,50.0,2.0,50.0,1074
8599,13,37,50,3,7,50.0,2.0,50.0,1074
8600,-12,38,26,1,0,50.0,2.0,50.0,1075
8601,1,79,80,1,1,50.0,2.0,50.0,1075
8602,-6,12,6,2,2,50.0,2.0,50.0,1075
8603,1,7,8,2,3,50.0,2.0,50.0,1075
8604,-14,75,61,3,4,50.0,2.0,50.0,1075
8605,5,8,13,3,5,50.0,2.0,50.0,1075
8606,-21,38,17,3,6,50.0,2.0,50.0,1075
8607,6,7,13,3,7,50.0,2.0,50.0,1075
8608,50,50,100,1,0,50.0,2.0,50.0,1076
8609,25,75,100,1,1,50.0,2.0,50.0,1076
8610,39,50,89,2,2,50.0,2.0,50.0,1076
8611,80,20,100,2,3,50.0,2.0,50.0,1076
8612,10,90,100,3,4,50.0,2.0,50.0,1076
8613,20,80,100,3,5,50.0,2.0,50.0,1076
8614,75,25,100,3,6,50.0,2.0,50.0,1076
8615,70,30,100,3,7,50.0,2.0,50.0,1076
8616,-19,59,40,1,0,50.0,2.0,50.0,1077
8617,-13,52,39,1,1,50.0,2.0,50.0,1077
8618,-16,50,34,2,2,50.0,2.0,50.0,1077
8619,0,100,100,2,3,50.0,2.0,50.0,1077
8620,-1,46,45,3,4,50.0,2.0,50.0,1077
8621,-10,57,47,3,5,50.0,2.0,50.0,1077
8622,-10,43,33,3,6,50.0,2.0,50.0,1077
8623,8,23,31,3,7,50.0,2.0,50.0,1077
8624,-1,52,51,1,0,50.0,2.0,50.0,1078
8625,31,69,100,1,1,50.0,2.0,50.0,1078
8626,1,49,50,2,2,50.0,2.0,50.0,1078
8627,0,50,50,2,3,50.0,2.0,50.0,1078
8628,0,100,100,3,4,50.0,2.0,50.0,1078
8629,0,0,0,3,5,50.0,2.0,50.0,1078
8630,0,100,100,3,6,50.0,2.0,50.0,1078
8631,0,0,0,3,7,50.0,2.0,50.0,1078
8632,24,35,59,1,0,50.0,2.0,50.0,1079
8633,7,51,58,1,1,50.0,2.0,50.0,1079
8634,-26,59,33,2,2,50.0,2.0,50.0,1079
8635,-48,98,50,2,3,50.0,2.0,50.0,1079
8636,-21,58,37,3,4,50.0,2.0,50.0,1079
8637,1,55,56,3,5,50.0,2.0,50.0,1079
8638,-46,77,31,3,6,50.0,2.0,50.0,1079
8639,39,26,65,3,7,50.0,2.0,50.0,1079
8640,17,50,67,1,0,50.0,2.0,50.0,1080
8641,-1,62,61,1,1,50.0,2.0,50.0,1080
8642,-34,59,25,2,2,50.0,2.0,50.0,1080
8643,0,50,50,2,3,50.0,2.0,50.0,1080
8644,12,60,72,3,4,50.0,2.0,50.0,1080
8645,-3,36,33,3,5,50.0,2.0,50.0,1080
8646,-2,32,30,3,6,50.0,2.0,50.0,1080
8647,-4,38,34,3,7,50.0,2.0,50.0,1080
8648,12,38,50,1,0,50.0,2.0,50.0,1081
8649,11,89,100,1,1,50.0,2.0,50.0,1081
8650,0,50,50,2,2,50.0,2.0,50.0,1081
8651,50,50,100,2,3,50.0,2.0,50.0,1081
8652,50,50,100,3,4,50.0,2.0,50.0,1081
8653,50,50,100,3,5,50.0,2.0,50.0,1081
8654,75,25,100,3,6,50.0,2.0,50.0,1081
8655,19,31,50,3,7,50.0,2.0,50.0,1081
8656,71,29,100,1,0,50.0,2.0,50.0,1082
8657,50,50,100,1,1,50.0,2.0,50.0,1082
8658,72,28,100,2,2,50.0,2.0,50.0,1082
8659,21,79,100,2,3,50.0,2.0,50.0,1082
8660,50,50,100,3,4,50.0,2.0,50.0,1082
8661,50,50,100,3,5,50.0,2.0,50.0,1082
8662,18,82,100,3,6,50.0,2.0,50.0,1082
8663,77,23,100,3,7,50.0,2.0,50.0,1082
8664,-1,1,0,1,0,50.0,2.0,50.0,1083
8665,99,1,100,1,1,50.0,2.0,50.0,1083
8666,6,94,100,2,2,50.0,2.0,50.0,1083
8667,100,0,100,2,3,50.0,2.0,50.0,1083
8668,50,50,100,3,4,50.0,2.0,50.0,1083
8669,50,50,100,3,5,50.0,2.0,50.0,1083
8670,50,50,100,3,6,50.0,2.0,50.0,1083
8671,97,3,100,3,7,50.0,2.0,50.0,1083
8672,30,20,50,1,0,50.0,2.0,50.0,1084
8673,15,65,80,1,1,50.0,2.0,50.0,1084
8674,0,50,50,2,2,50.0,2.0,50.0,1084
8675,-20,70,50,2,3,50.0,2.0,50.0,1084
8676,0,50,50,3,4,50.0,2.0,50.0,1084
8677,0,50,50,3,5,50.0,2.0,50.0,1084
8678,0,50,50,3,6,50.0,2.0,50.0,1084
8679,50,25,75,3,7,50.0,2.0,50.0,1084
8680,0,50,50,1,0,50.0,2.0,50.0,1085
8681,0,50,50,1,1,50.0,2.0,50.0,1085
8682,0,50,50,2,2,50.0,2.0,50.0,1085
8683,0,50,50,2,3,50.0,2.0,50.0,1085
8684,0,50,50,3,4,50.0,2.0,50.0,1085
8685,0,50,50,3,5,50.0,2.0,50.0,1085
8686,0,50,50,3,6,50.0,2.0,50.0,1085
8687,0,50,50,3,7,50.0,2.0,50.0,1085
8688,1,24,25,1,0,50.0,2.0,50.0,1086
8689,0,50,50,1,1,50.0,2.0,50.0,1086
8690,24,76,100,2,2,50.0,2.0,50.0,1086
8691,19,81,100,2,3,50.0,2.0,50.0,1086
8692,14,75,89,3,4,50.0,2.0,50.0,1086
8693,56,25,81,3,5,50.0,2.0,50.0,1086
8694,50,50,100,3,6,50.0,2.0,50.0,1086
8695,52,24,76,3,7,50.0,2.0,50.0,1086
8696,-16,16,0,1,0,50.0,2.0,50.0,1087
8697,52,48,100,1,1,50.0,2.0,50.0,1087
8698,46,54,100,2,2,50.0,2.0,50.0,1087
8699,50,50,100,2,3,50.0,2.0,50.0,1087
8700,36,64,100,3,4,50.0,2.0,50.0,1087
8701,31,69,100,3,5,50.0,2.0,50.0,1087
8702,81,19,100,3,6,50.0,2.0,50.0,1087
8703,85,15,100,3,7,50.0,2.0,50.0,1087
8704,2,50,52,1,0,50.0,2.0,50.0,1088
8705,3,50,53,1,1,50.0,2.0,50.0,1088
8706,0,50,50,2,2,50.0,2.0,50.0,1088
8707,49,51,100,2,3,50.0,2.0,50.0,1088
8708,-50,50,0,3,4,50.0,2.0,50.0,1088
8709,50,50,100,3,5,50.0,2.0,50.0,1088
8710,50,50,100,3,6,50.0,2.0,50.0,1088
8711,0,50,50,3,7,50.0,2.0,50.0,1088
8712,50,50,100,1,0,50.0,2.0,50.0,1089
8713,50,50,100,1,1,50.0,2.0,50.0,1089
8714,17,83,100,2,2,50.0,2.0,50.0,1089
8715,0,100,100,2,3,50.0,2.0,50.0,1089
8716,15,50,65,3,4,50.0,2.0,50.0,1089
8717,29,50,79,3,5,50.0,2.0,50.0,1089
8718,97,3,100,3,6,50.0,2.0,50.0,1089
8719,81,11,92,3,7,50.0,2.0,50.0,1089
8720,0,50,50,1,0,50.0,2.0,50.0,1090
8721,5,60,65,1,1,50.0,2.0,50.0,1090
8722,-3,75,72,2,2,50.0,2.0,50.0,1090
8723,10,50,60,2,3,50.0,2.0,50.0,1090
8724,0,50,50,3,4,50.0,2.0,50.0,1090
8725,34,2,36,3,5,50.0,2.0,50.0,1090
8726,10,80,90,3,6,50.0,2.0,50.0,1090
8727,91,0,91,3,7,50.0,2.0,50.0,1090
8728,-33,33,0,1,0,50.0,2.0,50.0,1091
8729,-47,74,27,1,1,50.0,2.0,50.0,1091
8730,-20,29,9,2,2,50.0,2.0,50.0,1091
8731,0,0,0,2,3,50.0,2.0,50.0,1091
8732,-7,73,66,3,4,50.0,2.0,50.0,1091
8733,-21,50,29,3,5,50.0,2.0,50.0,1091
8734,-17,40,23,3,6,50.0,2.0,50.0,1091
8735,0,0,0,3,7,50.0,2.0,50.0,1091
8736,50,50,100,1,0,50.0,2.0,50.0,1092
8737,-35,35,0,1,1,50.0,2.0,50.0,1092
8738,38,62,100,2,2,50.0,2.0,50.0,1092
8739,67,33,100,2,3,50.0,2.0,50.0,1092
8740,8,92,100,3,4,50.0,2.0,50.0,1092
8741,49,51,100,3,5,50.0,2.0,50.0,1092
8742,31,19,50,3,6,50.0,2.0,50.0,1092
8743,86,14,100,3,7,50.0,2.0,50.0,1092
8744,42,35,77,1,0,50.0,2.0,50.0,1093
8745,51,41,92,1,1,50.0,2.0,50.0,1093
8746,37,50,87,2,2,50.0,2.0,50.0,1093
8747,48,38,86,2,3,50.0,2.0,50.0,1093
8748,28,54,82,3,4,50.0,2.0,50.0,1093
8749,28,50,78,3,5,50.0,2.0,50.0,1093
8750,40,50,90,3,6,50.0,2.0,50.0,1093
8751,44,33,77,3,7,50.0,2.0,50.0,1093
8752,0,33,33,1,0,50.0,2.0,50.0,1094
8753,13,19,32,1,1,50.0,2.0,50.0,1094
8754,-4,62,58,2,2,50.0,2.0,50.0,1094
8755,-25,81,56,2,3,50.0,2.0,50.0,1094
8756,1,65,66,3,4,50.0,2.0,50.0,1094
8757,-8,58,50,3,5,50.0,2.0,50.0,1094
8758,-2,59,57,3,6,50.0,2.0,50.0,1094
8759,-5,47,42,3,7,50.0,2.0,50.0,1094
8760,-9,59,50,1,0,50.0,2.0,50.0,1095
8761,50,0,50,1,1,50.0,2.0,50.0,1095
8762,0,0,0,2,2,50.0,2.0,50.0,1095
8763,0,50,50,2,3,50.0,2.0,50.0,1095
8764,0,50,50,3,4,50.0,2.0,50.0,1095
8765,0,50,50,3,5,50.0,2.0,50.0,1095
8766,0,50,50,3,6,50.0,2.0,50.0,1095
8767,50,0,50,3,7,50.0,2.0,50.0,1095
8768,39,50,89,1,0,50.0,2.0,50.0,1096
8769,20,75,95,1,1,50.0,2.0,50.0,1096
8770,47,50,97,2,2,50.0,2.0,50.0,1096
8771,25,75,100,2,3,50.0,2.0,50.0,1096
8772,15,75,90,3,4,50.0,2.0,50.0,1096
8773,87,11,98,3,5,50.0,2.0,50.0,1096
8774,0,100,100,3,6,50.0,2.0,50.0,1096
8775,12,0,12,3,7,50.0,2.0,50.0,1096
8776,71,11,82,1,0,50.0,2.0,50.0,1097
8777,86,5,91,1,1,50.0,2.0,50.0,1097
8778,82,8,90,2,2,50.0,2.0,50.0,1097
8779,1,99,100,2,3,50.0,2.0,50.0,1097
8780,97,0,97,3,4,50.0,2.0,50.0,1097
8781,100,0,100,3,5,50.0,2.0,50.0,1097
8782,-1,93,92,3,6,50.0,2.0,50.0,1097
8783,80,7,87,3,7,50.0,2.0,50.0,1097
8784,-6,76,70,1,0,50.0,2.0,50.0,1098
8785,-60,80,20,1,1,50.0,2.0,50.0,1098
8786,-5,40,35,2,2,50.0,2.0,50.0,1098
8787,-1,1,0,2,3,50.0,2.0,50.0,1098
8788,0,41,41,3,4,50.0,2.0,50.0,1098
8789,15,27,42,3,5,50.0,2.0,50.0,1098
8790,-12,76,64,3,6,50.0,2.0,50.0,1098
8791,9,41,50,3,7,50.0,2.0,50.0,1098
8792,72,26,98,1,0,50.0,2.0,50.0,1099
8793,81,17,98,1,1,50.0,2.0,50.0,1099
8794,60,32,92,2,2,50.0,2.0,50.0,1099
8795,68,32,100,2,3,50.0,2.0,50.0,1099
8796,67,33,100,3,4,50.0,2.0,50.0,1099
8797,60,40,100,3,5,50.0,2.0,50.0,1099
8798,-13,13,0,3,6,50.0,2.0,50.0,1099
8799,70,21,91,3,7,50.0,2.0,50.0,1099
8800,10,8,18,1,0,50.0,2.0,50.0,1100
8801,15,10,25,1,1,50.0,2.0,50.0,1100
8802,0,100,100,2,2,50.0,2.0,50.0,1100
8803,10,80,90,2,3,50.0,2.0,50.0,1100
8804,50,25,75,3,4,50.0,2.0,50.0,1100
8805,50,50,100,3,5,50.0,2.0,50.0,1100
8806,5,95,100,3,6,50.0,2.0,50.0,1100
8807,22,3,25,3,7,50.0,2.0,50.0,1100
8808,-1,50,49,1,0,50.0,2.0,50.0,1101
8809,-11,50,39,1,1,50.0,2.0,50.0,1101
8810,-18,50,32,2,2,50.0,2.0,50.0,1101
8811,-2,100,98,2,3,50.0,2.0,50.0,1101
8812,16,50,66,3,4,50.0,2.0,50.0,1101
8813,-12,50,38,3,5,50.0,2.0,50.0,1101
8814,0,50,50,3,6,50.0,2.0,50.0,1101
8815,0,50,50,3,7,50.0,2.0,50.0,1101
8816,42,50,92,1,0,50.0,2.0,50.0,1102
8817,-7,7,0,1,1,50.0,2.0,50.0,1102
8818,2,48,50,2,2,50.0,2.0,50.0,1102
8819,16,83,99,2,3,50.0,2.0,50.0,1102
8820,85,15,100,3,4,50.0,2.0,50.0,1102
8821,-3,3,0,3,5,50.0,2.0,50.0,1102
8822,56,44,100,3,6,50.0,2.0,50.0,1102
8823,-50,50,0,3,7,50.0,2.0,50.0,1102
8824,-19,49,30,1,0,50.0,2.0,50.0,1103
8825,-25,25,0,1,1,50.0,2.0,50.0,1103
8826,10,90,100,2,2,50.0,2.0,50.0,1103
8827,13,87,100,2,3,50.0,2.0,50.0,1103
8828,38,62,100,3,4,50.0,2.0,50.0,1103
8829,49,51,100,3,5,50.0,2.0,50.0,1103
8830,16,84,100,3,6,50.0,2.0,50.0,1103
8831,-19,19,0,3,7,50.0,2.0,50.0,1103
8832,-9,26,17,1,0,50.0,2.0,50.0,1104
8833,10,80,90,1,1,50.0,2.0,50.0,1104
8834,29,50,79,2,2,50.0,2.0,50.0,1104
8835,15,17,32,2,3,50.0,2.0,50.0,1104
8836,-4,86,82,3,4,50.0,2.0,50.0,1104
8837,4,17,21,3,5,50.0,2.0,50.0,1104
8838,-74,85,11,3,6,50.0,2.0,50.0,1104
8839,2,22,24,3,7,50.0,2.0,50.0,1104
8840,-40,60,20,1,0,50.0,2.0,50.0,1105
8841,-4,22,18,1,1,50.0,2.0,50.0,1105
8842,-81,95,14,2,2,50.0,2.0,50.0,1105
8843,9,88,97,2,3,50.0,2.0,50.0,1105
8844,4,92,96,3,4,50.0,2.0,50.0,1105
8845,-7,99,92,3,5,50.0,2.0,50.0,1105
8846,-24,24,0,3,6,50.0,2.0,50.0,1105
8847,42,30,72,3,7,50.0,2.0,50.0,1105
8848,0,0,0,1,0,50.0,2.0,50.0,1106
8849,0,0,0,1,1,50.0,2.0,50.0,1106
8850,0,100,100,2,2,50.0,2.0,50.0,1106
8851,100,0,100,2,3,50.0,2.0,50.0,1106
8852,50,50,100,3,4,50.0,2.0,50.0,1106
8853,50,50,100,3,5,50.0,2.0,50.0,1106
8854,100,0,100,3,6,50.0,2.0,50.0,1106
8855,50,50,100,3,7,50.0,2.0,50.0,1106
8856,9,41,50,1,0,50.0,2.0,50.0,1107
8857,-1,49,48,1,1,50.0,2.0,50.0,1107
8858,-3,51,48,2,2,50.0,2.0,50.0,1107
8859,-1,37,36,2,3,50.0,2.0,50.0,1107
8860,-6,69,63,3,4,50.0,2.0,50.0,1107
8861,-3,30,27,3,5,50.0,2.0,50.0,1107
8862,6,43,49,3,6,50.0,2.0,50.0,1107
8863,-1,22,21,3,7,50.0,2.0,50.0,1107
8864,36,42,78,1,0,50.0,2.0,50.0,1108
8865,-1,82,81,1,1,50.0,2.0,50.0,1108
8866,-18,50,32,2,2,50.0,2.0,50.0,1108
8867,8,40,48,2,3,50.0,2.0,50.0,1108
8868,12,57,69,3,4,50.0,2.0,50.0,1108
8869,-30,50,20,3,5,50.0,2.0,50.0,1108
8870,50,33,83,3,6,50.0,2.0,50.0,1108
8871,-7,74,67,3,7,50.0,2.0,50.0,1108
8872,30,49,79,1,0,50.0,2.0,50.0,1109
8873,29,51,80,1,1,50.0,2.0,50.0,1109
8874,24,61,85,2,2,50.0,2.0,50.0,1109
8875,-10,61,51,2,3,50.0,2.0,50.0,1109
8876,1,41,42,3,4,50.0,2.0,50.0,1109
8877,52,41,93,3,5,50.0,2.0,50.0,1109
8878,11,36,47,3,6,50.0,2.0,50.0,1109
8879,39,46,85,3,7,50.0,2.0,50.0,1109
8880,-10,50,40,1,0,50.0,2.0,50.0,1110
8881,-14,50,36,1,1,50.0,2.0,50.0,1110
8882,-10,50,40,2,2,50.0,2.0,50.0,1110
8883,74,26,100,2,3,50.0,2.0,50.0,1110
8884,2,98,100,3,4,50.0,2.0,50.0,1110
8885,0,100,100,3,5,50.0,2.0,50.0,1110
8886,0,0,0,3,6,50.0,2.0,50.0,1110
8887,55,9,64,3,7,50.0,2.0,50.0,1110
8888,27,64,91,1,0,50.0,2.0,50.0,1111
8889,13,87,100,1,1,50.0,2.0,50.0,1111
8890,42,55,97,2,2,50.0,2.0,50.0,1111
8891,13,9,22,2,3,50.0,2.0,50.0,1111
8892,17,60,77,3,4,50.0,2.0,50.0,1111
8893,83,13,96,3,5,50.0,2.0,50.0,1111
8894,13,86,99,3,6,50.0,2.0,50.0,1111
8895,-44,50,6,3,7,50.0,2.0,50.0,1111
8896,26,17,43,1,0,50.0,2.0,50.0,1112
8897,6,22,28,1,1,50.0,2.0,50.0,1112
8898,5,58,63,2,2,50.0,2.0,50.0,1112
8899,-9,85,76,2,3,50.0,2.0,50.0,1112
8900,-9,74,65,3,4,50.0,2.0,50.0,1112
8901,9,50,59,3,5,50.0,2.0,50.0,1112
8902,-2,29,27,3,6,50.0,2.0,50.0,1112
8903,17,16,33,3,7,50.0,2.0,50.0,1112
8904,75,20,95,1,0,50.0,2.0,50.0,1113
8905,62,30,92,1,1,50.0,2.0,50.0,1113
8906,53,40,93,2,2,50.0,2.0,50.0,1113
8907,93,0,93,2,3,50.0,2.0,50.0,1113
8908,39,60,99,3,4,50.0,2.0,50.0,1113
8909,49,50,99,3,5,50.0,2.0,50.0,1113
8910,79,20,99,3,6,50.0,2.0,50.0,1113
8911,93,0,93,3,7,50.0,2.0,50.0,1113
8912,-28,29,1,1,0,50.0,2.0,50.0,1114
8913,74,26,100,1,1,50.0,2.0,50.0,1114
8914,0,3,3,2,2,50.0,2.0,50.0,1114
8915,40,60,100,2,3,50.0,2.0,50.0,1114
8916,16,84,100,3,4,50.0,2.0,50.0,1114
8917,82,17,99,3,5,50.0,2.0,50.0,1114
8918,78,22,100,3,6,50.0,2.0,50.0,1114
8919,89,11,100,3,7,50.0,2.0,50.0,1114
8920,39,24,63,1,0,50.0,2.0,50.0,1115
8921,25,41,66,1,1,50.0,2.0,50.0,1115
8922,35,23,58,2,2,50.0,2.0,50.0,1115
8923,58,25,83,2,3,50.0,2.0,50.0,1115
8924,23,40,63,3,4,50.0,2.0,50.0,1115
8925,39,24,63,3,5,50.0,2.0,50.0,1115
8926,39,50,89,3,6,50.0,2.0,50.0,1115
8927,37,13,50,3,7,50.0,2.0,50.0,1115
8928,77,7,84,1,0,50.0,2.0,50.0,1116
8929,97,3,100,1,1,50.0,2.0,50.0,1116
8930,-7,7,0,2,2,50.0,2.0,50.0,1116
8931,34,66,100,2,3,50.0,2.0,50.0,1116
8932,38,62,100,3,4,50.0,2.0,50.0,1116
8933,12,88,100,3,5,50.0,2.0,50.0,1116
8934,17,83,100,3,6,50.0,2.0,50.0,1116
8935,0,0,0,3,7,50.0,2.0,50.0,1116
8936,50,0,50,1,0,50.0,2.0,50.0,1117
8937,7,50,57,1,1,50.0,2.0,50.0,1117
8938,20,56,76,2,2,50.0,2.0,50.0,1117
8939,0,50,50,2,3,50.0,2.0,50.0,1117
8940,24,76,100,3,4,50.0,2.0,50.0,1117
8941,45,11,56,3,5,50.0,2.0,50.0,1117
8942,0,72,72,3,6,50.0,2.0,50.0,1117
8943,0,0,0,3,7,50.0,2.0,50.0,1117
8944,0,50,50,1,0,50.0,2.0,50.0,1118
8945,0,100,100,1,1,50.0,2.0,50.0,1118
8946,1,9,10,2,2,50.0,2.0,50.0,1118
8947,0,75,75,2,3,50.0,2.0,50.0,1118
8948,-8,70,62,3,4,50.0,2.0,50.0,1118
8949,1,4,5,3,5,50.0,2.0,50.0,1118
8950,0,83,83,3,6,50.0,2.0,50.0,1118
8951,0,0,0,3,7,50.0,2.0,50.0,1118
8952,0,50,50,1,0,50.0,2.0,50.0,1119
8953,43,28,71,1,1,50.0,2.0,50.0,1119
8954,25,50,75,2,2,50.0,2.0,50.0,1119
8955,-1,26,25,2,3,50.0,2.0,50.0,1119
8956,39,38,77,3,4,50.0,2.0,50.0,1119
8957,52,25,77,3,5,50.0,2.0,50.0,1119
8958,27,65,92,3,6,50.0,2.0,50.0,1119
8959,53,19,72,3,7,50.0,2.0,50.0,1119
8960,50,0,50,1,0,50.0,2.0,50.0,1120
8961,24,0,24,1,1,50.0,2.0,50.0,1120
8962,15,85,100,2,2,50.0,2.0,50.0,1120
8963,42,50,92,2,3,50.0,2.0,50.0,1120
8964,37,63,100,3,4,50.0,2.0,50.0,1120
8965,100,0,100,3,5,50.0,2.0,50.0,1120
8966,0,100,100,3,6,50.0,2.0,50.0,1120
8967,75,1,76,3,7,50.0,2.0,50.0,1120
8968,100,0,100,1,0,50.0,2.0,50.0,1121
8969,99,1,100,1,1,50.0,2.0,50.0,1121
8970,94,6,100,2,2,50.0,2.0,50.0,1121
8971,89,11,100,2,3,50.0,2.0,50.0,1121
8972,22,78,100,3,4,50.0,2.0,50.0,1121
8973,90,10,100,3,5,50.0,2.0,50.0,1121
8974,0,100,100,3,6,50.0,2.0,50.0,1121
8975,100,0,100,3,7,50.0,2.0,50.0,1121
8976,87,0,87,1,0,50.0,2.0,50.0,1122
8977,0,69,69,1,1,50.0,2.0,50.0,1122
8978,-5,95,90,2,2,50.0,2.0,50.0,1122
8979,2,98,100,2,3,50.0,2.0,50.0,1122
8980,12,88,100,3,4,50.0,2.0,50.0,1122
8981,54,16,70,3,5,50.0,2.0,50.0,1122
8982,46,54,100,3,6,50.0,2.0,50.0,1122
8983,77,2,79,3,7,50.0,2.0,50.0,1122
8984,-2,20,18,1,0,50.0,2.0,50.0,1123
8985,42,23,65,1,1,50.0,2.0,50.0,1123
8986,-50,50,0,2,2,50.0,2.0,50.0,1123
8987,-10,10,0,2,3,50.0,2.0,50.0,1123
8988,-3,22,19,3,4,50.0,2.0,50.0,1123
8989,50,0,50,3,5,50.0,2.0,50.0,1123
8990,0,100,100,3,6,50.0,2.0,50.0,1123
8991,-4,4,0,3,7,50.0,2.0,50.0,1123
8992,36,64,100,1,0,50.0,2.0,50.0,1124
8993,100,0,100,1,1,50.0,2.0,50.0,1124
8994,50,50,100,2,2,50.0,2.0,50.0,1124
8995,0,100,100,2,3,50.0,2.0,50.0,1124
8996,50,50,100,3,4,50.0,2.0,50.0,1124
8997,50,50,100,3,5,50.0,2.0,50.0,1124
8998,100,0,100,3,6,50.0,2.0,50.0,1124
8999,90,10,100,3,7,50.0,2.0,50.0,1124
9000,19,50,69,1,0,50.0,2.0,50.0,1125
9001,0,50,50,1,1,50.0,2.0,50.0,1125
9002,42,50,92,2,2,50.0,2.0,50.0,1125
9003,8,50,58,2,3,50.0,2.0,50.0,1125
9004,32,63,95,3,4,50.0,2.0,50.0,1125
9005,31,50,81,3,5,50.0,2.0,50.0,1125
9006,12,87,99,3,6,50.0,2.0,50.0,1125
9007,46,50,96,3,7,50.0,2.0,50.0,1125
9008,46,39,85,1,0,50.0,2.0,50.0,1126
9009,-48,50,2,1,1,50.0,2.0,50.0,1126
9010,-50,50,0,2,2,50.0,2.0,50.0,1126
9011,-54,63,9,2,3,50.0,2.0,50.0,1126
9012,62,38,100,3,4,50.0,2.0,50.0,1126
9013,69,29,98,3,5,50.0,2.0,50.0,1126
9014,43,32,75,3,6,50.0,2.0,50.0,1126
9015,-22,23,1,3,7,50.0,2.0,50.0,1126
9016,40,54,94,1,0,50.0,2.0,50.0,1127
9017,17,66,83,1,1,50.0,2.0,50.0,1127
9018,13,75,88,2,2,50.0,2.0,50.0,1127
9019,0,100,100,2,3,50.0,2.0,50.0,1127
9020,51,49,100,3,4,50.0,2.0,50.0,1127
9021,20,76,96,3,5,50.0,2.0,50.0,1127
9022,39,61,100,3,6,50.0,2.0,50.0,1127
9023,33,67,100,3,7,50.0,2.0,50.0,1127
9024,0,50,50,1,0,50.0,2.0,50.0,1128
9025,0,50,50,1,1,50.0,2.0,50.0,1128
9026,0,50,50,2,2,50.0,2.0,50.0,1128
9027,0,50,50,2,3,50.0,2.0,50.0,1128
9028,0,50,50,3,4,50.0,2.0,50.0,1128
9029,0,50,50,3,5,50.0,2.0,50.0,1128
9030,0,50,50,3,6,50.0,2.0,50.0,1128
9031,0,50,50,3,7,50.0,2.0,50.0,1128
9032,24,36,60,1,0,50.0,2.0,50.0,1129
9033,36,31,67,1,1,50.0,2.0,50.0,1129
9034,9,75,84,2,2,50.0,2.0,50.0,1129
9035,6,94,100,2,3,50.0,2.0,50.0,1129
9036,14,50,64,3,4,50.0,2.0,50.0,1129
9037,11,50,61,3,5,50.0,2.0,50.0,1129
9038,11,50,61,3,6,50.0,2.0,50.0,1129
9039,45,5,50,3,7,50.0,2.0,50.0,1129
9040,90,6,96,1,0,50.0,2.0,50.0,1130
9041,12,88,100,1,1,50.0,2.0,50.0,1130
9042,87,13,100,2,2,50.0,2.0,50.0,1130
9043,50,50,100,2,3,50.0,2.0,50.0,1130
9044,0,0,0,3,4,50.0,2.0,50.0,1130
9045,0,0,0,3,5,50.0,2.0,50.0,1130
9046,-1,1,0,3,6,50.0,2.0,50.0,1130
9047,99,0,99,3,7,50.0,2.0,50.0,1130
9048,-64,64,0,1,0,50.0,2.0,50.0,1131
9049,0,0,0,1,1,50.0,2.0,50.0,1131
9050,0,0,0,2,2,50.0,2.0,50.0,1131
9051,0,100,100,2,3,50.0,2.0,50.0,1131
9052,0,100,100,3,4,50.0,2.0,50.0,1131
9053,-3,3,0,3,5,50.0,2.0,50.0,1131
9054,0,0,0,3,6,50.0,2.0,50.0,1131
9055,0,0,0,3,7,50.0,2.0,50.0,1131
9056,15,35,50,1,0,50.0,2.0,50.0,1132
9057,-7,57,50,1,1,50.0,2.0,50.0,1132
9058,-9,50,41,2,2,50.0,2.0,50.0,1132
9059,-2,67,65,2,3,50.0,2.0,50.0,1132
9060,-9,59,50,3,4,50.0,2.0,50.0,1132
9061,40,60,100,3,5,50.0,2.0,50.0,1132
9062,5,84,89,3,6,50.0,2.0,50.0,1132
9063,54,14,68,3,7,50.0,2.0,50.0,1132
9064,-20,38,18,1,0,50.0,2.0,50.0,1133
9065,21,46,67,1,1,50.0,2.0,50.0,1133
9066,-19,36,17,2,2,50.0,2.0,50.0,1133
9067,5,94,99,2,3,50.0,2.0,50.0,1133
9068,-51,73,22,3,4,50.0,2.0,50.0,1133
9069,-8,8,0,3,5,50.0,2.0,50.0,1133
9070,35,15,50,3,6,50.0,2.0,50.0,1133
9071,0,0,0,3,7,50.0,2.0,50.0,1133
9072,22,28,50,1,0,50.0,2.0,50.0,1134
9073,47,23,70,1,1,50.0,2.0,50.0,1134
9074,17,50,67,2,2,50.0,2.0,50.0,1134
9075,21,50,71,2,3,50.0,2.0,50.0,1134
9076,18,50,68,3,4,50.0,2.0,50.0,1134
9077,57,31,88,3,5,50.0,2.0,50.0,1134
9078,11,74,85,3,6,50.0,2.0,50.0,1134
9079,64,13,77,3,7,50.0,2.0,50.0,1134
9080,1,49,50,1,0,50.0,2.0,50.0,1135
9081,0,100,100,1,1,50.0,2.0,50.0,1135
9082,5,81,86,2,2,50.0,2.0,50.0,1135
9083,21,75,96,2,3,50.0,2.0,50.0,1135
9084,19,81,100,3,4,50.0,2.0,50.0,1135
9085,-4,54,50,3,5,50.0,2.0,50.0,1135
9086,0,100,100,3,6,50.0,2.0,50.0,1135
9087,-6,6,0,3,7,50.0,2.0,50.0,1135
9088,26,50,76,1,0,50.0,2.0,50.0,1136
9089,83,5,88,1,1,50.0,2.0,50.0,1136
9090,11,75,86,2,2,50.0,2.0,50.0,1136
9091,-5,100,95,2,3,50.0,2.0,50.0,1136
9092,64,25,89,3,4,50.0,2.0,50.0,1136
9093,88,5,93,3,5,50.0,2.0,50.0,1136
9094,10,90,100,3,6,50.0,2.0,50.0,1136
9095,82,6,88,3,7,50.0,2.0,50.0,1136
9096,-29,50,21,1,0,50.0,2.0,50.0,1137
9097,0,50,50,1,1,50.0,2.0,50.0,1137
9098,0,50,50,2,2,50.0,2.0,50.0,1137
9099,0,50,50,2,3,50.0,2.0,50.0,1137
9100,-7,39,32,3,4,50.0,2.0,50.0,1137
9101,-5,40,35,3,5,50.0,2.0,50.0,1137
9102,0,0,0,3,6,50.0,2.0,50.0,1137
9103,-10,35,25,3,7,50.0,2.0,50.0,1137
9104,51,49,100,1,0,50.0,2.0,50.0,1138
9105,23,77,100,1,1,50.0,2.0,50.0,1138
9106,59,41,100,2,2,50.0,2.0,50.0,1138
9107,50,50,100,2,3,50.0,2.0,50.0,1138
9108,50,50,100,3,4,50.0,2.0,50.0,1138
9109,50,50,100,3,5,50.0,2.0,50.0,1138
9110,6,94,100,3,6,50.0,2.0,50.0,1138
9111,83,17,100,3,7,50.0,2.0,50.0,1138
9112,50,0,50,1,0,50.0,2.0,50.0,1139
9113,0,0,0,1,1,50.0,2.0,50.0,1139
9114,10,90,100,2,2,50.0,2.0,50.0,1139
9115,-25,75,50,2,3,50.0,2.0,50.0,1139
9116,-10,60,50,3,4,50.0,2.0,50.0,1139
9117,40,60,100,3,5,50.0,2.0,50.0,1139
9118,0,50,50,3,6,50.0,2.0,50.0,1139
9119,-20,20,0,3,7,50.0,2.0,50.0,1139
9120,100,0,100,1,0,50.0,2.0,50.0,1140
9121,100,0,100,1,1,50.0,2.0,50.0,1140
9122,-68,68,0,2,2,50.0,2.0,50.0,1140
9123,73,27,100,2,3,50.0,2.0,50.0,1140
9124,64,36,100,3,4,50.0,2.0,50.0,1140
9125,100,0,100,3,5,50.0,2.0,50.0,1140
9126,57,43,100,3,6,50.0,2.0,50.0,1140
9127,100,0,100,3,7,50.0,2.0,50.0,1140
9128,51,49,100,1,0,50.0,2.0,50.0,1141
9129,22,78,100,1,1,50.0,2.0,50.0,1141
9130,75,25,100,2,2,50.0,2.0,50.0,1141
9131,44,56,100,2,3,50.0,2.0,50.0,1141
9132,51,49,100,3,4,50.0,2.0,50.0,1141
9133,69,31,100,3,5,50.0,2.0,50.0,1141
9134,23,77,100,3,6,50.0,2.0,50.0,1141
9135,70,30,100,3,7,50.0,2.0,50.0,1141
9136,62,11,73,1,0,50.0,2.0,50.0,1142
9137,17,75,92,1,1,50.0,2.0,50.0,1142
9138,27,50,77,2,2,50.0,2.0,50.0,1142
9139,2,0,2,2,3,50.0,2.0,50.0,1142
9140,16,84,100,3,4,50.0,2.0,50.0,1142
9141,41,50,91,3,5,50.0,2.0,50.0,1142
9142,10,90,100,3,6,50.0,2.0,50.0,1142
9143,30,0,30,3,7,50.0,2.0,50.0,1142
9144,16,44,60,1,0,50.0,2.0,50.0,1143
9145,100,0,100,1,1,50.0,2.0,50.0,1143
9146,37,50,87,2,2,50.0,2.0,50.0,1143
9147,59,41,100,2,3,50.0,2.0,50.0,1143
9148,21,53,74,3,4,50.0,2.0,50.0,1143
9149,43,57,100,3,5,50.0,2.0,50.0,1143
9150,64,36,100,3,6,50.0,2.0,50.0,1143
9151,66,4,70,3,7,50.0,2.0,50.0,1143
9152,100,0,100,1,0,50.0,2.0,50.0,1144
9153,0,0,0,1,1,50.0,2.0,50.0,1144
9154,-100,100,0,2,2,50.0,2.0,50.0,1144
9155,0,100,100,2,3,50.0,2.0,50.0,1144
9156,36,64,100,3,4,50.0,2.0,50.0,1144
9157,100,0,100,3,5,50.0,2.0,50.0,1144
9158,70,30,100,3,6,50.0,2.0,50.0,1144
9159,100,0,100,3,7,50.0,2.0,50.0,1144
9160,37,55,92,1,0,50.0,2.0,50.0,1145
9161,20,59,79,1,1,50.0,2.0,50.0,1145
9162,35,58,93,2,2,50.0,2.0,50.0,1145
9163,31,52,83,2,3,50.0,2.0,50.0,1145
9164,0,100,100,3,4,50.0,2.0,50.0,1145
9165,38,56,94,3,5,50.0,2.0,50.0,1145
9166,0,0,0,3,6,50.0,2.0,50.0,1145
9167,55,25,80,3,7,50.0,2.0,50.0,1145
9168,48,33,81,1,0,50.0,2.0,50.0,1146
9169,-66,83,17,1,1,50.0,2.0,50.0,1146
9170,14,80,94,2,2,50.0,2.0,50.0,1146
9171,71,27,98,2,3,50.0,2.0,50.0,1146
9172,48,27,75,3,4,50.0,2.0,50.0,1146
9173,-7,88,81,3,5,50.0,2.0,50.0,1146
9174,4,24,28,3,6,50.0,2.0,50.0,1146
9175,80,0,80,3,7,50.0,2.0,50.0,1146
9176,0,0,0,1,0,50.0,2.0,50.0,1147
9177,0,0,0,1,1,50.0,2.0,50.0,1147
9178,0,0,0,2,2,50.0,2.0,50.0,1147
9179,0,80,80,2,3,50.0,2.0,50.0,1147
9180,0,0,0,3,4,50.0,2.0,50.0,1147
9181,0,0,0,3,5,50.0,2.0,50.0,1147
9182,0,0,0,3,6,50.0,2.0,50.0,1147
9183,0,0,0,3,7,50.0,2.0,50.0,1147
9184,13,50,63,1,0,50.0,2.0,50.0,1148
9185,24,0,24,1,1,50.0,2.0,50.0,1148
9186,0,50,50,2,2,50.0,2.0,50.0,1148
9187,6,11,17,2,3,50.0,2.0,50.0,1148
9188,8,63,71,3,4,50.0,2.0,50.0,1148
9189,13,61,74,3,5,50.0,2.0,50.0,1148
9190,19,65,84,3,6,50.0,2.0,50.0,1148
9191,17,10,27,3,7,50.0,2.0,50.0,1148
9192,-46,50,4,1,0,50.0,2.0,50.0,1149
9193,2,50,52,1,1,50.0,2.0,50.0,1149
9194,1,50,51,2,2,50.0,2.0,50.0,1149
9195,50,50,100,2,3,50.0,2.0,50.0,1149
9196,0,50,50,3,4,50.0,2.0,50.0,1149
9197,50,50,100,3,5,50.0,2.0,50.0,1149
9198,50,50,100,3,6,50.0,2.0,50.0,1149
9199,100,0,100,3,7,50.0,2.0,50.0,1149
9200,82,18,100,1,0,50.0,2.0,50.0,1150
9201,22,78,100,1,1,50.0,2.0,50.0,1150
9202,0,100,100,2,2,50.0,2.0,50.0,1150
9203,0,100,100,2,3,50.0,2.0,50.0,1150
9204,0,100,100,3,4,50.0,2.0,50.0,1150
9205,50,50,100,3,5,50.0,2.0,50.0,1150
9206,8,92,100,3,6,50.0,2.0,50.0,1150
9207,81,19,100,3,7,50.0,2.0,50.0,1150
9208,100,0,100,1,0,50.0,2.0,50.0,1151
9209,0,50,50,1,1,50.0,2.0,50.0,1151
9210,50,50,100,2,2,50.0,2.0,50.0,1151
9211,23,77,100,2,3,50.0,2.0,50.0,1151
9212,20,80,100,3,4,50.0,2.0,50.0,1151
9213,95,5,100,3,5,50.0,2.0,50.0,1151
9214,0,50,50,3,6,50.0,2.0,50.0,1151
9215,100,0,100,3,7,50.0,2.0,50.0,1151
9216,-42,50,8,1,0,50.0,2.0,50.0,1152
9217,36,59,95,1,1,50.0,2.0,50.0,1152
9218,40,50,90,2,2,50.0,2.0,50.0,1152
9219,43,50,93,2,3,50.0,2.0,50.0,1152
9220,38,56,94,3,4,50.0,2.0,50.0,1152
9221,46,44,90,3,5,50.0,2.0,50.0,1152
9222,0,93,93,3,6,50.0,2.0,50.0,1152
9223,58,30,88,3,7,50.0,2.0,50.0,1152
9224,50,50,100,1,0,50.0,2.0,50.0,1153
9225,3,0,3,1,1,50.0,2.0,50.0,1153
9226,49,1,50,2,2,50.0,2.0,50.0,1153
9227,0,50,50,2,3,50.0,2.0,50.0,1153
9228,65,35,100,3,4,50.0,2.0,50.0,1153
9229,97,3,100,3,5,50.0,2.0,50.0,1153
9230,50,50,100,3,6,50.0,2.0,50.0,1153
9231,99,0,99,3,7,50.0,2.0,50.0,1153
9232,50,50,100,1,0,50.0,2.0,50.0,1154
9233,100,0,100,1,1,50.0,2.0,50.0,1154
9234,50,50,100,2,2,50.0,2.0,50.0,1154
9235,0,100,100,2,3,50.0,2.0,50.0,1154
9236,50,50,100,3,4,50.0,2.0,50.0,1154
9237,100,0,100,3,5,50.0,2.0,50.0,1154
9238,100,0,100,3,6,50.0,2.0,50.0,1154
9239,100,0,100,3,7,50.0,2.0,50.0,1154
9240,10,0,10,1,0,50.0,2.0,50.0,1155
9241,-50,50,0,1,1,50.0,2.0,50.0,1155
9242,-50,50,0,2,2,50.0,2.0,50.0,1155
9243,0,50,50,2,3,50.0,2.0,50.0,1155
9244,0,100,100,3,4,50.0,2.0,50.0,1155
9245,9,76,85,3,5,50.0,2.0,50.0,1155
9246,0,50,50,3,6,50.0,2.0,50.0,1155
9247,-35,35,0,3,7,50.0,2.0,50.0,1155
9248,14,86,100,1,0,50.0,2.0,50.0,1156
9249,3,97,100,1,1,50.0,2.0,50.0,1156
9250,49,1,50,2,2,50.0,2.0,50.0,1156
9251,70,5,75,2,3,50.0,2.0,50.0,1156
9252,17,80,97,3,4,50.0,2.0,50.0,1156
9253,43,50,93,3,5,50.0,2.0,50.0,1156
9254,15,75,90,3,6,50.0,2.0,50.0,1156
9255,22,55,77,3,7,50.0,2.0,50.0,1156
9256,-3,50,47,1,0,50.0,2.0,50.0,1157
9257,-43,62,19,1,1,50.0,2.0,50.0,1157
9258,-10,60,50,2,2,50.0,2.0,50.0,1157
9259,-4,47,43,2,3,50.0,2.0,50.0,1157
9260,3,44,47,3,4,50.0,2.0,50.0,1157
9261,20,30,50,3,5,50.0,2.0,50.0,1157
9262,-9,59,50,3,6,50.0,2.0,50.0,1157
9263,-18,68,50,3,7,50.0,2.0,50.0,1157
9264,34,50,84,1,0,50.0,2.0,50.0,1158
9265,43,50,93,1,1,50.0,2.0,50.0,1158
9266,0,50,50,2,2,50.0,2.0,50.0,1158
9267,45,42,87,2,3,50.0,2.0,50.0,1158
9268,-15,65,50,3,4,50.0,2.0,50.0,1158
9269,77,11,88,3,5,50.0,2.0,50.0,1158
9270,73,27,100,3,6,50.0,2.0,50.0,1158
9271,71,12,83,3,7,50.0,2.0,50.0,1158
9272,0,50,50,1,0,50.0,2.0,50.0,1159
9273,0,50,50,1,1,50.0,2.0,50.0,1159
9274,0,50,50,2,2,50.0,2.0,50.0,1159
9275,-50,50,0,2,3,50.0,2.0,50.0,1159
9276,0,50,50,3,4,50.0,2.0,50.0,1159
9277,-50,50,0,3,5,50.0,2.0,50.0,1159
9278,0,50,50,3,6,50.0,2.0,50.0,1159
9279,-50,50,0,3,7,50.0,2.0,50.0,1159
9280,80,20,100,1,0,50.0,2.0,50.0,1160
9281,70,30,100,1,1,50.0,2.0,50.0,1160
9282,24,76,100,2,2,50.0,2.0,50.0,1160
9283,35,65,100,2,3,50.0,2.0,50.0,1160
9284,40,60,100,3,4,50.0,2.0,50.0,1160
9285,50,50,100,3,5,50.0,2.0,50.0,1160
9286,24,76,100,3,6,50.0,2.0,50.0,1160
9287,80,20,100,3,7,50.0,2.0,50.0,1160
9288,0,0,0,1,0,50.0,2.0,50.0,1161
9289,0,0,0,1,1,50.0,2.0,50.0,1161
9290,0,100,100,2,2,50.0,2.0,50.0,1161
9291,0,0,0,2,3,50.0,2.0,50.0,1161
9292,0,100,100,3,4,50.0,2.0,50.0,1161
9293,-100,100,0,3,5,50.0,2.0,50.0,1161
9294,100,0,100,3,6,50.0,2.0,50.0,1161
9295,0,0,0,3,7,50.0,2.0,50.0,1161
9296,2,48,50,1,0,50.0,2.0,50.0,1162
9297,17,33,50,1,1,50.0,2.0,50.0,1162
9298,0,50,50,2,2,50.0,2.0,50.0,1162
9299,0,50,50,2,3,50.0,2.0,50.0,1162
9300,-20,70,50,3,4,50.0,2.0,50.0,1162
9301,57,40,97,3,5,50.0,2.0,50.0,1162
9302,79,20,99,3,6,50.0,2.0,50.0,1162
9303,59,41,100,3,7,50.0,2.0,50.0,1162
9304,0,0,0,1,0,50.0,2.0,50.0,1163
9305,50,50,100,1,1,50.0,2.0,50.0,1163
9306,-8,31,23,2,2,50.0,2.0,50.0,1163
9307,0,0,0,2,3,50.0,2.0,50.0,1163
9308,11,77,88,3,4,50.0,2.0,50.0,1163
9309,0,0,0,3,5,50.0,2.0,50.0,1163
9310,22,6,28,3,6,50.0,2.0,50.0,1163
9311,6,0,6,3,7,50.0,2.0,50.0,1163
9312,79,13,92,1,0,50.0,2.0,50.0,1164
9313,44,42,86,1,1,50.0,2.0,50.0,1164
9314,58,38,96,2,2,50.0,2.0,50.0,1164
9315,6,94,100,2,3,50.0,2.0,50.0,1164
9316,14,76,90,3,4,50.0,2.0,50.0,1164
9317,44,50,94,3,5,50.0,2.0,50.0,1164
9318,65,28,93,3,6,50.0,2.0,50.0,1164
9319,71,24,95,3,7,50.0,2.0,50.0,1164
9320,50,50,100,1,0,50.0,2.0,50.0,1165
9321,34,66,100,1,1,50.0,2.0,50.0,1165
9322,50,50,100,2,2,50.0,2.0,50.0,1165
9323,100,0,100,2,3,50.0,2.0,50.0,1165
9324,25,75,100,3,4,50.0,2.0,50.0,1165
9325,50,50,100,3,5,50.0,2.0,50.0,1165
9326,100,0,100,3,6,50.0,2.0,50.0,1165
9327,100,0,100,3,7,50.0,2.0,50.0,1165
9328,26,40,66,1,0,50.0,2.0,50.0,1166
9329,40,60,100,1,1,50.0,2.0,50.0,1166
9330,5,55,60,2,2,50.0,2.0,50.0,1166
9331,30,70,100,2,3,50.0,2.0,50.0,1166
9332,36,64,100,3,4,50.0,2.0,50.0,1166
9333,50,50,100,3,5,50.0,2.0,50.0,1166
9334,50,50,100,3,6,50.0,2.0,50.0,1166
9335,3,30,33,3,7,50.0,2.0,50.0,1166
9336,100,0,100,1,0,50.0,2.0,50.0,1167
9337,0,100,100,1,1,50.0,2.0,50.0,1167
9338,0,0,0,2,2,50.0,2.0,50.0,1167
9339,99,1,100,2,3,50.0,2.0,50.0,1167
9340,100,0,100,3,4,50.0,2.0,50.0,1167
9341,50,50,100,3,5,50.0,2.0,50.0,1167
9342,0,0,0,3,6,50.0,2.0,50.0,1167
9343,0,0,0,3,7,50.0,2.0,50.0,1167
9344,59,0,59,1,0,50.0,2.0,50.0,1168
9345,47,11,58,1,1,50.0,2.0,50.0,1168
9346,-25,79,54,2,2,50.0,2.0,50.0,1168
9347,-2,83,81,2,3,50.0,2.0,50.0,1168
9348,11,77,88,3,4,50.0,2.0,50.0,1168
9349,-2,55,53,3,5,50.0,2.0,50.0,1168
9350,1,54,55,3,6,50.0,2.0,50.0,1168
9351,66,6,72,3,7,50.0,2.0,50.0,1168
9352,100,0,100,1,0,50.0,2.0,50.0,1169
9353,100,0,100,1,1,50.0,2.0,50.0,1169
9354,100,0,100,2,2,50.0,2.0,50.0,1169
9355,0,0,0,2,3,50.0,2.0,50.0,1169
9356,25,75,100,3,4,50.0,2.0,50.0,1169
9357,25,75,100,3,5,50.0,2.0,50.0,1169
9358,100,0,100,3,6,50.0,2.0,50.0,1169
9359,0,0,0,3,7,50.0,2.0,50.0,1169
9360,16,49,65,1,0,50.0,2.0,50.0,1170
9361,3,77,80,1,1,50.0,2.0,50.0,1170
9362,15,55,70,2,2,50.0,2.0,50.0,1170
9363,0,100,100,2,3,50.0,2.0,50.0,1170
9364,25,50,75,3,4,50.0,2.0,50.0,1170
9365,22,38,60,3,5,50.0,2.0,50.0,1170
9366,10,90,100,3,6,50.0,2.0,50.0,1170
9367,22,30,52,3,7,50.0,2.0,50.0,1170
9368,0,100,100,1,0,50.0,2.0,50.0,1171
9369,10,90,100,1,1,50.0,2.0,50.0,1171
9370,30,0,30,2,2,50.0,2.0,50.0,1171
9371,20,0,20,2,3,50.0,2.0,50.0,1171
9372,35,60,95,3,4,50.0,2.0,50.0,1171
9373,90,0,90,3,5,50.0,2.0,50.0,1171
9374,-100,100,0,3,6,50.0,2.0,50.0,1171
9375,40,40,80,3,7,50.0,2.0,50.0,1171
9376,99,1,100,1,0,50.0,2.0,50.0,1172
9377,50,50,100,1,1,50.0,2.0,50.0,1172
9378,50,50,100,2,2,50.0,2.0,50.0,1172
9379,0,100,100,2,3,50.0,2.0,50.0,1172
9380,23,77,100,3,4,50.0,2.0,50.0,1172
9381,0,100,100,3,5,50.0,2.0,50.0,1172
9382,50,50,100,3,6,50.0,2.0,50.0,1172
9383,-33,33,0,3,7,50.0,2.0,50.0,1172
9384,0,0,0,1,0,50.0,2.0,50.0,1173
9385,0,100,100,1,1,50.0,2.0,50.0,1173
9386,0,0,0,2,2,50.0,2.0,50.0,1173
9387,29,50,79,2,3,50.0,2.0,50.0,1173
9388,-11,24,13,3,4,50.0,2.0,50.0,1173
9389,-6,6,0,3,5,50.0,2.0,50.0,1173
9390,-28,52,24,3,6,50.0,2.0,50.0,1173
9391,0,0,0,3,7,50.0,2.0,50.0,1173
9392,38,37,75,1,0,50.0,2.0,50.0,1174
9393,50,50,100,1,1,50.0,2.0,50.0,1174
9394,61,39,100,2,2,50.0,2.0,50.0,1174
9395,80,20,100,2,3,50.0,2.0,50.0,1174
9396,23,77,100,3,4,50.0,2.0,50.0,1174
9397,50,50,100,3,5,50.0,2.0,50.0,1174
9398,38,62,100,3,6,50.0,2.0,50.0,1174
9399,64,36,100,3,7,50.0,2.0,50.0,1174
9400,17,53,70,1,0,50.0,2.0,50.0,1175
9401,22,53,75,1,1,50.0,2.0,50.0,1175
9402,30,53,83,2,2,50.0,2.0,50.0,1175
9403,37,53,90,2,3,50.0,2.0,50.0,1175
9404,41,46,87,3,4,50.0,2.0,50.0,1175
9405,38,51,89,3,5,50.0,2.0,50.0,1175
9406,31,49,80,3,6,50.0,2.0,50.0,1175
9407,47,42,89,3,7,50.0,2.0,50.0,1175
9408,43,57,100,1,0,50.0,2.0,50.0,1176
9409,0,100,100,1,1,50.0,2.0,50.0,1176
9410,89,11,100,2,2,50.0,2.0,50.0,1176
9411,49,51,100,2,3,50.0,2.0,50.0,1176
9412,24,76,100,3,4,50.0,2.0,50.0,1176
9413,37,63,100,3,5,50.0,2.0,50.0,1176
9414,75,25,100,3,6,50.0,2.0,50.0,1176
9415,87,13,100,3,7,50.0,2.0,50.0,1176
9416,0,50,50,1,0,50.0,2.0,50.0,1177
9417,0,50,50,1,1,50.0,2.0,50.0,1177
9418,-38,88,50,2,2,50.0,2.0,50.0,1177
9419,0,100,100,2,3,50.0,2.0,50.0,1177
9420,0,0,0,3,4,50.0,2.0,50.0,1177
9421,0,0,0,3,5,50.0,2.0,50.0,1177
9422,0,100,100,3,6,50.0,2.0,50.0,1177
9423,0,0,0,3,7,50.0,2.0,50.0,1177
9424,22,21,43,1,0,50.0,2.0,50.0,1178
9425,26,24,50,1,1,50.0,2.0,50.0,1178
9426,64,29,93,2,2,50.0,2.0,50.0,1178
9427,50,50,100,2,3,50.0,2.0,50.0,1178
9428,-9,41,32,3,4,50.0,2.0,50.0,1178
9429,-3,41,38,3,5,50.0,2.0,50.0,1178
9430,8,42,50,3,6,50.0,2.0,50.0,1178
9431,7,6,13,3,7,50.0,2.0,50.0,1178
9432,26,0,26,1,0,50.0,2.0,50.0,1179
9433,-26,50,24,1,1,50.0,2.0,50.0,1179
9434,-17,50,33,2,2,50.0,2.0,50.0,1179
9435,9,78,87,2,3,50.0,2.0,50.0,1179
9436,17,71,88,3,4,50.0,2.0,50.0,1179
9437,-14,38,24,3,5,50.0,2.0,50.0,1179
9438,0,100,100,3,6,50.0,2.0,50.0,1179
9439,0,0,0,3,7,50.0,2.0,50.0,1179
9440,7,43,50,1,0,50.0,2.0,50.0,1180
9441,0,100,100,1,1,50.0,2.0,50.0,1180
9442,11,50,61,2,2,50.0,2.0,50.0,1180
9443,37,13,50,2,3,50.0,2.0,50.0,1180
9444,16,50,66,3,4,50.0,2.0,50.0,1180
9445,27,50,77,3,5,50.0,2.0,50.0,1180
9446,0,100,100,3,6,50.0,2.0,50.0,1180
9447,50,0,50,3,7,50.0,2.0,50.0,1180
9448,0,50,50,1,0,50.0,2.0,50.0,1181
9449,-6,67,61,1,1,50.0,2.0,50.0,1181
9450,35,50,85,2,2,50.0,2.0,50.0,1181
9451,56,0,56,2,3,50.0,2.0,50.0,1181
9452,-4,54,50,3,4,50.0,2.0,50.0,1181
9453,21,0,21,3,5,50.0,2.0,50.0,1181
9454,19,0,19,3,6,50.0,2.0,50.0,1181
9455,0,0,0,3,7,50.0,2.0,50.0,1181
9456,3,50,53,1,0,50.0,2.0,50.0,1182
9457,0,50,50,1,1,50.0,2.0,50.0,1182
9458,0,50,50,2,2,50.0,2.0,50.0,1182
9459,0,50,50,2,3,50.0,2.0,50.0,1182
9460,0,50,50,3,4,50.0,2.0,50.0,1182
9461,-3,53,50,3,5,50.0,2.0,50.0,1182
9462,-6,56,50,3,6,50.0,2.0,50.0,1182
9463,0,50,50,3,7,50.0,2.0,50.0,1182
9464,-14,49,35,1,0,50.0,2.0,50.0,1183
9465,-9,59,50,1,1,50.0,2.0,50.0,1183
9466,-16,66,50,2,2,50.0,2.0,50.0,1183
9467,-2,71,69,2,3,50.0,2.0,50.0,1183
9468,-7,57,50,3,4,50.0,2.0,50.0,1183
9469,0,50,50,3,5,50.0,2.0,50.0,1183
9470,21,69,90,3,6,50.0,2.0,50.0,1183
9471,0,0,0,3,7,50.0,2.0,50.0,1183
9472,-8,78,70,1,0,50.0,2.0,50.0,1184
9473,21,65,86,1,1,50.0,2.0,50.0,1184
9474,54,25,79,2,2,50.0,2.0,50.0,1184
9475,2,95,97,2,3,50.0,2.0,50.0,1184
9476,4,73,77,3,4,50.0,2.0,50.0,1184
9477,60,26,86,3,5,50.0,2.0,50.0,1184
9478,30,50,80,3,6,50.0,2.0,50.0,1184
9479,-30,52,22,3,7,50.0,2.0,50.0,1184
9480,30,50,80,1,0,50.0,2.0,50.0,1185
9481,3,70,73,1,1,50.0,2.0,50.0,1185
9482,-3,21,18,2,2,50.0,2.0,50.0,1185
9483,-31,50,19,2,3,50.0,2.0,50.0,1185
9484,5,76,81,3,4,50.0,2.0,50.0,1185
9485,1,49,50,3,5,50.0,2.0,50.0,1185
9486,56,24,80,3,6,50.0,2.0,50.0,1185
9487,53,23,76,3,7,50.0,2.0,50.0,1185
9488,50,50,100,1,0,50.0,2.0,50.0,1186
9489,100,0,100,1,1,50.0,2.0,50.0,1186
9490,50,50,100,2,2,50.0,2.0,50.0,1186
9491,50,50,100,2,3,50.0,2.0,50.0,1186
9492,50,50,100,3,4,50.0,2.0,50.0,1186
9493,50,50,100,3,5,50.0,2.0,50.0,1186
9494,60,40,100,3,6,50.0,2.0,50.0,1186
9495,60,40,100,3,7,50.0,2.0,50.0,1186
9496,50,50,100,1,0,50.0,2.0,50.0,1187
9497,-2,100,98,1,1,50.0,2.0,50.0,1187
9498,0,0,0,2,2,50.0,2.0,50.0,1187
9499,0,100,100,2,3,50.0,2.0,50.0,1187
9500,0,100,100,3,4,50.0,2.0,50.0,1187
9501,98,0,98,3,5,50.0,2.0,50.0,1187
9502,0,100,100,3,6,50.0,2.0,50.0,1187
9503,0,0,0,3,7,50.0,2.0,50.0,1187
9504,-56,87,31,1,0,50.0,2.0,50.0,1188
9505,-2,86,84,1,1,50.0,2.0,50.0,1188
9506,-7,92,85,2,2,50.0,2.0,50.0,1188
9507,-57,89,32,2,3,50.0,2.0,50.0,1188
9508,0,90,90,3,4,50.0,2.0,50.0,1188
9509,-3,80,77,3,5,50.0,2.0,50.0,1188
9510,-9,85,76,3,6,50.0,2.0,50.0,1188
9511,-7,89,82,3,7,50.0,2.0,50.0,1188
9512,-13,14,1,1,0,50.0,2.0,50.0,1189
9513,15,81,96,1,1,50.0,2.0,50.0,1189
9514,18,23,41,2,2,50.0,2.0,50.0,1189
9515,2,25,27,2,3,50.0,2.0,50.0,1189
9516,5,54,59,3,4,50.0,2.0,50.0,1189
9517,60,0,60,3,5,50.0,2.0,50.0,1189
9518,9,91,100,3,6,50.0,2.0,50.0,1189
9519,19,15,34,3,7,50.0,2.0,50.0,1189
9520,1,61,62,1,0,50.0,2.0,50.0,1190
9521,0,50,50,1,1,50.0,2.0,50.0,1190
9522,0,50,50,2,2,50.0,2.0,50.0,1190
9523,6,31,37,2,3,50.0,2.0,50.0,1190
9524,0,50,50,3,4,50.0,2.0,50.0,1190
9525,0,50,50,3,5,50.0,2.0,50.0,1190
9526,0,100,100,3,6,50.0,2.0,50.0,1190
9527,12,21,33,3,7,50.0,2.0,50.0,1190
9528,75,25,100,1,0,50.0,2.0,50.0,1191
9529,100,0,100,1,1,50.0,2.0,50.0,1191
9530,100,0,100,2,2,50.0,2.0,50.0,1191
9531,77,23,100,2,3,50.0,2.0,50.0,1191
9532,76,24,100,3,4,50.0,2.0,50.0,1191
9533,100,0,100,3,5,50.0,2.0,50.0,1191
9534,51,49,100,3,6,50.0,2.0,50.0,1191
9535,89,11,100,3,7,50.0,2.0,50.0,1191
9536,72,28,100,1,0,50.0,2.0,50.0,1192
9537,78,22,100,1,1,50.0,2.0,50.0,1192
9538,74,26,100,2,2,50.0,2.0,50.0,1192
9539,50,50,100,2,3,50.0,2.0,50.0,1192
9540,50,50,100,3,4,50.0,2.0,50.0,1192
9541,66,34,100,3,5,50.0,2.0,50.0,1192
9542,0,100,100,3,6,50.0,2.0,50.0,1192
9543,76,24,100,3,7,50.0,2.0,50.0,1192
9544,50,50,100,1,0,50.0,2.0,50.0,1193
9545,50,50,100,1,1,50.0,2.0,50.0,1193
9546,50,50,100,2,2,50.0,2.0,50.0,1193
9547,19,81,100,2,3,50.0,2.0,50.0,1193
9548,40,60,100,3,4,50.0,2.0,50.0,1193
9549,53,47,100,3,5,50.0,2.0,50.0,1193
9550,66,34,100,3,6,50.0,2.0,50.0,1193
9551,-30,30,0,3,7,50.0,2.0,50.0,1193
9552,0,50,50,1,0,50.0,2.0,50.0,1194
9553,-8,50,42,1,1,50.0,2.0,50.0,1194
9554,-25,50,25,2,2,50.0,2.0,50.0,1194
9555,0,50,50,2,3,50.0,2.0,50.0,1194
9556,49,34,83,3,4,50.0,2.0,50.0,1194
9557,20,50,70,3,5,50.0,2.0,50.0,1194
9558,-36,50,14,3,6,50.0,2.0,50.0,1194
9559,40,10,50,3,7,50.0,2.0,50.0,1194
9560,100,0,100,1,0,50.0,2.0,50.0,1195
9561,100,0,100,1,1,50.0,2.0,50.0,1195
9562,0,100,100,2,2,50.0,2.0,50.0,1195
9563,0,100,100,2,3,50.0,2.0,50.0,1195
9564,50,50,100,3,4,50.0,2.0,50.0,1195
9565,62,38,100,3,5,50.0,2.0,50.0,1195
9566,0,100,100,3,6,50.0,2.0,50.0,1195
9567,40,60,100,3,7,50.0,2.0,50.0,1195
9568,44,42,86,1,0,50.0,2.0,50.0,1196
9569,1,79,80,1,1,50.0,2.0,50.0,1196
9570,63,22,85,2,2,50.0,2.0,50.0,1196
9571,18,68,86,2,3,50.0,2.0,50.0,1196
9572,50,37,87,3,4,50.0,2.0,50.0,1196
9573,46,33,79,3,5,50.0,2.0,50.0,1196
9574,15,72,87,3,6,50.0,2.0,50.0,1196
9575,86,0,86,3,7,50.0,2.0,50.0,1196
9576,3,50,53,1,0,50.0,2.0,50.0,1197
9577,13,68,81,1,1,50.0,2.0,50.0,1197
9578,62,38,100,2,2,50.0,2.0,50.0,1197
9579,14,71,85,2,3,50.0,2.0,50.0,1197
9580,28,67,95,3,4,50.0,2.0,50.0,1197
9581,50,50,100,3,5,50.0,2.0,50.0,1197
9582,67,29,96,3,6,50.0,2.0,50.0,1197
9583,-8,23,15,3,7,50.0,2.0,50.0,1197
9584,0,50,50,1,0,50.0,2.0,50.0,1198
9585,0,50,50,1,1,50.0,2.0,50.0,1198
9586,-7,37,30,2,2,50.0,2.0,50.0,1198
9587,-5,69,64,2,3,50.0,2.0,50.0,1198
9588,0,50,50,3,4,50.0,2.0,50.0,1198
9589,0,50,50,3,5,50.0,2.0,50.0,1198
9590,21,50,71,3,6,50.0,2.0,50.0,1198
9591,0,50,50,3,7,50.0,2.0,50.0,1198
9592,-3,12,9,1,0,50.0,2.0,50.0,1199
9593,27,65,92,1,1,50.0,2.0,50.0,1199
9594,37,50,87,2,2,50.0,2.0,50.0,1199
9595,16,65,81,2,3,50.0,2.0,50.0,1199
9596,49,50,99,3,4,50.0,2.0,50.0,1199
9597,47,50,97,3,5,50.0,2.0,50.0,1199
9598,-76,76,0,3,6,50.0,2.0,50.0,1199
9599,-5,15,10,3,7,50.0,2.0,50.0,1199
9600,100,0,100,1,0,50.0,2.0,50.0,1200
9601,50,50,100,1,1,50.0,2.0,50.0,1200
9602,50,50,100,2,2,50.0,2.0,50.0,1200
9603,0,100,100,2,3,50.0,2.0,50.0,1200
9604,50,50,100,3,4,50.0,2.0,50.0,1200
9605,50,50,100,3,5,50.0,2.0,50.0,1200
9606,50,50,100,3,6,50.0,2.0,50.0,1200
9607,100,0,100,3,7,50.0,2.0,50.0,1200
9608,55,0,55,1,0,50.0,2.0,50.0,1201
9609,55,45,100,1,1,50.0,2.0,50.0,1201
9610,50,0,50,2,2,50.0,2.0,50.0,1201
9611,40,20,60,2,3,50.0,2.0,50.0,1201
9612,20,80,100,3,4,50.0,2.0,50.0,1201
9613,60,0,60,3,5,50.0,2.0,50.0,1201
9614,70,30,100,3,6,50.0,2.0,50.0,1201
9615,0,0,0,3,7,50.0,2.0,50.0,1201
9616,0,50,50,1,0,50.0,2.0,50.0,1202
9617,12,63,75,1,1,50.0,2.0,50.0,1202
9618,44,33,77,2,2,50.0,2.0,50.0,1202
9619,39,36,75,2,3,50.0,2.0,50.0,1202
9620,16,50,66,3,4,50.0,2.0,50.0,1202
9621,22,50,72,3,5,50.0,2.0,50.0,1202
9622,42,50,92,3,6,50.0,2.0,50.0,1202
9623,-9,76,67,3,7,50.0,2.0,50.0,1202
9624,17,8,25,1,0,50.0,2.0,50.0,1203
9625,13,64,77,1,1,50.0,2.0,50.0,1203
9626,0,0,0,2,2,50.0,2.0,50.0,1203
9627,-3,51,48,2,3,50.0,2.0,50.0,1203
9628,-9,50,41,3,4,50.0,2.0,50.0,1203
9629,50,50,100,3,5,50.0,2.0,50.0,1203
9630,50,50,100,3,6,50.0,2.0,50.0,1203
9631,20,9,29,3,7,50.0,2.0,50.0,1203
9632,0,50,50,1,0,50.0,2.0,50.0,1204
9633,0,50,50,1,1,50.0,2.0,50.0,1204
9634,0,50,50,2,2,50.0,2.0,50.0,1204
9635,0,50,50,2,3,50.0,2.0,50.0,1204
9636,50,50,100,3,4,50.0,2.0,50.0,1204
9637,0,50,50,3,5,50.0,2.0,50.0,1204
9638,0,50,50,3,6,50.0,2.0,50.0,1204
9639,0,50,50,3,7,50.0,2.0,50.0,1204
9640,72,0,72,1,0,50.0,2.0,50.0,1205
9641,-60,100,40,1,1,50.0,2.0,50.0,1205
9642,-8,89,81,2,2,50.0,2.0,50.0,1205
9643,11,89,100,2,3,50.0,2.0,50.0,1205
9644,7,74,81,3,4,50.0,2.0,50.0,1205
9645,37,41,78,3,5,50.0,2.0,50.0,1205
9646,23,51,74,3,6,50.0,2.0,50.0,1205
9647,10,65,75,3,7,50.0,2.0,50.0,1205
9648,-14,33,19,1,0,50.0,2.0,50.0,1206
9649,15,50,65,1,1,50.0,2.0,50.0,1206
9650,-17,67,50,2,2,50.0,2.0,50.0,1206
9651,3,14,17,2,3,50.0,2.0,50.0,1206
9652,-9,32,23,3,4,50.0,2.0,50.0,1206
9653,-4,69,65,3,5,50.0,2.0,50.0,1206
9654,-14,64,50,3,6,50.0,2.0,50.0,1206
9655,20,30,50,3,7,50.0,2.0,50.0,1206
9656,0,50,50,1,0,50.0,2.0,50.0,1207
9657,0,50,50,1,1,50.0,2.0,50.0,1207
9658,0,100,100,2,2,50.0,2.0,50.0,1207
9659,0,50,50,2,3,50.0,2.0,50.0,1207
9660,-5,5,0,3,4,50.0,2.0,50.0,1207
9661,0,0,0,3,5,50.0,2.0,50.0,1207
9662,0,0,0,3,6,50.0,2.0,50.0,1207
9663,0,0,0,3,7,50.0,2.0,50.0,1207
9664,71,3,74,1,0,50.0,2.0,50.0,1208
9665,40,34,74,1,1,50.0,2.0,50.0,1208
9666,-21,71,50,2,2,50.0,2.0,50.0,1208
9667,-8,78,70,2,3,50.0,2.0,50.0,1208
9668,-18,50,32,3,4,50.0,2.0,50.0,1208
9669,-72,73,1,3,5,50.0,2.0,50.0,1208
9670,74,21,95,3,6,50.0,2.0,50.0,1208
9671,79,13,92,3,7,50.0,2.0,50.0,1208
9672,-40,40,0,1,0,50.0,2.0,50.0,1209
9673,30,20,50,1,1,50.0,2.0,50.0,1209
9674,71,4,75,2,2,50.0,2.0,50.0,1209
9675,0,0,0,2,3,50.0,2.0,50.0,1209
9676,-7,45,38,3,4,50.0,2.0,50.0,1209
9677,0,50,50,3,5,50.0,2.0,50.0,1209
9678,19,50,69,3,6,50.0,2.0,50.0,1209
9679,-2,2,0,3,7,50.0,2.0,50.0,1209
9680,6,0,6,1,0,50.0,2.0,50.0,1210
9681,0,50,50,1,1,50.0,2.0,50.0,1210
9682,-6,50,44,2,2,50.0,2.0,50.0,1210
9683,-95,100,5,2,3,50.0,2.0,50.0,1210
9684,0,50,50,3,4,50.0,2.0,50.0,1210
9685,12,83,95,3,5,50.0,2.0,50.0,1210
9686,-78,88,10,3,6,50.0,2.0,50.0,1210
9687,-100,100,0,3,7,50.0,2.0,50.0,1210
9688,24,50,74,1,0,50.0,2.0,50.0,1211
9689,0,100,100,1,1,50.0,2.0,50.0,1211
9690,2,50,52,2,2,50.0,2.0,50.0,1211
9691,9,50,59,2,3,50.0,2.0,50.0,1211
9692,32,50,82,3,4,50.0,2.0,50.0,1211
9693,84,0,84,3,5,50.0,2.0,50.0,1211
9694,-13,50,37,3,6,50.0,2.0,50.0,1211
9695,66,0,66,3,7,50.0,2.0,50.0,1211
9696,100,0,100,1,0,50.0,2.0,50.0,1212
9697,96,4,100,1,1,50.0,2.0,50.0,1212
9698,64,36,100,2,2,50.0,2.0,50.0,1212
9699,0,100,100,2,3,50.0,2.0,50.0,1212
9700,0,100,100,3,4,50.0,2.0,50.0,1212
9701,97,3,100,3,5,50.0,2.0,50.0,1212
9702,100,0,100,3,6,50.0,2.0,50.0,1212
9703,0,0,0,3,7,50.0,2.0,50.0,1212
9704,-14,43,29,1,0,50.0,2.0,50.0,1213
9705,40,22,62,1,1,50.0,2.0,50.0,1213
9706,58,9,67,2,2,50.0,2.0,50.0,1213
9707,-43,54,11,2,3,50.0,2.0,50.0,1213
9708,3,47,50,3,4,50.0,2.0,50.0,1213
9709,13,50,63,3,5,50.0,2.0,50.0,1213
9710,6,44,50,3,6,50.0,2.0,50.0,1213
9711,4,19,23,3,7,50.0,2.0,50.0,1213
9712,-53,74,21,1,0,50.0,2.0,50.0,1214
9713,-17,50,33,1,1,50.0,2.0,50.0,1214
9714,20,50,70,2,2,50.0,2.0,50.0,1214
9715,2,20,22,2,3,50.0,2.0,50.0,1214
9716,28,40,68,3,4,50.0,2.0,50.0,1214
9717,-53,66,13,3,5,50.0,2.0,50.0,1214
9718,10,34,44,3,6,50.0,2.0,50.0,1214
9719,14,0,14,3,7,50.0,2.0,50.0,1214
9720,37,15,52,1,0,50.0,2.0,50.0,1215
9721,0,50,50,1,1,50.0,2.0,50.0,1215
9722,0,60,60,2,2,50.0,2.0,50.0,1215
9723,82,15,97,2,3,50.0,2.0,50.0,1215
9724,45,55,100,3,4,50.0,2.0,50.0,1215
9725,50,50,100,3,5,50.0,2.0,50.0,1215
9726,60,35,95,3,6,50.0,2.0,50.0,1215
9727,85,5,90,3,7,50.0,2.0,50.0,1215
9728,82,18,100,1,0,50.0,2.0,50.0,1216
9729,50,50,100,1,1,50.0,2.0,50.0,1216
9730,14,86,100,2,2,50.0,2.0,50.0,1216
9731,20,80,100,2,3,50.0,2.0,50.0,1216
9732,31,69,100,3,4,50.0,2.0,50.0,1216
9733,66,34,100,3,5,50.0,2.0,50.0,1216
9734,-15,15,0,3,6,50.0,2.0,50.0,1216
9735,86,14,100,3,7,50.0,2.0,50.0,1216
9736,25,22,47,1,0,50.0,2.0,50.0,1217
9737,-1,37,36,1,1,50.0,2.0,50.0,1217
9738,19,45,64,2,2,50.0,2.0,50.0,1217
9739,22,78,100,2,3,50.0,2.0,50.0,1217
9740,21,15,36,3,4,50.0,2.0,50.0,1217
9741,14,24,38,3,5,50.0,2.0,50.0,1217
9742,-5,36,31,3,6,50.0,2.0,50.0,1217
9743,17,19,36,3,7,50.0,2.0,50.0,1217
9744,50,0,50,1,0,50.0,2.0,50.0,1218
9745,1,49,50,1,1,50.0,2.0,50.0,1218
9746,0,50,50,2,2,50.0,2.0,50.0,1218
9747,21,79,100,2,3,50.0,2.0,50.0,1218
9748,0,50,50,3,4,50.0,2.0,50.0,1218
9749,-14,14,0,3,5,50.0,2.0,50.0,1218
9750,10,50,60,3,6,50.0,2.0,50.0,1218
9751,0,0,0,3,7,50.0,2.0,50.0,1218
9752,0,50,50,1,0,50.0,2.0,50.0,1219
9753,-14,64,50,1,1,50.0,2.0,50.0,1219
9754,6,44,50,2,2,50.0,2.0,50.0,1219
9755,1,49,50,2,3,50.0,2.0,50.0,1219
9756,0,50,50,3,4,50.0,2.0,50.0,1219
9757,19,31,50,3,5,50.0,2.0,50.0,1219
9758,0,50,50,3,6,50.0,2.0,50.0,1219
9759,16,34,50,3,7,50.0,2.0,50.0,1219
9760,-9,24,15,1,0,50.0,2.0,50.0,1220
9761,-9,82,73,1,1,50.0,2.0,50.0,1220
9762,-1,11,10,2,2,50.0,2.0,50.0,1220
9763,16,62,78,2,3,50.0,2.0,50.0,1220
9764,-5,12,7,3,4,50.0,2.0,50.0,1220
9765,22,28,50,3,5,50.0,2.0,50.0,1220
9766,-18,69,51,3,6,50.0,2.0,50.0,1220
9767,69,4,73,3,7,50.0,2.0,50.0,1220
9768,91,0,91,1,0,50.0,2.0,50.0,1221
9769,28,25,53,1,1,50.0,2.0,50.0,1221
9770,38,59,97,2,2,50.0,2.0,50.0,1221
9771,51,49,100,2,3,50.0,2.0,50.0,1221
9772,34,63,97,3,4,50.0,2.0,50.0,1221
9773,31,58,89,3,5,50.0,2.0,50.0,1221
9774,50,50,100,3,6,50.0,2.0,50.0,1221
9775,32,68,100,3,7,50.0,2.0,50.0,1221
9776,0,50,50,1,0,50.0,2.0,50.0,1222
9777,-25,75,50,1,1,50.0,2.0,50.0,1222
9778,0,50,50,2,2,50.0,2.0,50.0,1222
9779,0,50,50,2,3,50.0,2.0,50.0,1222
9780,0,65,65,3,4,50.0,2.0,50.0,1222
9781,0,50,50,3,5,50.0,2.0,50.0,1222
9782,0,50,50,3,6,50.0,2.0,50.0,1222
9783,0,50,50,3,7,50.0,2.0,50.0,1222
9784,-39,39,0,1,0,50.0,2.0,50.0,1223
9785,-23,23,0,1,1,50.0,2.0,50.0,1223
9786,0,0,0,2,2,50.0,2.0,50.0,1223
9787,14,0,14,2,3,50.0,2.0,50.0,1223
9788,74,26,100,3,4,50.0,2.0,50.0,1223
9789,0,0,0,3,5,50.0,2.0,50.0,1223
9790,0,100,100,3,6,50.0,2.0,50.0,1223
9791,38,62,100,3,7,50.0,2.0,50.0,1223
9792,36,50,86,1,0,50.0,2.0,50.0,1224
9793,-15,74,59,1,1,50.0,2.0,50.0,1224
9794,13,80,93,2,2,50.0,2.0,50.0,1224
9795,10,82,92,2,3,50.0,2.0,50.0,1224
9796,-33,33,0,3,4,50.0,2.0,50.0,1224
9797,10,50,60,3,5,50.0,2.0,50.0,1224
9798,-17,33,16,3,6,50.0,2.0,50.0,1224
9799,11,0,11,3,7,50.0,2.0,50.0,1224
9800,41,19,60,1,0,50.0,2.0,50.0,1225
9801,-1,70,69,1,1,50.0,2.0,50.0,1225
9802,34,50,84,2,2,50.0,2.0,50.0,1225
9803,24,76,100,2,3,50.0,2.0,50.0,1225
9804,44,38,82,3,4,50.0,2.0,50.0,1225
9805,68,32,100,3,5,50.0,2.0,50.0,1225
9806,34,56,90,3,6,50.0,2.0,50.0,1225
9807,66,24,90,3,7,50.0,2.0,50.0,1225
9808,48,52,100,1,0,50.0,2.0,50.0,1226
9809,43,57,100,1,1,50.0,2.0,50.0,1226
9810,28,72,100,2,2,50.0,2.0,50.0,1226
9811,29,71,100,2,3,50.0,2.0,50.0,1226
9812,63,37,100,3,4,50.0,2.0,50.0,1226
9813,41,59,100,3,5,50.0,2.0,50.0,1226
9814,34,66,100,3,6,50.0,2.0,50.0,1226
9815,42,58,100,3,7,50.0,2.0,50.0,1226
9816,0,50,50,1,0,50.0,2.0,50.0,1227
9817,-2,92,90,1,1,50.0,2.0,50.0,1227
9818,0,50,50,2,2,50.0,2.0,50.0,1227
9819,0,50,50,2,3,50.0,2.0,50.0,1227
9820,50,50,100,3,4,50.0,2.0,50.0,1227
9821,0,50,50,3,5,50.0,2.0,50.0,1227
9822,10,78,88,3,6,50.0,2.0,50.0,1227
9823,-3,6,3,3,7,50.0,2.0,50.0,1227
9824,-20,50,30,1,0,50.0,2.0,50.0,1228
9825,-23,50,27,1,1,50.0,2.0,50.0,1228
9826,17,50,67,2,2,50.0,2.0,50.0,1228
9827,20,50,70,2,3,50.0,2.0,50.0,1228
9828,6,50,56,3,4,50.0,2.0,50.0,1228
9829,-27,56,29,3,5,50.0,2.0,50.0,1228
9830,0,0,0,3,6,50.0,2.0,50.0,1228
9831,28,0,28,3,7,50.0,2.0,50.0,1228
9832,-2,68,66,1,0,50.0,2.0,50.0,1229
9833,5,62,67,1,1,50.0,2.0,50.0,1229
9834,27,15,42,2,2,50.0,2.0,50.0,1229
9835,14,43,57,2,3,50.0,2.0,50.0,1229
9836,41,35,76,3,4,50.0,2.0,50.0,1229
9837,-15,51,36,3,5,50.0,2.0,50.0,1229
9838,6,30,36,3,6,50.0,2.0,50.0,1229
9839,21,59,80,3,7,50.0,2.0,50.0,1229
9840,50,50,100,1,0,50.0,2.0,50.0,1230
9841,-2,2,0,1,1,50.0,2.0,50.0,1230
9842,5,95,100,2,2,50.0,2.0,50.0,1230
9843,3,97,100,2,3,50.0,2.0,50.0,1230
9844,5,95,100,3,4,50.0,2.0,50.0,1230
9845,50,50,100,3,5,50.0,2.0,50.0,1230
9846,50,50,100,3,6,50.0,2.0,50.0,1230
9847,50,50,100,3,7,50.0,2.0,50.0,1230
9848,-50,50,0,1,0,50.0,2.0,50.0,1231
9849,0,50,50,1,1,50.0,2.0,50.0,1231
9850,0,50,50,2,2,50.0,2.0,50.0,1231
9851,0,50,50,2,3,50.0,2.0,50.0,1231
9852,-5,55,50,3,4,50.0,2.0,50.0,1231
9853,0,0,0,3,5,50.0,2.0,50.0,1231
9854,0,50,50,3,6,50.0,2.0,50.0,1231
9855,0,0,0,3,7,50.0,2.0,50.0,1231
9856,0,0,0,1,0,50.0,2.0,50.0,1232
9857,0,0,0,1,1,50.0,2.0,50.0,1232
9858,0,0,0,2,2,50.0,2.0,50.0,1232
9859,0,0,0,2,3,50.0,2.0,50.0,1232
9860,0,50,50,3,4,50.0,2.0,50.0,1232
9861,46,1,47,3,5,50.0,2.0,50.0,1232
9862,0,100,100,3,6,50.0,2.0,50.0,1232
9863,1,0,1,3,7,50.0,2.0,50.0,1232
9864,-13,50,37,1,0,50.0,2.0,50.0,1233
9865,21,50,71,1,1,50.0,2.0,50.0,1233
9866,50,50,100,2,2,50.0,2.0,50.0,1233
9867,58,42,100,2,3,50.0,2.0,50.0,1233
9868,32,68,100,3,4,50.0,2.0,50.0,1233
9869,69,31,100,3,5,50.0,2.0,50.0,1233
9870,61,39,100,3,6,50.0,2.0,50.0,1233
9871,66,34,100,3,7,50.0,2.0,50.0,1233
9872,100,0,100,1,0,50.0,2.0,50.0,1234
9873,-57,57,0,1,1,50.0,2.0,50.0,1234
9874,70,30,100,2,2,50.0,2.0,50.0,1234
9875,0,100,100,2,3,50.0,2.0,50.0,1234
9876,0,100,100,3,4,50.0,2.0,50.0,1234
9877,0,0,0,3,5,50.0,2.0,50.0,1234
9878,77,23,100,3,6,50.0,2.0,50.0,1234
9879,100,0,100,3,7,50.0,2.0,50.0,1234
9880,-20,50,30,1,0,50.0,2.0,50.0,1235
9881,0,50,50,1,1,50.0,2.0,50.0,1235
9882,-6,77,71,2,2,50.0,2.0,50.0,1235
9883,29,50,79,2,3,50.0,2.0,50.0,1235
9884,43,29,72,3,4,50.0,2.0,50.0,1235
9885,21,29,50,3,5,50.0,2.0,50.0,1235
9886,-3,50,47,3,6,50.0,2.0,50.0,1235
9887,12,24,36,3,7,50.0,2.0,50.0,1235
9888,0,50,50,1,0,50.0,2.0,50.0,1236
9889,0,50,50,1,1,50.0,2.0,50.0,1236
9890,0,0,0,2,2,50.0,2.0,50.0,1236
9891,0,50,50,2,3,50.0,2.0,50.0,1236
9892,0,50,50,3,4,50.0,2.0,50.0,1236
9893,0,0,0,3,5,50.0,2.0,50.0,1236
9894,0,100,100,3,6,50.0,2.0,50.0,1236
9895,0,0,0,3,7,50.0,2.0,50.0,1236
9896,-42,50,8,1,0,50.0,2.0,50.0,1237
9897,50,23,73,1,1,50.0,2.0,50.0,1237
9898,48,25,73,2,2,50.0,2.0,50.0,1237
9899,2,55,57,2,3,50.0,2.0,50.0,1237
9900,-3,91,88,3,4,50.0,2.0,50.0,1237
9901,44,0,44,3,5,50.0,2.0,50.0,1237
9902,-25,48,23,3,6,50.0,2.0,50.0,1237
9903,12,0,12,3,7,50.0,2.0,50.0,1237
9904,0,50,50,1,0,50.0,2.0,50.0,1238
9905,0,50,50,1,1,50.0,2.0,50.0,1238
9906,30,27,57,2,2,50.0,2.0,50.0,1238
9907,11,39,50,2,3,50.0,2.0,50.0,1238
9908,0,100,100,3,4,50.0,2.0,50.0,1238
9909,10,40,50,3,5,50.0,2.0,50.0,1238
9910,0,59,59,3,6,50.0,2.0,50.0,1238
9911,24,19,43,3,7,50.0,2.0,50.0,1238
9912,0,0,0,1,0,50.0,2.0,50.0,1239
9913,80,10,90,1,1,50.0,2.0,50.0,1239
9914,75,0,75,2,2,50.0,2.0,50.0,1239
9915,-5,5,0,2,3,50.0,2.0,50.0,1239
9916,15,20,35,3,4,50.0,2.0,50.0,1239
9917,85,0,85,3,5,50.0,2.0,50.0,1239
9918,-100,100,0,3,6,50.0,2.0,50.0,1239
9919,85,0,85,3,7,50.0,2.0,50.0,1239
9920,38,50,88,1,0,50.0,2.0,50.0,1240
9921,95,0,95,1,1,50.0,2.0,50.0,1240
9922,-35,50,15,2,2,50.0,2.0,50.0,1240
9923,-3,93,90,2,3,50.0,2.0,50.0,1240
9924,3,75,78,3,4,50.0,2.0,50.0,1240
9925,32,50,82,3,5,50.0,2.0,50.0,1240
9926,-48,50,2,3,6,50.0,2.0,50.0,1240
9927,0,19,19,3,7,50.0,2.0,50.0,1240
9928,0,100,100,1,0,50.0,2.0,50.0,1241
9929,-19,100,81,1,1,50.0,2.0,50.0,1241
9930,0,0,0,2,2,50.0,2.0,50.0,1241
9931,0,100,100,2,3,50.0,2.0,50.0,1241
9932,0,0,0,3,4,50.0,2.0,50.0,1241
9933,0,0,0,3,5,50.0,2.0,50.0,1241
9934,-25,25,0,3,6,50.0,2.0,50.0,1241
9935,100,0,100,3,7,50.0,2.0,50.0,1241
9936,37,50,87,1,0,50.0,2.0,50.0,1242
9937,-14,100,86,1,1,50.0,2.0,50.0,1242
9938,56,23,79,2,2,50.0,2.0,50.0,1242
9939,65,24,89,2,3,50.0,2.0,50.0,1242
9940,16,67,83,3,4,50.0,2.0,50.0,1242
9941,33,50,83,3,5,50.0,2.0,50.0,1242
9942,37,50,87,3,6,50.0,2.0,50.0,1242
9943,75,0,75,3,7,50.0,2.0,50.0,1242
9944,-3,28,25,1,0,50.0,2.0,50.0,1243
9945,-4,59,55,1,1,50.0,2.0,50.0,1243
9946,-5,90,85,2,2,50.0,2.0,50.0,1243
9947,0,50,50,2,3,50.0,2.0,50.0,1243
9948,8,57,65,3,4,50.0,2.0,50.0,1243
9949,-6,36,30,3,5,50.0,2.0,50.0,1243
9950,-16,91,75,3,6,50.0,2.0,50.0,1243
9951,2,28,30,3,7,50.0,2.0,50.0,1243
9952,50,50,100,1,0,50.0,2.0,50.0,1244
9953,89,11,100,1,1,50.0,2.0,50.0,1244
9954,50,50,100,2,2,50.0,2.0,50.0,1244
9955,22,78,100,2,3,50.0,2.0,50.0,1244
9956,20,74,94,3,4,50.0,2.0,50.0,1244
9957,39,50,89,3,5,50.0,2.0,50.0,1244
9958,0,100,100,3,6,50.0,2.0,50.0,1244
9959,100,0,100,3,7,50.0,2.0,50.0,1244
9960,62,15,77,1,0,50.0,2.0,50.0,1245
9961,85,6,91,1,1,50.0,2.0,50.0,1245
9962,42,50,92,2,2,50.0,2.0,50.0,1245
9963,87,0,87,2,3,50.0,2.0,50.0,1245
9964,1,99,100,3,4,50.0,2.0,50.0,1245
9965,96,4,100,3,5,50.0,2.0,50.0,1245
9966,92,3,95,3,6,50.0,2.0,50.0,1245
9967,6,8,14,3,7,50.0,2.0,50.0,1245
9968,38,62,100,1,0,50.0,2.0,50.0,1246
9969,28,72,100,1,1,50.0,2.0,50.0,1246
9970,36,64,100,2,2,50.0,2.0,50.0,1246
9971,50,50,100,2,3,50.0,2.0,50.0,1246
9972,0,100,100,3,4,50.0,2.0,50.0,1246
9973,50,50,100,3,5,50.0,2.0,50.0,1246
9974,50,50,100,3,6,50.0,2.0,50.0,1246
9975,28,72,100,3,7,50.0,2.0,50.0,1246
9976,0,0,0,1,0,50.0,2.0,50.0,1247
9977,0,0,0,1,1,50.0,2.0,50.0,1247
9978,0,0,0,2,2,50.0,2.0,50.0,1247
9979,0,0,0,2,3,50.0,2.0,50.0,1247
9980,1,24,25,3,4,50.0,2.0,50.0,1247
9981,0,0,0,3,5,50.0,2.0,50.0,1247
9982,0,0,0,3,6,50.0,2.0,50.0,1247
9983,0,0,0,3,7,50.0,2.0,50.0,1247
9984,-38,50,12,1,0,50.0,2.0,50.0,1248
9985,0,50,50,1,1,50.0,2.0,50.0,1248
9986,0,50,50,2,2,50.0,2.0,50.0,1248
9987,39,50,89,2,3,50.0,2.0,50.0,1248
9988,-10,32,22,3,4,50.0,2.0,50.0,1248
9989,-9,26,17,3,5,50.0,2.0,50.0,1248
9990,-19,37,18,3,6,50.0,2.0,50.0,1248
9991,20,0,20,3,7,50.0,2.0,50.0,1248
9992,-23,50,27,1,0,50.0,2.0,50.0,1249
9993,-9,29,20,1,1,50.0,2.0,50.0,1249
9994,19,10,29,2,2,50.0,2.0,50.0,1249
9995,0,50,50,2,3,50.0,2.0,50.0,1249
9996,2,22,24,3,4,50.0,2.0,50.0,1249
9997,4,72,76,3,5,50.0,2.0,50.0,1249
9998,9,27,36,3,6,50.0,2.0,50.0,1249
9999,14,8,22,3,7,50.0,2.0,50.0,1249
10000,55,45,100,1,0,50.0,2.0,50.0,1250
10001,-77,77,0,1,1,50.0,2.0,50.0,1250
10002,28,72,100,2,2,50.0,2.0,50.0,1250
10003,45,55,100,2,3,50.0,2.0,50.0,1250
10004,64,36,100,3,4,50.0,2.0,50.0,1250
10005,23,77,100,3,5,50.0,2.0,50.0,1250
10006,76,24,100,3,6,50.0,2.0,50.0,1250
10007,0,100,100,3,7,50.0,2.0,50.0,1250
10008,75,25,100,1,0,50.0,2.0,50.0,1251
10009,100,0,100,1,1,50.0,2.0,50.0,1251
10010,100,0,100,2,2,50.0,2.0,50.0,1251
10011,100,0,100,2,3,50.0,2.0,50.0,1251
10012,100,0,100,3,4,50.0,2.0,50.0,1251
10013,60,40,100,3,5,50.0,2.0,50.0,1251
10014,75,25,100,3,6,50.0,2.0,50.0,1251
10015,70,30,100,3,7,50.0,2.0,50.0,1251
10016,0,0,0,1,0,50.0,2.0,50.0,1252
10017,50,0,50,1,1,50.0,2.0,50.0,1252
10018,0,0,0,2,2,50.0,2.0,50.0,1252
10019,0,0,0,2,3,50.0,2.0,50.0,1252
10020,0,37,37,3,4,50.0,2.0,50.0,1252
10021,-38,38,0,3,5,50.0,2.0,50.0,1252
10022,0,0,0,3,6,50.0,2.0,50.0,1252
10023,0,0,0,3,7,50.0,2.0,50.0,1252
10024,100,0,100,1,0,50.0,2.0,50.0,1253
10025,10,90,100,1,1,50.0,2.0,50.0,1253
10026,100,0,100,2,2,50.0,2.0,50.0,1253
10027,62,38,100,2,3,50.0,2.0,50.0,1253
10028,14,86,100,3,4,50.0,2.0,50.0,1253
10029,81,19,100,3,5,50.0,2.0,50.0,1253
10030,50,50,100,3,6,50.0,2.0,50.0,1253
10031,100,0,100,3,7,50.0,2.0,50.0,1253
10032,46,42,88,1,0,50.0,2.0,50.0,1254
10033,67,25,92,1,1,50.0,2.0,50.0,1254
10034,29,71,100,2,2,50.0,2.0,50.0,1254
10035,15,85,100,2,3,50.0,2.0,50.0,1254
10036,58,42,100,3,4,50.0,2.0,50.0,1254
10037,48,46,94,3,5,50.0,2.0,50.0,1254
10038,31,49,80,3,6,50.0,2.0,50.0,1254
10039,55,24,79,3,7,50.0,2.0,50.0,1254
10040,-39,50,11,1,0,50.0,2.0,50.0,1255
10041,0,74,74,1,1,50.0,2.0,50.0,1255
10042,6,89,95,2,2,50.0,2.0,50.0,1255
10043,50,0,50,2,3,50.0,2.0,50.0,1255
10044,50,50,100,3,4,50.0,2.0,50.0,1255
10045,48,39,87,3,5,50.0,2.0,50.0,1255
10046,51,22,73,3,6,50.0,2.0,50.0,1255
10047,66,31,97,3,7,50.0,2.0,50.0,1255
10048,25,50,75,1,0,50.0,2.0,50.0,1256
10049,25,50,75,1,1,50.0,2.0,50.0,1256
10050,25,25,50,2,2,50.0,2.0,50.0,1256
10051,15,10,25,2,3,50.0,2.0,50.0,1256
10052,50,25,75,3,4,50.0,2.0,50.0,1256
10053,25,0,25,3,5,50.0,2.0,50.0,1256
10054,0,100,100,3,6,50.0,2.0,50.0,1256
10055,-25,50,25,3,7,50.0,2.0,50.0,1256
10056,65,25,90,1,0,50.0,2.0,50.0,1257
10057,-15,25,10,1,1,50.0,2.0,50.0,1257
10058,40,50,90,2,2,50.0,2.0,50.0,1257
10059,25,65,90,2,3,50.0,2.0,50.0,1257
10060,25,65,90,3,4,50.0,2.0,50.0,1257
10061,40,50,90,3,5,50.0,2.0,50.0,1257
10062,65,25,90,3,6,50.0,2.0,50.0,1257
10063,65,25,90,3,7,50.0,2.0,50.0,1257
10064,0,10,10,1,0,50.0,2.0,50.0,1258
10065,3,58,61,1,1,50.0,2.0,50.0,1258
10066,7,55,62,2,2,50.0,2.0,50.0,1258
10067,13,81,94,2,3,50.0,2.0,50.0,1258
10068,-5,57,52,3,4,50.0,2.0,50.0,1258
10069,-7,18,11,3,5,50.0,2.0,50.0,1258
10070,-26,57,31,3,6,50.0,2.0,50.0,1258
10071,0,10,10,3,7,50.0,2.0,50.0,1258
10072,85,0,85,1,0,50.0,2.0,50.0,1259
10073,51,24,75,1,1,50.0,2.0,50.0,1259
10074,60,40,100,2,2,50.0,2.0,50.0,1259
10075,20,65,85,2,3,50.0,2.0,50.0,1259
10076,10,90,100,3,4,50.0,2.0,50.0,1259
10077,88,12,100,3,5,50.0,2.0,50.0,1259
10078,19,80,99,3,6,50.0,2.0,50.0,1259
10079,100,0,100,3,7,50.0,2.0,50.0,1259
10080,9,18,27,1,0,50.0,2.0,50.0,1260
10081,0,75,75,1,1,50.0,2.0,50.0,1260
10082,37,21,58,2,2,50.0,2.0,50.0,1260
10083,-9,82,73,2,3,50.0,2.0,50.0,1260
10084,0,50,50,3,4,50.0,2.0,50.0,1260
10085,-4,77,73,3,5,50.0,2.0,50.0,1260
10086,11,10,21,3,6,50.0,2.0,50.0,1260
10087,0,15,15,3,7,50.0,2.0,50.0,1260
10088,72,11,83,1,0,51.0,2.0,51.0,1261
10089,99,0,99,1,1,51.0,2.0,51.0,1261
10090,98,2,100,2,2,51.0,2.0,51.0,1261
10091,12,74,86,2,3,51.0,2.0,51.0,1261
10092,38,59,97,3,4,51.0,2.0,51.0,1261
10093,51,49,100,3,5,51.0,2.0,51.0,1261
10094,90,9,99,3,6,51.0,2.0,51.0,1261
10095,19,0,19,3,7,51.0,2.0,51.0,1261
10096,100,0,100,1,0,51.0,2.0,51.0,1262
10097,100,0,100,1,1,51.0,2.0,51.0,1262
10098,100,0,100,2,2,51.0,2.0,51.0,1262
10099,0,100,100,2,3,51.0,2.0,51.0,1262
10100,18,82,100,3,4,51.0,2.0,51.0,1262
10101,50,50,100,3,5,51.0,2.0,51.0,1262
10102,0,100,100,3,6,51.0,2.0,51.0,1262
10103,100,0,100,3,7,51.0,2.0,51.0,1262
10104,18,44,62,1,0,51.0,2.0,51.0,1263
10105,23,77,100,1,1,51.0,2.0,51.0,1263
10106,49,10,59,2,2,51.0,2.0,51.0,1263
10107,-35,72,37,2,3,51.0,2.0,51.0,1263
10108,22,67,89,3,4,51.0,2.0,51.0,1263
10109,61,0,61,3,5,51.0,2.0,51.0,1263
10110,34,25,59,3,6,51.0,2.0,51.0,1263
10111,58,0,58,3,7,51.0,2.0,51.0,1263
10112,11,50,61,1,0,51.0,2.0,51.0,1264
10113,-40,100,60,1,1,51.0,2.0,51.0,1264
10114,10,53,63,2,2,51.0,2.0,51.0,1264
10115,10,50,60,2,3,51.0,2.0,51.0,1264
10116,15,46,61,3,4,51.0,2.0,51.0,1264
10117,23,38,61,3,5,51.0,2.0,51.0,1264
10118,-7,49,42,3,6,51.0,2.0,51.0,1264
10119,63,0,63,3,7,51.0,2.0,51.0,1264
10120,19,67,86,1,0,51.0,2.0,51.0,1265
10121,27,65,92,1,1,51.0,2.0,51.0,1265
10122,33,24,57,2,2,51.0,2.0,51.0,1265
10123,24,60,84,2,3,51.0,2.0,51.0,1265
10124,23,61,84,3,4,51.0,2.0,51.0,1265
10125,45,42,87,3,5,51.0,2.0,51.0,1265
10126,66,33,99,3,6,51.0,2.0,51.0,1265
10127,61,14,75,3,7,51.0,2.0,51.0,1265
10128,47,0,47,1,0,51.0,2.0,51.0,1266
10129,0,0,0,1,1,51.0,2.0,51.0,1266
10130,25,75,100,2,2,51.0,2.0,51.0,1266
10131,50,0,50,2,3,51.0,2.0,51.0,1266
10132,-23,74,51,3,4,51.0,2.0,51.0,1266
10133,50,0,50,3,5,51.0,2.0,51.0,1266
10134,50,0,50,3,6,51.0,2.0,51.0,1266
10135,0,50,50,3,7,51.0,2.0,51.0,1266
10136,0,100,100,1,0,51.0,2.0,51.0,1267
10137,75,25,100,1,1,51.0,2.0,51.0,1267
10138,2,98,100,2,2,51.0,2.0,51.0,1267
10139,10,90,100,2,3,51.0,2.0,51.0,1267
10140,23,77,100,3,4,51.0,2.0,51.0,1267
10141,51,49,100,3,5,51.0,2.0,51.0,1267
10142,86,14,100,3,6,51.0,2.0,51.0,1267
10143,88,12,100,3,7,51.0,2.0,51.0,1267
10144,50,50,100,1,0,51.0,2.0,51.0,1268
10145,-50,50,0,1,1,51.0,2.0,51.0,1268
10146,50,50,100,2,2,51.0,2.0,51.0,1268
10147,50,50,100,2,3,51.0,2.0,51.0,1268
10148,50,50,100,3,4,51.0,2.0,51.0,1268
10149,50,50,100,3,5,51.0,2.0,51.0,1268
10150,50,50,100,3,6,51.0,2.0,51.0,1268
10151,100,0,100,3,7,51.0,2.0,51.0,1268
10152,37,51,88,1,0,51.0,2.0,51.0,1269
10153,78,10,88,1,1,51.0,2.0,51.0,1269
10154,49,47,96,2,2,51.0,2.0,51.0,1269
10155,46,46,92,2,3,51.0,2.0,51.0,1269
10156,32,60,92,3,4,51.0,2.0,51.0,1269
10157,46,47,93,3,5,51.0,2.0,51.0,1269
10158,68,26,94,3,6,51.0,2.0,51.0,1269
10159,49,41,90,3,7,51.0,2.0,51.0,1269
10160,22,78,100,1,0,51.0,2.0,51.0,1270
10161,37,63,100,1,1,51.0,2.0,51.0,1270
10162,58,42,100,2,2,51.0,2.0,51.0,1270
10163,-37,37,0,2,3,51.0,2.0,51.0,1270
10164,22,78,100,3,4,51.0,2.0,51.0,1270
10165,62,38,100,3,5,51.0,2.0,51.0,1270
10166,33,67,100,3,6,51.0,2.0,51.0,1270
10167,68,32,100,3,7,51.0,2.0,51.0,1270
10168,49,50,99,1,0,51.0,2.0,51.0,1271
10169,50,50,100,1,1,51.0,2.0,51.0,1271
10170,-47,50,3,2,2,51.0,2.0,51.0,1271
10171,-47,50,3,2,3,51.0,2.0,51.0,1271
10172,37,63,100,3,4,51.0,2.0,51.0,1271
10173,50,50,100,3,5,51.0,2.0,51.0,1271
10174,70,29,99,3,6,51.0,2.0,51.0,1271
10175,84,13,97,3,7,51.0,2.0,51.0,1271
10176,0,57,57,1,0,51.0,2.0,51.0,1272
10177,-7,78,71,1,1,51.0,2.0,51.0,1272
10178,27,35,62,2,2,51.0,2.0,51.0,1272
10179,13,44,57,2,3,51.0,2.0,51.0,1272
10180,10,52,62,3,4,51.0,2.0,51.0,1272
10181,4,52,56,3,5,51.0,2.0,51.0,1272
10182,-13,75,62,3,6,51.0,2.0,51.0,1272
10183,32,15,47,3,7,51.0,2.0,51.0,1272
10184,44,50,94,1,0,51.0,2.0,51.0,1273
10185,24,73,97,1,1,51.0,2.0,51.0,1273
10186,48,50,98,2,2,51.0,2.0,51.0,1273
10187,25,71,96,2,3,51.0,2.0,51.0,1273
10188,17,33,50,3,4,51.0,2.0,51.0,1273
10189,30,50,80,3,5,51.0,2.0,51.0,1273
10190,49,50,99,3,6,51.0,2.0,51.0,1273
10191,20,76,96,3,7,51.0,2.0,51.0,1273
10192,92,8,100,1,0,51.0,2.0,51.0,1274
10193,5,95,100,1,1,51.0,2.0,51.0,1274
10194,26,50,76,2,2,51.0,2.0,51.0,1274
10195,100,0,100,2,3,51.0,2.0,51.0,1274
10196,27,50,77,3,4,51.0,2.0,51.0,1274
10197,50,50,100,3,5,51.0,2.0,51.0,1274
10198,50,50,100,3,6,51.0,2.0,51.0,1274
10199,50,50,100,3,7,51.0,2.0,51.0,1274
10200,50,44,94,1,0,51.0,2.0,51.0,1275
10201,19,79,98,1,1,51.0,2.0,51.0,1275
10202,3,89,92,2,2,51.0,2.0,51.0,1275
10203,30,60,90,2,3,51.0,2.0,51.0,1275
10204,40,44,84,3,4,51.0,2.0,51.0,1275
10205,50,42,92,3,5,51.0,2.0,51.0,1275
10206,63,19,82,3,6,51.0,2.0,51.0,1275
10207,52,26,78,3,7,51.0,2.0,51.0,1275
10208,11,40,51,1,0,51.0,2.0,51.0,1276
10209,10,56,66,1,1,51.0,2.0,51.0,1276
10210,-7,50,43,2,2,51.0,2.0,51.0,1276
10211,-13,50,37,2,3,51.0,2.0,51.0,1276
10212,-16,83,67,3,4,51.0,2.0,51.0,1276
10213,26,51,77,3,5,51.0,2.0,51.0,1276
10214,14,50,64,3,6,51.0,2.0,51.0,1276
10215,22,50,72,3,7,51.0,2.0,51.0,1276
10216,1,52,53,1,0,51.0,2.0,51.0,1277
10217,-2,71,69,1,1,51.0,2.0,51.0,1277
10218,-5,59,54,2,2,51.0,2.0,51.0,1277
10219,-10,79,69,2,3,51.0,2.0,51.0,1277
10220,-1,71,70,3,4,51.0,2.0,51.0,1277
10221,-5,55,50,3,5,51.0,2.0,51.0,1277
10222,-13,100,87,3,6,51.0,2.0,51.0,1277
10223,-16,71,55,3,7,51.0,2.0,51.0,1277
10224,7,48,55,1,0,51.0,2.0,51.0,1278
10225,45,55,100,1,1,51.0,2.0,51.0,1278
10226,36,58,94,2,2,51.0,2.0,51.0,1278
10227,42,50,92,2,3,51.0,2.0,51.0,1278
10228,26,62,88,3,4,51.0,2.0,51.0,1278
10229,29,51,80,3,5,51.0,2.0,51.0,1278
10230,8,92,100,3,6,51.0,2.0,51.0,1278
10231,34,50,84,3,7,51.0,2.0,51.0,1278
10232,34,66,100,1,0,51.0,2.0,51.0,1279
10233,-50,50,0,1,1,51.0,2.0,51.0,1279
10234,37,63,100,2,2,51.0,2.0,51.0,1279
10235,43,57,100,2,3,51.0,2.0,51.0,1279
10236,25,75,100,3,4,51.0,2.0,51.0,1279
10237,27,73,100,3,5,51.0,2.0,51.0,1279
10238,0,100,100,3,6,51.0,2.0,51.0,1279
10239,-41,41,0,3,7,51.0,2.0,51.0,1279
10240,8,44,52,1,0,51.0,2.0,51.0,1280
10241,55,0,55,1,1,51.0,2.0,51.0,1280
10242,30,25,55,2,2,51.0,2.0,51.0,1280
10243,-1,50,49,2,3,51.0,2.0,51.0,1280
10244,12,71,83,3,4,51.0,2.0,51.0,1280
10245,-1,57,56,3,5,51.0,2.0,51.0,1280
10246,-39,84,45,3,6,51.0,2.0,51.0,1280
10247,0,0,0,3,7,51.0,2.0,51.0,1280
10248,-1,52,51,1,0,51.0,2.0,51.0,1281
10249,0,100,100,1,1,51.0,2.0,51.0,1281
10250,-8,60,52,2,2,51.0,2.0,51.0,1281
10251,1,50,51,2,3,51.0,2.0,51.0,1281
10252,-1,51,50,3,4,51.0,2.0,51.0,1281
10253,-2,51,49,3,5,51.0,2.0,51.0,1281
10254,2,0,2,3,6,51.0,2.0,51.0,1281
10255,47,1,48,3,7,51.0,2.0,51.0,1281
10256,60,40,100,1,0,51.0,2.0,51.0,1282
10257,75,25,100,1,1,51.0,2.0,51.0,1282
10258,0,0,0,2,2,51.0,2.0,51.0,1282
10259,76,24,100,2,3,51.0,2.0,51.0,1282
10260,51,49,100,3,4,51.0,2.0,51.0,1282
10261,50,50,100,3,5,51.0,2.0,51.0,1282
10262,50,50,100,3,6,51.0,2.0,51.0,1282
10263,100,0,100,3,7,51.0,2.0,51.0,1282
10264,100,0,100,1,0,51.0,2.0,51.0,1283
10265,80,20,100,1,1,51.0,2.0,51.0,1283
10266,100,0,100,2,2,51.0,2.0,51.0,1283
10267,-25,25,0,2,3,51.0,2.0,51.0,1283
10268,18,82,100,3,4,51.0,2.0,51.0,1283
10269,20,80,100,3,5,51.0,2.0,51.0,1283
10270,95,5,100,3,6,51.0,2.0,51.0,1283
10271,100,0,100,3,7,51.0,2.0,51.0,1283
10272,-27,49,22,1,0,51.0,2.0,51.0,1284
10273,29,49,78,1,1,51.0,2.0,51.0,1284
10274,-6,68,62,2,2,51.0,2.0,51.0,1284
10275,-12,34,22,2,3,51.0,2.0,51.0,1284
10276,44,33,77,3,4,51.0,2.0,51.0,1284
10277,-6,36,30,3,5,51.0,2.0,51.0,1284
10278,9,28,37,3,6,51.0,2.0,51.0,1284
10279,69,0,69,3,7,51.0,2.0,51.0,1284
10280,-87,87,0,1,0,51.0,2.0,51.0,1285
10281,-80,80,0,1,1,51.0,2.0,51.0,1285
10282,73,27,100,2,2,51.0,2.0,51.0,1285
10283,-31,31,0,2,3,51.0,2.0,51.0,1285
10284,0,100,100,3,4,51.0,2.0,51.0,1285
10285,96,4,100,3,5,51.0,2.0,51.0,1285
10286,-5,5,0,3,6,51.0,2.0,51.0,1285
10287,-20,20,0,3,7,51.0,2.0,51.0,1285
10288,72,21,93,1,0,51.0,2.0,51.0,1286
10289,52,38,90,1,1,51.0,2.0,51.0,1286
10290,33,51,84,2,2,51.0,2.0,51.0,1286
10291,16,68,84,2,3,51.0,2.0,51.0,1286
10292,10,88,98,3,4,51.0,2.0,51.0,1286
10293,23,74,97,3,5,51.0,2.0,51.0,1286
10294,25,70,95,3,6,51.0,2.0,51.0,1286
10295,53,35,88,3,7,51.0,2.0,51.0,1286
10296,7,47,54,1,0,51.0,2.0,51.0,1287
10297,3,48,51,1,1,51.0,2.0,51.0,1287
10298,7,45,52,2,2,51.0,2.0,51.0,1287
10299,28,26,54,2,3,51.0,2.0,51.0,1287
10300,1,56,57,3,4,51.0,2.0,51.0,1287
10301,5,49,54,3,5,51.0,2.0,51.0,1287
10302,5,48,53,3,6,51.0,2.0,51.0,1287
10303,11,42,53,3,7,51.0,2.0,51.0,1287
10304,70,23,93,1,0,51.0,2.0,51.0,1288
10305,53,47,100,1,1,51.0,2.0,51.0,1288
10306,19,81,100,2,2,51.0,2.0,51.0,1288
10307,8,92,100,2,3,51.0,2.0,51.0,1288
10308,34,66,100,3,4,51.0,2.0,51.0,1288
10309,98,2,100,3,5,51.0,2.0,51.0,1288
10310,44,56,100,3,6,51.0,2.0,51.0,1288
10311,76,13,89,3,7,51.0,2.0,51.0,1288
10312,-36,68,32,1,0,51.0,2.0,51.0,1289
10313,-67,100,33,1,1,51.0,2.0,51.0,1289
10314,70,0,70,2,2,51.0,2.0,51.0,1289
10315,-7,34,27,2,3,51.0,2.0,51.0,1289
10316,34,66,100,3,4,51.0,2.0,51.0,1289
10317,57,0,57,3,5,51.0,2.0,51.0,1289
10318,68,0,68,3,6,51.0,2.0,51.0,1289
10319,77,0,77,3,7,51.0,2.0,51.0,1289
10320,0,50,50,1,0,51.0,2.0,51.0,1290
10321,0,50,50,1,1,51.0,2.0,51.0,1290
10322,0,50,50,2,2,51.0,2.0,51.0,1290
10323,-1,51,50,2,3,51.0,2.0,51.0,1290
10324,-4,54,50,3,4,51.0,2.0,51.0,1290
10325,-1,51,50,3,5,51.0,2.0,51.0,1290
10326,1,50,51,3,6,51.0,2.0,51.0,1290
10327,0,50,50,3,7,51.0,2.0,51.0,1290
10328,50,50,100,1,0,51.0,2.0,51.0,1291
10329,66,34,100,1,1,51.0,2.0,51.0,1291
10330,0,50,50,2,2,51.0,2.0,51.0,1291
10331,26,74,100,2,3,51.0,2.0,51.0,1291
10332,22,28,50,3,4,51.0,2.0,51.0,1291
10333,42,40,82,3,5,51.0,2.0,51.0,1291
10334,65,35,100,3,6,51.0,2.0,51.0,1291
10335,35,15,50,3,7,51.0,2.0,51.0,1291
10336,34,50,84,1,0,51.0,2.0,51.0,1292
10337,62,17,79,1,1,51.0,2.0,51.0,1292
10338,1,93,94,2,2,51.0,2.0,51.0,1292
10339,0,100,100,2,3,51.0,2.0,51.0,1292
10340,42,50,92,3,4,51.0,2.0,51.0,1292
10341,31,50,81,3,5,51.0,2.0,51.0,1292
10342,31,68,99,3,6,51.0,2.0,51.0,1292
10343,33,50,83,3,7,51.0,2.0,51.0,1292
10344,100,0,100,1,0,51.0,2.0,51.0,1293
10345,100,0,100,1,1,51.0,2.0,51.0,1293
10346,0,100,100,2,2,51.0,2.0,51.0,1293
10347,0,100,100,2,3,51.0,2.0,51.0,1293
10348,57,43,100,3,4,51.0,2.0,51.0,1293
10349,100,0,100,3,5,51.0,2.0,51.0,1293
10350,0,100,100,3,6,51.0,2.0,51.0,1293
10351,100,0,100,3,7,51.0,2.0,51.0,1293
10352,20,50,70,1,0,51.0,2.0,51.0,1294
10353,33,17,50,1,1,51.0,2.0,51.0,1294
10354,0,50,50,2,2,51.0,2.0,51.0,1294
10355,28,34,62,2,3,51.0,2.0,51.0,1294
10356,-38,76,38,3,4,51.0,2.0,51.0,1294
10357,-11,74,63,3,5,51.0,2.0,51.0,1294
10358,0,50,50,3,6,51.0,2.0,51.0,1294
10359,-23,74,51,3,7,51.0,2.0,51.0,1294
10360,4,38,42,1,0,51.0,2.0,51.0,1295
10361,8,22,30,1,1,51.0,2.0,51.0,1295
10362,7,33,40,2,2,51.0,2.0,51.0,1295
10363,1,31,32,2,3,51.0,2.0,51.0,1295
10364,-4,71,67,3,4,51.0,2.0,51.0,1295
10365,-38,67,29,3,5,51.0,2.0,51.0,1295
10366,4,41,45,3,6,51.0,2.0,51.0,1295
10367,-5,41,36,3,7,51.0,2.0,51.0,1295
10368,2,79,81,1,0,51.0,2.0,51.0,1296
10369,54,25,79,1,1,51.0,2.0,51.0,1296
10370,18,55,73,2,2,51.0,2.0,51.0,1296
10371,47,11,58,2,3,51.0,2.0,51.0,1296
10372,36,50,86,3,4,51.0,2.0,51.0,1296
10373,30,50,80,3,5,51.0,2.0,51.0,1296
10374,67,15,82,3,6,51.0,2.0,51.0,1296
10375,73,0,73,3,7,51.0,2.0,51.0,1296
10376,62,26,88,1,0,51.0,2.0,51.0,1297
10377,25,53,78,1,1,51.0,2.0,51.0,1297
10378,67,8,75,2,2,51.0,2.0,51.0,1297
10379,65,0,65,2,3,51.0,2.0,51.0,1297
10380,57,21,78,3,4,51.0,2.0,51.0,1297
10381,77,0,77,3,5,51.0,2.0,51.0,1297
10382,-66,66,0,3,6,51.0,2.0,51.0,1297
10383,23,0,23,3,7,51.0,2.0,51.0,1297
10384,39,0,39,1,0,51.0,2.0,51.0,1298
10385,52,0,52,1,1,51.0,2.0,51.0,1298
10386,0,100,100,2,2,51.0,2.0,51.0,1298
10387,0,100,100,2,3,51.0,2.0,51.0,1298
10388,0,100,100,3,4,51.0,2.0,51.0,1298
10389,51,49,100,3,5,51.0,2.0,51.0,1298
10390,0,100,100,3,6,51.0,2.0,51.0,1298
10391,50,50,100,3,7,51.0,2.0,51.0,1298
10392,-6,26,20,1,0,51.0,2.0,51.0,1299
10393,-56,76,20,1,1,51.0,2.0,51.0,1299
10394,-46,77,31,2,2,51.0,2.0,51.0,1299
10395,-4,78,74,2,3,51.0,2.0,51.0,1299
10396,-53,70,17,3,4,51.0,2.0,51.0,1299
10397,0,33,33,3,5,51.0,2.0,51.0,1299
10398,4,19,23,3,6,51.0,2.0,51.0,1299
10399,39,32,71,3,7,51.0,2.0,51.0,1299
10400,5,95,100,1,0,51.0,2.0,51.0,1300
10401,0,100,100,1,1,51.0,2.0,51.0,1300
10402,86,14,100,2,2,51.0,2.0,51.0,1300
10403,51,49,100,2,3,51.0,2.0,51.0,1300
10404,-3,61,58,3,4,51.0,2.0,51.0,1300
10405,51,49,100,3,5,51.0,2.0,51.0,1300
10406,0,100,100,3,6,51.0,2.0,51.0,1300
10407,100,0,100,3,7,51.0,2.0,51.0,1300
10408,17,13,30,1,0,51.0,2.0,51.0,1301
10409,-18,31,13,1,1,51.0,2.0,51.0,1301
10410,27,8,35,2,2,51.0,2.0,51.0,1301
10411,9,2,11,2,3,51.0,2.0,51.0,1301
10412,9,25,34,3,4,51.0,2.0,51.0,1301
10413,22,51,73,3,5,51.0,2.0,51.0,1301
10414,17,8,25,3,6,51.0,2.0,51.0,1301
10415,78,12,90,3,7,51.0,2.0,51.0,1301
10416,11,39,50,1,0,51.0,2.0,51.0,1302
10417,1,50,51,1,1,51.0,2.0,51.0,1302
10418,-8,68,60,2,2,51.0,2.0,51.0,1302
10419,0,50,50,2,3,51.0,2.0,51.0,1302
10420,-19,60,41,3,4,51.0,2.0,51.0,1302
10421,3,62,65,3,5,51.0,2.0,51.0,1302
10422,-20,60,40,3,6,51.0,2.0,51.0,1302
10423,2,62,64,3,7,51.0,2.0,51.0,1302
10424,57,11,68,1,0,51.0,2.0,51.0,1303
10425,49,51,100,1,1,51.0,2.0,51.0,1303
10426,61,39,100,2,2,51.0,2.0,51.0,1303
10427,73,27,100,2,3,51.0,2.0,51.0,1303
10428,59,41,100,3,4,51.0,2.0,51.0,1303
10429,83,17,100,3,5,51.0,2.0,51.0,1303
10430,0,100,100,3,6,51.0,2.0,51.0,1303
10431,0,0,0,3,7,51.0,2.0,51.0,1303
10432,-41,77,36,1,0,51.0,2.0,51.0,1304
10433,2,53,55,1,1,51.0,2.0,51.0,1304
10434,-24,33,9,2,2,51.0,2.0,51.0,1304
10435,-20,65,45,2,3,51.0,2.0,51.0,1304
10436,13,56,69,3,4,51.0,2.0,51.0,1304
10437,13,32,45,3,5,51.0,2.0,51.0,1304
10438,5,33,38,3,6,51.0,2.0,51.0,1304
10439,3,36,39,3,7,51.0,2.0,51.0,1304
10440,49,17,66,1,0,51.0,2.0,51.0,1305
10441,10,57,67,1,1,51.0,2.0,51.0,1305
10442,23,50,73,2,2,51.0,2.0,51.0,1305
10443,16,83,99,2,3,51.0,2.0,51.0,1305
10444,15,56,71,3,4,51.0,2.0,51.0,1305
10445,17,50,67,3,5,51.0,2.0,51.0,1305
10446,8,61,69,3,6,51.0,2.0,51.0,1305
10447,54,20,74,3,7,51.0,2.0,51.0,1305
10448,0,12,12,1,0,51.0,2.0,51.0,1306
10449,-14,14,0,1,1,51.0,2.0,51.0,1306
10450,4,0,4,2,2,51.0,2.0,51.0,1306
10451,20,0,20,2,3,51.0,2.0,51.0,1306
10452,-29,39,10,3,4,51.0,2.0,51.0,1306
10453,-15,22,7,3,5,51.0,2.0,51.0,1306
10454,-49,52,3,3,6,51.0,2.0,51.0,1306
10455,0,0,0,3,7,51.0,2.0,51.0,1306
10456,46,10,56,1,0,51.0,2.0,51.0,1307
10457,5,34,39,1,1,51.0,2.0,51.0,1307
10458,13,33,46,2,2,51.0,2.0,51.0,1307
10459,41,0,41,2,3,51.0,2.0,51.0,1307
10460,17,55,72,3,4,51.0,2.0,51.0,1307
10461,30,39,69,3,5,51.0,2.0,51.0,1307
10462,34,32,66,3,6,51.0,2.0,51.0,1307
10463,17,18,35,3,7,51.0,2.0,51.0,1307
10464,9,64,73,1,0,52.0,2.0,52.0,1308
10465,-1,34,33,1,1,52.0,2.0,52.0,1308
10466,-8,50,42,2,2,52.0,2.0,52.0,1308
10467,2,48,50,2,3,52.0,2.0,52.0,1308
10468,-17,61,44,3,4,52.0,2.0,52.0,1308
10469,13,23,36,3,5,52.0,2.0,52.0,1308
10470,8,92,100,3,6,52.0,2.0,52.0,1308
10471,-4,46,42,3,7,52.0,2.0,52.0,1308
10472,100,0,100,1,0,52.0,2.0,52.0,1309
10473,100,0,100,1,1,52.0,2.0,52.0,1309
10474,97,2,99,2,2,52.0,2.0,52.0,1309
10475,100,0,100,2,3,52.0,2.0,52.0,1309
10476,33,67,100,3,4,52.0,2.0,52.0,1309
10477,100,0,100,3,5,52.0,2.0,52.0,1309
10478,100,0,100,3,6,52.0,2.0,52.0,1309
10479,100,0,100,3,7,52.0,2.0,52.0,1309
10480,11,89,100,1,0,52.0,2.0,52.0,1310
10481,64,28,92,1,1,52.0,2.0,52.0,1310
10482,26,50,76,2,2,52.0,2.0,52.0,1310
10483,-13,50,37,2,3,52.0,2.0,52.0,1310
10484,57,29,86,3,4,52.0,2.0,52.0,1310
10485,80,11,91,3,5,52.0,2.0,52.0,1310
10486,67,27,94,3,6,52.0,2.0,52.0,1310
10487,67,17,84,3,7,52.0,2.0,52.0,1310
10488,-21,50,29,1,0,52.0,2.0,52.0,1311
10489,0,100,100,1,1,52.0,2.0,52.0,1311
10490,31,39,70,2,2,52.0,2.0,52.0,1311
10491,22,48,70,2,3,52.0,2.0,52.0,1311
10492,15,47,62,3,4,52.0,2.0,52.0,1311
10493,9,50,59,3,5,52.0,2.0,52.0,1311
10494,14,48,62,3,6,52.0,2.0,52.0,1311
10495,23,50,73,3,7,52.0,2.0,52.0,1311
10496,13,37,50,1,0,52.0,2.0,52.0,1312
10497,28,50,78,1,1,52.0,2.0,52.0,1312
10498,54,10,64,2,2,52.0,2.0,52.0,1312
10499,24,26,50,2,3,52.0,2.0,52.0,1312
10500,14,50,64,3,4,52.0,2.0,52.0,1312
10501,36,50,86,3,5,52.0,2.0,52.0,1312
10502,0,50,50,3,6,52.0,2.0,52.0,1312
10503,35,19,54,3,7,52.0,2.0,52.0,1312
10504,0,100,100,1,0,52.0,2.0,52.0,1313
10505,0,100,100,1,1,52.0,2.0,52.0,1313
10506,83,17,100,2,2,52.0,2.0,52.0,1313
10507,100,0,100,2,3,52.0,2.0,52.0,1313
10508,14,86,100,3,4,52.0,2.0,52.0,1313
10509,0,0,0,3,5,52.0,2.0,52.0,1313
10510,0,0,0,3,6,52.0,2.0,52.0,1313
10511,0,0,0,3,7,52.0,2.0,52.0,1313
10512,0,0,0,1,0,52.0,2.0,52.0,1314
10513,0,0,0,1,1,52.0,2.0,52.0,1314
10514,0,0,0,2,2,52.0,2.0,52.0,1314
10515,-50,50,0,2,3,52.0,2.0,52.0,1314
10516,-50,50,0,3,4,52.0,2.0,52.0,1314
10517,-50,50,0,3,5,52.0,2.0,52.0,1314
10518,0,100,100,3,6,52.0,2.0,52.0,1314
10519,0,0,0,3,7,52.0,2.0,52.0,1314
10520,-1,59,58,1,0,52.0,2.0,52.0,1315
10521,28,72,100,1,1,52.0,2.0,52.0,1315
10522,13,87,100,2,2,52.0,2.0,52.0,1315
10523,15,48,63,2,3,52.0,2.0,52.0,1315
10524,40,60,100,3,4,52.0,2.0,52.0,1315
10525,2,65,67,3,5,52.0,2.0,52.0,1315
10526,0,100,100,3,6,52.0,2.0,52.0,1315
10527,66,0,66,3,7,52.0,2.0,52.0,1315
10528,34,66,100,1,0,52.0,2.0,52.0,1316
10529,50,50,100,1,1,52.0,2.0,52.0,1316
10530,38,50,88,2,2,52.0,2.0,52.0,1316
10531,3,25,28,2,3,52.0,2.0,52.0,1316
10532,23,77,100,3,4,52.0,2.0,52.0,1316
10533,18,80,98,3,5,52.0,2.0,52.0,1316
10534,63,26,89,3,6,52.0,2.0,52.0,1316
10535,81,17,98,3,7,52.0,2.0,52.0,1316
10536,-64,64,0,1,0,52.0,2.0,52.0,1317
10537,85,15,100,1,1,52.0,2.0,52.0,1317
10538,25,75,100,2,2,52.0,2.0,52.0,1317
10539,44,56,100,2,3,52.0,2.0,52.0,1317
10540,3,97,100,3,4,52.0,2.0,52.0,1317
10541,35,65,100,3,5,52.0,2.0,52.0,1317
10542,50,50,100,3,6,52.0,2.0,52.0,1317
10543,-26,31,5,3,7,52.0,2.0,52.0,1317
10544,18,45,63,1,0,52.0,2.0,52.0,1318
10545,-9,88,79,1,1,52.0,2.0,52.0,1318
10546,-2,76,74,2,2,52.0,2.0,52.0,1318
10547,74,6,80,2,3,52.0,2.0,52.0,1318
10548,-13,77,64,3,4,52.0,2.0,52.0,1318
10549,27,12,39,3,5,52.0,2.0,52.0,1318
10550,47,37,84,3,6,52.0,2.0,52.0,1318
10551,65,10,75,3,7,52.0,2.0,52.0,1318
10552,90,10,100,1,0,52.0,2.0,52.0,1319
10553,100,0,100,1,1,52.0,2.0,52.0,1319
10554,14,86,100,2,2,52.0,2.0,52.0,1319
10555,93,7,100,2,3,52.0,2.0,52.0,1319
10556,33,67,100,3,4,52.0,2.0,52.0,1319
10557,91,9,100,3,5,52.0,2.0,52.0,1319
10558,6,94,100,3,6,52.0,2.0,52.0,1319
10559,95,5,100,3,7,52.0,2.0,52.0,1319
10560,-5,40,35,1,0,52.0,2.0,52.0,1320
10561,17,53,70,1,1,52.0,2.0,52.0,1320
10562,15,34,49,2,2,52.0,2.0,52.0,1320
10563,1,75,76,2,3,52.0,2.0,52.0,1320
10564,-4,64,60,3,4,52.0,2.0,52.0,1320
10565,16,45,61,3,5,52.0,2.0,52.0,1320
10566,-4,29,25,3,6,52.0,2.0,52.0,1320
10567,-21,61,40,3,7,52.0,2.0,52.0,1320
10568,-11,11,0,1,0,52.0,2.0,52.0,1321
10569,12,88,100,1,1,52.0,2.0,52.0,1321
10570,0,0,0,2,2,52.0,2.0,52.0,1321
10571,0,100,100,2,3,52.0,2.0,52.0,1321
10572,-1,29,28,3,4,52.0,2.0,52.0,1321
10573,-4,64,60,3,5,52.0,2.0,52.0,1321
10574,0,0,0,3,6,52.0,2.0,52.0,1321
10575,-1,1,0,3,7,52.0,2.0,52.0,1321
10576,-8,50,42,1,0,52.0,2.0,52.0,1322
10577,-11,61,50,1,1,52.0,2.0,52.0,1322
10578,-6,50,44,2,2,52.0,2.0,52.0,1322
10579,-12,62,50,2,3,52.0,2.0,52.0,1322
10580,36,40,76,3,4,52.0,2.0,52.0,1322
10581,4,46,50,3,5,52.0,2.0,52.0,1322
10582,-14,75,61,3,6,52.0,2.0,52.0,1322
10583,-23,54,31,3,7,52.0,2.0,52.0,1322
10584,-17,17,0,1,0,52.0,2.0,52.0,1323
10585,18,82,100,1,1,52.0,2.0,52.0,1323
10586,22,78,100,2,2,52.0,2.0,52.0,1323
10587,79,21,100,2,3,52.0,2.0,52.0,1323
10588,51,49,100,3,4,52.0,2.0,52.0,1323
10589,76,24,100,3,5,52.0,2.0,52.0,1323
10590,62,38,100,3,6,52.0,2.0,52.0,1323
10591,83,17,100,3,7,52.0,2.0,52.0,1323
10592,6,38,44,1,0,52.0,2.0,52.0,1324
10593,-19,59,40,1,1,52.0,2.0,52.0,1324
10594,-12,42,30,2,2,52.0,2.0,52.0,1324
10595,8,50,58,2,3,52.0,2.0,52.0,1324
10596,25,40,65,3,4,52.0,2.0,52.0,1324
10597,-6,54,48,3,5,52.0,2.0,52.0,1324
10598,-11,55,44,3,6,52.0,2.0,52.0,1324
10599,-9,35,26,3,7,52.0,2.0,52.0,1324
10600,39,26,65,1,0,52.0,2.0,52.0,1325
10601,16,82,98,1,1,52.0,2.0,52.0,1325
10602,21,73,94,2,2,52.0,2.0,52.0,1325
10603,-6,100,94,2,3,52.0,2.0,52.0,1325
10604,2,93,95,3,4,52.0,2.0,52.0,1325
10605,16,81,97,3,5,52.0,2.0,52.0,1325
10606,79,10,89,3,6,52.0,2.0,52.0,1325
10607,44,56,100,3,7,52.0,2.0,52.0,1325
10608,0,61,61,1,0,52.0,2.0,52.0,1326
10609,-39,73,34,1,1,52.0,2.0,52.0,1326
10610,14,59,73,2,2,52.0,2.0,52.0,1326
10611,-1,64,63,2,3,52.0,2.0,52.0,1326
10612,-10,23,13,3,4,52.0,2.0,52.0,1326
10613,-24,58,34,3,5,52.0,2.0,52.0,1326
10614,-33,63,30,3,6,52.0,2.0,52.0,1326
10615,-12,25,13,3,7,52.0,2.0,52.0,1326
10616,20,5,25,1,0,52.0,2.0,52.0,1327
10617,-52,52,0,1,1,52.0,2.0,52.0,1327
10618,15,49,64,2,2,52.0,2.0,52.0,1327
10619,7,77,84,2,3,52.0,2.0,52.0,1327
10620,-20,21,1,3,4,52.0,2.0,52.0,1327
10621,-13,24,11,3,5,52.0,2.0,52.0,1327
10622,-34,36,2,3,6,52.0,2.0,52.0,1327
10623,1,0,1,3,7,52.0,2.0,52.0,1327
10624,6,94,100,1,0,52.0,2.0,52.0,1328
10625,65,35,100,1,1,52.0,2.0,52.0,1328
10626,0,100,100,2,2,52.0,2.0,52.0,1328
10627,0,100,100,2,3,52.0,2.0,52.0,1328
10628,19,81,100,3,4,52.0,2.0,52.0,1328
10629,3,97,100,3,5,52.0,2.0,52.0,1328
10630,93,7,100,3,6,52.0,2.0,52.0,1328
10631,100,0,100,3,7,52.0,2.0,52.0,1328
10632,25,50,75,1,0,52.0,2.0,52.0,1329
10633,-25,50,25,1,1,52.0,2.0,52.0,1329
10634,22,50,72,2,2,52.0,2.0,52.0,1329
10635,36,64,100,2,3,52.0,2.0,52.0,1329
10636,34,50,84,3,4,52.0,2.0,52.0,1329
10637,74,6,80,3,5,52.0,2.0,52.0,1329
10638,0,100,100,3,6,52.0,2.0,52.0,1329
10639,64,12,76,3,7,52.0,2.0,52.0,1329
10640,63,19,82,1,0,52.0,2.0,52.0,1330
10641,15,0,15,1,1,52.0,2.0,52.0,1330
10642,66,12,78,2,2,52.0,2.0,52.0,1330
10643,55,28,83,2,3,52.0,2.0,52.0,1330
10644,7,66,73,3,4,52.0,2.0,52.0,1330
10645,64,25,89,3,5,52.0,2.0,52.0,1330
10646,58,24,82,3,6,52.0,2.0,52.0,1330
10647,0,16,16,3,7,52.0,2.0,52.0,1330
10648,41,50,91,1,0,52.0,2.0,52.0,1331
10649,28,50,78,1,1,52.0,2.0,52.0,1331
10650,7,62,69,2,2,52.0,2.0,52.0,1331
10651,42,40,82,2,3,52.0,2.0,52.0,1331
10652,37,59,96,3,4,52.0,2.0,52.0,1331
10653,46,50,96,3,5,52.0,2.0,52.0,1331
10654,57,43,100,3,6,52.0,2.0,52.0,1331
10655,69,14,83,3,7,52.0,2.0,52.0,1331
10656,0,50,50,1,0,52.0,2.0,52.0,1332
10657,-9,59,50,1,1,52.0,2.0,52.0,1332
10658,0,50,50,2,2,52.0,2.0,52.0,1332
10659,-13,63,50,2,3,52.0,2.0,52.0,1332
10660,0,50,50,3,4,52.0,2.0,52.0,1332
10661,1,50,51,3,5,52.0,2.0,52.0,1332
10662,-8,58,50,3,6,52.0,2.0,52.0,1332
10663,17,34,51,3,7,52.0,2.0,52.0,1332
10664,4,56,60,1,0,53.0,2.0,53.0,1333
10665,17,46,63,1,1,53.0,2.0,53.0,1333
10666,-4,33,29,2,2,53.0,2.0,53.0,1333
10667,39,30,69,2,3,53.0,2.0,53.0,1333
10668,2,60,62,3,4,53.0,2.0,53.0,1333
10669,13,64,77,3,5,53.0,2.0,53.0,1333
10670,3,21,24,3,6,53.0,2.0,53.0,1333
10671,-14,41,27,3,7,53.0,2.0,53.0,1333
10672,44,50,94,1,0,53.0,2.0,53.0,1334
10673,51,49,100,1,1,53.0,2.0,53.0,1334
10674,35,59,94,2,2,53.0,2.0,53.0,1334
10675,50,50,100,2,3,53.0,2.0,53.0,1334
10676,-5,50,45,3,4,53.0,2.0,53.0,1334
10677,26,73,99,3,5,53.0,2.0,53.0,1334
10678,-2,94,92,3,6,53.0,2.0,53.0,1334
10679,-22,27,5,3,7,53.0,2.0,53.0,1334
10680,100,0,100,1,0,53.0,2.0,53.0,1335
10681,41,59,100,1,1,53.0,2.0,53.0,1335
10682,67,23,90,2,2,53.0,2.0,53.0,1335
10683,82,0,82,2,3,53.0,2.0,53.0,1335
10684,90,10,100,3,4,53.0,2.0,53.0,1335
10685,47,53,100,3,5,53.0,2.0,53.0,1335
10686,77,23,100,3,6,53.0,2.0,53.0,1335
10687,52,10,62,3,7,53.0,2.0,53.0,1335
10688,42,58,100,1,0,53.0,2.0,53.0,1336
10689,0,100,100,1,1,53.0,2.0,53.0,1336
10690,-25,60,35,2,2,53.0,2.0,53.0,1336
10691,0,70,70,2,3,53.0,2.0,53.0,1336
10692,-39,39,0,3,4,53.0,2.0,53.0,1336
10693,-39,59,20,3,5,53.0,2.0,53.0,1336
10694,-10,36,26,3,6,53.0,2.0,53.0,1336
10695,3,46,49,3,7,53.0,2.0,53.0,1336
10696,51,32,83,1,0,53.0,2.0,53.0,1337
10697,-32,41,9,1,1,53.0,2.0,53.0,1337
10698,-32,43,11,2,2,53.0,2.0,53.0,1337
10699,25,6,31,2,3,53.0,2.0,53.0,1337
10700,28,57,85,3,4,53.0,2.0,53.0,1337
10701,25,67,92,3,5,53.0,2.0,53.0,1337
10702,48,42,90,3,6,53.0,2.0,53.0,1337
10703,66,13,79,3,7,53.0,2.0,53.0,1337
10704,-1,40,39,1,0,53.0,2.0,53.0,1338
10705,13,75,88,1,1,53.0,2.0,53.0,1338
10706,-6,66,60,2,2,53.0,2.0,53.0,1338
10707,2,26,28,2,3,53.0,2.0,53.0,1338
10708,11,52,63,3,4,53.0,2.0,53.0,1338
10709,1,64,65,3,5,53.0,2.0,53.0,1338
10710,-9,37,28,3,6,53.0,2.0,53.0,1338
10711,24,36,60,3,7,53.0,2.0,53.0,1338
10712,-45,45,0,1,0,53.0,2.0,53.0,1339
10713,0,100,100,1,1,53.0,2.0,53.0,1339
10714,66,34,100,2,2,53.0,2.0,53.0,1339
10715,100,0,100,2,3,53.0,2.0,53.0,1339
10716,5,95,100,3,4,53.0,2.0,53.0,1339
10717,34,66,100,3,5,53.0,2.0,53.0,1339
10718,79,15,94,3,6,53.0,2.0,53.0,1339
10719,100,0,100,3,7,53.0,2.0,53.0,1339
10720,88,12,100,1,0,53.0,2.0,53.0,1340
10721,24,76,100,1,1,53.0,2.0,53.0,1340
10722,87,13,100,2,2,53.0,2.0,53.0,1340
10723,39,61,100,2,3,53.0,2.0,53.0,1340
10724,22,78,100,3,4,53.0,2.0,53.0,1340
10725,91,9,100,3,5,53.0,2.0,53.0,1340
10726,100,0,100,3,6,53.0,2.0,53.0,1340
10727,-4,4,0,3,7,53.0,2.0,53.0,1340
10728,50,50,100,1,0,53.0,2.0,53.0,1341
10729,-4,100,96,1,1,53.0,2.0,53.0,1341
10730,0,100,100,2,2,53.0,2.0,53.0,1341
10731,50,50,100,2,3,53.0,2.0,53.0,1341
10732,1,99,100,3,4,53.0,2.0,53.0,1341
10733,50,50,100,3,5,53.0,2.0,53.0,1341
10734,0,100,100,3,6,53.0,2.0,53.0,1341
10735,50,50,100,3,7,53.0,2.0,53.0,1341
10736,30,0,30,1,0,53.0,2.0,53.0,1342
10737,12,0,12,1,1,53.0,2.0,53.0,1342
10738,28,55,83,2,2,53.0,2.0,53.0,1342
10739,22,78,100,2,3,53.0,2.0,53.0,1342
10740,19,47,66,3,4,53.0,2.0,53.0,1342
10741,5,80,85,3,5,53.0,2.0,53.0,1342
10742,0,100,100,3,6,53.0,2.0,53.0,1342
10743,30,0,30,3,7,53.0,2.0,53.0,1342
10744,41,30,71,1,0,53.0,2.0,53.0,1343
10745,34,27,61,1,1,53.0,2.0,53.0,1343
10746,19,68,87,2,2,53.0,2.0,53.0,1343
10747,52,34,86,2,3,53.0,2.0,53.0,1343
10748,34,53,87,3,4,53.0,2.0,53.0,1343
10749,40,43,83,3,5,53.0,2.0,53.0,1343
10750,-1,97,96,3,6,53.0,2.0,53.0,1343
10751,88,0,88,3,7,53.0,2.0,53.0,1343
10752,1,72,73,1,0,53.0,2.0,53.0,1344
10753,22,40,62,1,1,53.0,2.0,53.0,1344
10754,4,60,64,2,2,53.0,2.0,53.0,1344
10755,-40,61,21,2,3,53.0,2.0,53.0,1344
10756,-2,60,58,3,4,53.0,2.0,53.0,1344
10757,7,62,69,3,5,53.0,2.0,53.0,1344
10758,-4,63,59,3,6,53.0,2.0,53.0,1344
10759,-33,50,17,3,7,53.0,2.0,53.0,1344
10760,60,40,100,1,0,53.0,2.0,53.0,1345
10761,49,51,100,1,1,53.0,2.0,53.0,1345
10762,53,47,100,2,2,53.0,2.0,53.0,1345
10763,51,49,100,2,3,53.0,2.0,53.0,1345
10764,39,61,100,3,4,53.0,2.0,53.0,1345
10765,49,51,100,3,5,53.0,2.0,53.0,1345
10766,57,43,100,3,6,53.0,2.0,53.0,1345
10767,49,51,100,3,7,53.0,2.0,53.0,1345
10768,36,23,59,1,0,53.0,2.0,53.0,1346
10769,-6,73,67,1,1,53.0,2.0,53.0,1346
10770,4,61,65,2,2,53.0,2.0,53.0,1346
10771,36,41,77,2,3,53.0,2.0,53.0,1346
10772,31,36,67,3,4,53.0,2.0,53.0,1346
10773,29,30,59,3,5,53.0,2.0,53.0,1346
10774,-15,100,85,3,6,53.0,2.0,53.0,1346
10775,26,40,66,3,7,53.0,2.0,53.0,1346
10776,0,50,50,1,0,53.0,2.0,53.0,1347
10777,0,50,50,1,1,53.0,2.0,53.0,1347
10778,0,50,50,2,2,53.0,2.0,53.0,1347
10779,24,50,74,2,3,53.0,2.0,53.0,1347
10780,13,50,63,3,4,53.0,2.0,53.0,1347
10781,-13,50,37,3,5,53.0,2.0,53.0,1347
10782,5,50,55,3,6,53.0,2.0,53.0,1347
10783,0,50,50,3,7,53.0,2.0,53.0,1347
10784,-19,50,31,1,0,53.0,2.0,53.0,1348
10785,14,50,64,1,1,53.0,2.0,53.0,1348
10786,32,34,66,2,2,53.0,2.0,53.0,1348
10787,26,13,39,2,3,53.0,2.0,53.0,1348
10788,49,21,70,3,4,53.0,2.0,53.0,1348
10789,34,0,34,3,5,53.0,2.0,53.0,1348
10790,73,0,73,3,6,53.0,2.0,53.0,1348
10791,70,0,70,3,7,53.0,2.0,53.0,1348
10792,-2,2,0,1,0,53.0,2.0,53.0,1349
10793,-9,51,42,1,1,53.0,2.0,53.0,1349
10794,-13,14,1,2,2,53.0,2.0,53.0,1349
10795,0,0,0,2,3,53.0,2.0,53.0,1349
10796,-9,50,41,3,4,53.0,2.0,53.0,1349
10797,1,0,1,3,5,53.0,2.0,53.0,1349
10798,71,24,95,3,6,53.0,2.0,53.0,1349
10799,0,0,0,3,7,53.0,2.0,53.0,1349
10800,-5,18,13,1,0,53.0,2.0,53.0,1350
10801,13,52,65,1,1,53.0,2.0,53.0,1350
10802,-13,82,69,2,2,53.0,2.0,53.0,1350
10803,-18,24,6,2,3,53.0,2.0,53.0,1350
10804,-2,77,75,3,4,53.0,2.0,53.0,1350
10805,-2,14,12,3,5,53.0,2.0,53.0,1350
10806,44,22,66,3,6,53.0,2.0,53.0,1350
10807,-2,21,19,3,7,53.0,2.0,53.0,1350
10808,56,4,60,1,0,53.0,2.0,53.0,1351
10809,57,1,58,1,1,53.0,2.0,53.0,1351
10810,17,58,75,2,2,53.0,2.0,53.0,1351
10811,66,13,79,2,3,53.0,2.0,53.0,1351
10812,9,46,55,3,4,53.0,2.0,53.0,1351
10813,71,0,71,3,5,53.0,2.0,53.0,1351
10814,40,25,65,3,6,53.0,2.0,53.0,1351
10815,53,3,56,3,7,53.0,2.0,53.0,1351
10816,8,92,100,1,0,53.0,2.0,53.0,1352
10817,100,0,100,1,1,53.0,2.0,53.0,1352
10818,100,0,100,2,2,53.0,2.0,53.0,1352
10819,44,56,100,2,3,53.0,2.0,53.0,1352
10820,10,90,100,3,4,53.0,2.0,53.0,1352
10821,5,95,100,3,5,53.0,2.0,53.0,1352
10822,100,0,100,3,6,53.0,2.0,53.0,1352
10823,0,100,100,3,7,53.0,2.0,53.0,1352
10824,0,0,0,1,0,54.0,2.0,54.0,1353
10825,10,64,74,1,1,54.0,2.0,54.0,1353
10826,11,49,60,2,2,54.0,2.0,54.0,1353
10827,-14,81,67,2,3,54.0,2.0,54.0,1353
10828,13,73,86,3,4,54.0,2.0,54.0,1353
10829,-19,36,17,3,5,54.0,2.0,54.0,1353
10830,-4,80,76,3,6,54.0,2.0,54.0,1353
10831,2,19,21,3,7,54.0,2.0,54.0,1353
10832,2,0,2,1,0,54.0,2.0,54.0,1354
10833,22,32,54,1,1,54.0,2.0,54.0,1354
10834,-9,49,40,2,2,54.0,2.0,54.0,1354
10835,34,21,55,2,3,54.0,2.0,54.0,1354
10836,13,50,63,3,4,54.0,2.0,54.0,1354
10837,1,50,51,3,5,54.0,2.0,54.0,1354
10838,5,34,39,3,6,54.0,2.0,54.0,1354
10839,53,0,53,3,7,54.0,2.0,54.0,1354
10840,-2,2,0,1,0,54.0,2.0,54.0,1355
10841,-1,3,2,1,1,54.0,2.0,54.0,1355
10842,-10,12,2,2,2,54.0,2.0,54.0,1355
10843,-5,6,1,2,3,54.0,2.0,54.0,1355
10844,-27,27,0,3,4,54.0,2.0,54.0,1355
10845,-28,28,0,3,5,54.0,2.0,54.0,1355
10846,0,100,100,3,6,54.0,2.0,54.0,1355
10847,-58,58,0,3,7,54.0,2.0,54.0,1355
10848,14,27,41,1,0,54.0,2.0,54.0,1356
10849,0,100,100,1,1,54.0,2.0,54.0,1356
10850,3,60,63,2,2,54.0,2.0,54.0,1356
10851,2,64,66,2,3,54.0,2.0,54.0,1356
10852,10,76,86,3,4,54.0,2.0,54.0,1356
10853,-6,55,49,3,5,54.0,2.0,54.0,1356
10854,20,39,59,3,6,54.0,2.0,54.0,1356
10855,9,13,22,3,7,54.0,2.0,54.0,1356
10856,68,7,75,1,0,54.0,2.0,54.0,1357
10857,41,39,80,1,1,54.0,2.0,54.0,1357
10858,31,49,80,2,2,54.0,2.0,54.0,1357
10859,16,74,90,2,3,54.0,2.0,54.0,1357
10860,37,43,80,3,4,54.0,2.0,54.0,1357
10861,46,32,78,3,5,54.0,2.0,54.0,1357
10862,53,42,95,3,6,54.0,2.0,54.0,1357
10863,14,6,20,3,7,54.0,2.0,54.0,1357
10864,4,46,50,1,0,54.0,2.0,54.0,1358
10865,1,97,98,1,1,54.0,2.0,54.0,1358
10866,22,31,53,2,2,54.0,2.0,54.0,1358
10867,8,42,50,2,3,54.0,2.0,54.0,1358
10868,-11,51,40,3,4,54.0,2.0,54.0,1358
10869,46,10,56,3,5,54.0,2.0,54.0,1358
10870,7,43,50,3,6,54.0,2.0,54.0,1358
10871,38,4,42,3,7,54.0,2.0,54.0,1358
10872,99,1,100,1,0,54.0,2.0,54.0,1359
10873,11,45,56,1,1,54.0,2.0,54.0,1359
10874,45,0,45,2,2,54.0,2.0,54.0,1359
10875,25,15,40,2,3,54.0,2.0,54.0,1359
10876,-9,64,55,3,4,54.0,2.0,54.0,1359
10877,6,94,100,3,5,54.0,2.0,54.0,1359
10878,23,0,23,3,6,54.0,2.0,54.0,1359
10879,0,0,0,3,7,54.0,2.0,54.0,1359
10880,26,28,54,1,0,54.0,2.0,54.0,1360
10881,27,31,58,1,1,54.0,2.0,54.0,1360
10882,3,51,54,2,2,54.0,2.0,54.0,1360
10883,-18,74,56,2,3,54.0,2.0,54.0,1360
10884,-8,63,55,3,4,54.0,2.0,54.0,1360
10885,15,48,63,3,5,54.0,2.0,54.0,1360
10886,36,28,64,3,6,54.0,2.0,54.0,1360
10887,37,25,62,3,7,54.0,2.0,54.0,1360
10888,7,61,68,1,0,54.0,2.0,54.0,1361
10889,11,27,38,1,1,54.0,2.0,54.0,1361
10890,-11,75,64,2,2,54.0,2.0,54.0,1361
10891,-24,55,31,2,3,54.0,2.0,54.0,1361
10892,0,23,23,3,4,54.0,2.0,54.0,1361
10893,14,50,64,3,5,54.0,2.0,54.0,1361
10894,-7,20,13,3,6,54.0,2.0,54.0,1361
10895,50,31,81,3,7,54.0,2.0,54.0,1361
10896,55,0,55,1,0,54.0,2.0,54.0,1362
10897,5,72,77,1,1,54.0,2.0,54.0,1362
10898,55,30,85,2,2,54.0,2.0,54.0,1362
10899,23,77,100,2,3,54.0,2.0,54.0,1362
10900,23,77,100,3,4,54.0,2.0,54.0,1362
10901,48,36,84,3,5,54.0,2.0,54.0,1362
10902,87,13,100,3,6,54.0,2.0,54.0,1362
10903,62,9,71,3,7,54.0,2.0,54.0,1362
10904,-17,56,39,1,0,54.0,2.0,54.0,1363
10905,-5,51,46,1,1,54.0,2.0,54.0,1363
10906,12,23,35,2,2,54.0,2.0,54.0,1363
10907,14,46,60,2,3,54.0,2.0,54.0,1363
10908,-4,85,81,3,4,54.0,2.0,54.0,1363
10909,3,58,61,3,5,54.0,2.0,54.0,1363
10910,0,100,100,3,6,54.0,2.0,54.0,1363
10911,45,0,45,3,7,54.0,2.0,54.0,1363
10912,19,11,30,1,0,54.0,2.0,54.0,1364
10913,18,2,20,1,1,54.0,2.0,54.0,1364
10914,5,95,100,2,2,54.0,2.0,54.0,1364
10915,10,89,99,2,3,54.0,2.0,54.0,1364
10916,3,78,81,3,4,54.0,2.0,54.0,1364
10917,59,40,99,3,5,54.0,2.0,54.0,1364
10918,8,23,31,3,6,54.0,2.0,54.0,1364
10919,9,6,15,3,7,54.0,2.0,54.0,1364
10920,28,64,92,1,0,54.0,2.0,54.0,1365
10921,-5,100,95,1,1,54.0,2.0,54.0,1365
10922,0,100,100,2,2,54.0,2.0,54.0,1365
10923,0,100,100,2,3,54.0,2.0,54.0,1365
10924,9,91,100,3,4,54.0,2.0,54.0,1365
10925,35,50,85,3,5,54.0,2.0,54.0,1365
10926,91,0,91,3,6,54.0,2.0,54.0,1365
10927,4,0,4,3,7,54.0,2.0,54.0,1365
10928,22,50,72,1,0,54.0,2.0,54.0,1366
10929,34,53,87,1,1,54.0,2.0,54.0,1366
10930,23,58,81,2,2,54.0,2.0,54.0,1366
10931,37,38,75,2,3,54.0,2.0,54.0,1366
10932,34,43,77,3,4,54.0,2.0,54.0,1366
10933,24,63,87,3,5,54.0,2.0,54.0,1366
10934,29,39,68,3,6,54.0,2.0,54.0,1366
10935,28,36,64,3,7,54.0,2.0,54.0,1366
10936,-7,43,36,1,0,54.0,2.0,54.0,1367
10937,2,29,31,1,1,54.0,2.0,54.0,1367
10938,7,28,35,2,2,54.0,2.0,54.0,1367
10939,-4,36,32,2,3,54.0,2.0,54.0,1367
10940,-3,59,56,3,4,54.0,2.0,54.0,1367
10941,0,27,27,3,5,54.0,2.0,54.0,1367
10942,-5,42,37,3,6,54.0,2.0,54.0,1367
10943,-3,42,39,3,7,54.0,2.0,54.0,1367
10944,19,50,69,1,0,54.0,2.0,54.0,1368
10945,-13,31,18,1,1,54.0,2.0,54.0,1368
10946,12,50,62,2,2,54.0,2.0,54.0,1368
10947,64,0,64,2,3,54.0,2.0,54.0,1368
10948,3,59,62,3,4,54.0,2.0,54.0,1368
10949,15,50,65,3,5,54.0,2.0,54.0,1368
10950,7,93,100,3,6,54.0,2.0,54.0,1368
10951,-2,12,10,3,7,54.0,2.0,54.0,1368
10952,19,38,57,1,0,54.0,2.0,54.0,1369
10953,62,38,100,1,1,54.0,2.0,54.0,1369
10954,13,81,94,2,2,54.0,2.0,54.0,1369
10955,22,73,95,2,3,54.0,2.0,54.0,1369
10956,34,63,97,3,4,54.0,2.0,54.0,1369
10957,37,61,98,3,5,54.0,2.0,54.0,1369
10958,-49,56,7,3,6,54.0,2.0,54.0,1369
10959,-18,18,0,3,7,54.0,2.0,54.0,1369
10960,65,35,100,1,0,54.0,2.0,54.0,1370
10961,100,0,100,1,1,54.0,2.0,54.0,1370
10962,36,64,100,2,2,54.0,2.0,54.0,1370
10963,78,22,100,2,3,54.0,2.0,54.0,1370
10964,36,64,100,3,4,54.0,2.0,54.0,1370
10965,27,73,100,3,5,54.0,2.0,54.0,1370
10966,26,74,100,3,6,54.0,2.0,54.0,1370
10967,85,15,100,3,7,54.0,2.0,54.0,1370
10968,18,21,39,1,0,54.0,2.0,54.0,1371
10969,-8,64,56,1,1,54.0,2.0,54.0,1371
10970,4,75,79,2,2,54.0,2.0,54.0,1371
10971,-71,100,29,2,3,54.0,2.0,54.0,1371
10972,15,85,100,3,4,54.0,2.0,54.0,1371
10973,-5,76,71,3,5,54.0,2.0,54.0,1371
10974,-4,25,21,3,6,54.0,2.0,54.0,1371
10975,0,56,56,3,7,54.0,2.0,54.0,1371
10976,70,30,100,1,0,54.0,2.0,54.0,1372
10977,22,78,100,1,1,54.0,2.0,54.0,1372
10978,95,3,98,2,2,54.0,2.0,54.0,1372
10979,50,50,100,2,3,54.0,2.0,54.0,1372
10980,4,96,100,3,4,54.0,2.0,54.0,1372
10981,48,52,100,3,5,54.0,2.0,54.0,1372
10982,91,9,100,3,6,54.0,2.0,54.0,1372
10983,50,50,100,3,7,54.0,2.0,54.0,1372
10984,18,38,56,1,0,54.0,2.0,54.0,1373
10985,0,100,100,1,1,54.0,2.0,54.0,1373
10986,0,100,100,2,2,54.0,2.0,54.0,1373
10987,0,100,100,2,3,54.0,2.0,54.0,1373
10988,-3,65,62,3,4,54.0,2.0,54.0,1373
10989,-12,57,45,3,5,54.0,2.0,54.0,1373
10990,57,0,57,3,6,54.0,2.0,54.0,1373
10991,25,0,25,3,7,54.0,2.0,54.0,1373
10992,10,14,24,1,0,54.0,2.0,54.0,1374
10993,15,56,71,1,1,54.0,2.0,54.0,1374
10994,7,11,18,2,2,54.0,2.0,54.0,1374
10995,-57,79,22,2,3,54.0,2.0,54.0,1374
10996,-13,38,25,3,4,54.0,2.0,54.0,1374
10997,17,13,30,3,5,54.0,2.0,54.0,1374
10998,11,8,19,3,6,54.0,2.0,54.0,1374
10999,0,0,0,3,7,54.0,2.0,54.0,1374
11000,25,39,64,1,0,54.0,2.0,54.0,1375
11001,1,60,61,1,1,54.0,2.0,54.0,1375
11002,35,45,80,2,2,54.0,2.0,54.0,1375
11003,-26,64,38,2,3,54.0,2.0,54.0,1375
11004,6,57,63,3,4,54.0,2.0,54.0,1375
11005,4,30,34,3,5,54.0,2.0,54.0,1375
11006,19,65,84,3,6,54.0,2.0,54.0,1375
11007,15,77,92,3,7,54.0,2.0,54.0,1375
11008,-23,23,0,1,0,54.0,2.0,54.0,1376
11009,50,0,50,1,1,54.0,2.0,54.0,1376
11010,19,79,98,2,2,54.0,2.0,54.0,1376
11011,7,93,100,2,3,54.0,2.0,54.0,1376
11012,31,69,100,3,4,54.0,2.0,54.0,1376
11013,94,6,100,3,5,54.0,2.0,54.0,1376
11014,0,100,100,3,6,54.0,2.0,54.0,1376
11015,-19,38,19,3,7,54.0,2.0,54.0,1376
11016,99,0,99,1,0,54.0,2.0,54.0,1377
11017,100,0,100,1,1,54.0,2.0,54.0,1377
11018,99,0,99,2,2,54.0,2.0,54.0,1377
11019,35,65,100,2,3,54.0,2.0,54.0,1377
11020,25,75,100,3,4,54.0,2.0,54.0,1377
11021,30,70,100,3,5,54.0,2.0,54.0,1377
11022,100,0,100,3,6,54.0,2.0,54.0,1377
11023,100,0,100,3,7,54.0,2.0,54.0,1377
11024,48,26,74,1,0,54.0,2.0,54.0,1378
11025,33,64,97,1,1,54.0,2.0,54.0,1378
11026,13,82,95,2,2,54.0,2.0,54.0,1378
11027,19,77,96,2,3,54.0,2.0,54.0,1378
11028,4,78,82,3,4,54.0,2.0,54.0,1378
11029,58,34,92,3,5,54.0,2.0,54.0,1378
11030,57,31,88,3,6,54.0,2.0,54.0,1378
11031,21,73,94,3,7,54.0,2.0,54.0,1378
11032,2,77,79,1,0,54.0,2.0,54.0,1379
11033,0,100,100,1,1,54.0,2.0,54.0,1379
11034,3,63,66,2,2,54.0,2.0,54.0,1379
11035,-8,34,26,2,3,54.0,2.0,54.0,1379
11036,7,50,57,3,4,54.0,2.0,54.0,1379
11037,-21,41,20,3,5,54.0,2.0,54.0,1379
11038,-38,100,62,3,6,54.0,2.0,54.0,1379
11039,0,67,67,3,7,54.0,2.0,54.0,1379
11040,100,0,100,1,0,54.0,2.0,54.0,1380
11041,0,100,100,1,1,54.0,2.0,54.0,1380
11042,0,0,0,2,2,54.0,2.0,54.0,1380
11043,0,0,0,2,3,54.0,2.0,54.0,1380
11044,-2,100,98,3,4,54.0,2.0,54.0,1380
11045,0,0,0,3,5,54.0,2.0,54.0,1380
11046,0,0,0,3,6,54.0,2.0,54.0,1380
11047,0,0,0,3,7,54.0,2.0,54.0,1380
11048,-61,77,16,1,0,54.0,2.0,54.0,1381
11049,-49,72,23,1,1,54.0,2.0,54.0,1381
11050,37,42,79,2,2,54.0,2.0,54.0,1381
11051,-7,29,22,2,3,54.0,2.0,54.0,1381
11052,7,75,82,3,4,54.0,2.0,54.0,1381
11053,-57,64,7,3,5,54.0,2.0,54.0,1381
11054,21,0,21,3,6,54.0,2.0,54.0,1381
11055,24,0,24,3,7,54.0,2.0,54.0,1381
11056,0,100,100,1,0,55.0,2.0,55.0,1382
11057,0,100,100,1,1,55.0,2.0,55.0,1382
11058,80,0,80,2,2,55.0,2.0,55.0,1382
11059,0,0,0,2,3,55.0,2.0,55.0,1382
11060,16,84,100,3,4,55.0,2.0,55.0,1382
11061,0,0,0,3,5,55.0,2.0,55.0,1382
11062,12,63,75,3,6,55.0,2.0,55.0,1382
11063,0,0,0,3,7,55.0,2.0,55.0,1382
11064,80,0,80,1,0,55.0,2.0,55.0,1383
11065,0,0,0,1,1,55.0,2.0,55.0,1383
11066,15,85,100,2,2,55.0,2.0,55.0,1383
11067,0,100,100,2,3,55.0,2.0,55.0,1383
11068,15,85,100,3,4,55.0,2.0,55.0,1383
11069,72,8,80,3,5,55.0,2.0,55.0,1383
11070,25,75,100,3,6,55.0,2.0,55.0,1383
11071,25,0,25,3,7,55.0,2.0,55.0,1383
11072,67,1,68,1,0,55.0,2.0,55.0,1384
11073,59,0,59,1,1,55.0,2.0,55.0,1384
11074,48,15,63,2,2,55.0,2.0,55.0,1384
11075,54,38,92,2,3,55.0,2.0,55.0,1384
11076,-21,100,79,3,4,55.0,2.0,55.0,1384
11077,23,38,61,3,5,55.0,2.0,55.0,1384
11078,17,50,67,3,6,55.0,2.0,55.0,1384
11079,81,0,81,3,7,55.0,2.0,55.0,1384
11080,47,53,100,1,0,55.0,2.0,55.0,1385
11081,0,100,100,1,1,55.0,2.0,55.0,1385
11082,0,0,0,2,2,55.0,2.0,55.0,1385
11083,100,0,100,2,3,55.0,2.0,55.0,1385
11084,0,100,100,3,4,55.0,2.0,55.0,1385
11085,100,0,100,3,5,55.0,2.0,55.0,1385
11086,-13,13,0,3,6,55.0,2.0,55.0,1385
11087,-9,14,5,3,7,55.0,2.0,55.0,1385
11088,-9,70,61,1,0,55.0,2.0,55.0,1386
11089,3,53,56,1,1,55.0,2.0,55.0,1386
11090,-17,77,60,2,2,55.0,2.0,55.0,1386
11091,-3,59,56,2,3,55.0,2.0,55.0,1386
11092,1,72,73,3,4,55.0,2.0,55.0,1386
11093,3,55,58,3,5,55.0,2.0,55.0,1386
11094,0,80,80,3,6,55.0,2.0,55.0,1386
11095,-3,34,31,3,7,55.0,2.0,55.0,1386
11096,38,0,38,1,0,55.0,2.0,55.0,1387
11097,0,0,0,1,1,55.0,2.0,55.0,1387
11098,29,26,55,2,2,55.0,2.0,55.0,1387
11099,0,100,100,2,3,55.0,2.0,55.0,1387
11100,24,44,68,3,4,55.0,2.0,55.0,1387
11101,25,50,75,3,5,55.0,2.0,55.0,1387
11102,0,50,50,3,6,55.0,2.0,55.0,1387
11103,46,0,46,3,7,55.0,2.0,55.0,1387
11104,65,25,90,1,0,55.0,2.0,55.0,1388
11105,16,35,51,1,1,55.0,2.0,55.0,1388
11106,30,0,30,2,2,55.0,2.0,55.0,1388
11107,75,0,75,2,3,55.0,2.0,55.0,1388
11108,8,52,60,3,4,55.0,2.0,55.0,1388
11109,32,23,55,3,5,55.0,2.0,55.0,1388
11110,11,9,20,3,6,55.0,2.0,55.0,1388
11111,10,0,10,3,7,55.0,2.0,55.0,1388
11112,18,41,59,1,0,55.0,2.0,55.0,1389
11113,43,57,100,1,1,55.0,2.0,55.0,1389
11114,25,45,70,2,2,55.0,2.0,55.0,1389
11115,39,44,83,2,3,55.0,2.0,55.0,1389
11116,0,50,50,3,4,55.0,2.0,55.0,1389
11117,5,16,21,3,5,55.0,2.0,55.0,1389
11118,0,100,100,3,6,55.0,2.0,55.0,1389
11119,47,10,57,3,7,55.0,2.0,55.0,1389
11120,-76,76,0,1,0,55.0,2.0,55.0,1390
11121,0,0,0,1,1,55.0,2.0,55.0,1390
11122,-25,74,49,2,2,55.0,2.0,55.0,1390
11123,1,50,51,2,3,55.0,2.0,55.0,1390
11124,-14,14,0,3,4,55.0,2.0,55.0,1390
11125,-19,69,50,3,5,55.0,2.0,55.0,1390
11126,12,38,50,3,6,55.0,2.0,55.0,1390
11127,7,5,12,3,7,55.0,2.0,55.0,1390
11128,-24,74,50,1,0,55.0,2.0,55.0,1391
11129,-17,100,83,1,1,55.0,2.0,55.0,1391
11130,1,51,52,2,2,55.0,2.0,55.0,1391
11131,12,57,69,2,3,55.0,2.0,55.0,1391
11132,-2,61,59,3,4,55.0,2.0,55.0,1391
11133,-3,53,50,3,5,55.0,2.0,55.0,1391
11134,-9,77,68,3,6,55.0,2.0,55.0,1391
11135,18,45,63,3,7,55.0,2.0,55.0,1391
11136,25,3,28,1,0,55.0,2.0,55.0,1392
11137,5,75,80,1,1,55.0,2.0,55.0,1392
11138,0,52,52,2,2,55.0,2.0,55.0,1392
11139,16,84,100,2,3,55.0,2.0,55.0,1392
11140,19,72,91,3,4,55.0,2.0,55.0,1392
11141,11,42,53,3,5,55.0,2.0,55.0,1392
11142,12,32,44,3,6,55.0,2.0,55.0,1392
11143,24,23,47,3,7,55.0,2.0,55.0,1392
11144,0,20,20,1,0,55.0,2.0,55.0,1393
11145,5,35,40,1,1,55.0,2.0,55.0,1393
11146,15,60,75,2,2,55.0,2.0,55.0,1393
11147,10,75,85,2,3,55.0,2.0,55.0,1393
11148,20,40,60,3,4,55.0,2.0,55.0,1393
11149,7,48,55,3,5,55.0,2.0,55.0,1393
11150,5,45,50,3,6,55.0,2.0,55.0,1393
11151,10,40,50,3,7,55.0,2.0,55.0,1393
11152,12,43,55,1,0,55.0,2.0,55.0,1394
11153,-5,60,55,1,1,55.0,2.0,55.0,1394
11154,2,58,60,2,2,55.0,2.0,55.0,1394
11155,-5,45,40,2,3,55.0,2.0,55.0,1394
11156,1,77,78,3,4,55.0,2.0,55.0,1394
11157,-1,45,44,3,5,55.0,2.0,55.0,1394
11158,1,42,43,3,6,55.0,2.0,55.0,1394
11159,17,22,39,3,7,55.0,2.0,55.0,1394
11160,20,49,69,1,0,55.0,2.0,55.0,1395
11161,17,63,80,1,1,55.0,2.0,55.0,1395
11162,19,50,69,2,2,55.0,2.0,55.0,1395
11163,35,43,78,2,3,55.0,2.0,55.0,1395
11164,14,58,72,3,4,55.0,2.0,55.0,1395
11165,18,50,68,3,5,55.0,2.0,55.0,1395
11166,59,17,76,3,6,55.0,2.0,55.0,1395
11167,46,34,80,3,7,55.0,2.0,55.0,1395
11168,-2,46,44,1,0,55.0,2.0,55.0,1396
11169,-17,57,40,1,1,55.0,2.0,55.0,1396
11170,-3,55,52,2,2,55.0,2.0,55.0,1396
11171,31,11,42,2,3,55.0,2.0,55.0,1396
11172,15,38,53,3,4,55.0,2.0,55.0,1396
11173,6,46,52,3,5,55.0,2.0,55.0,1396
11174,-13,77,64,3,6,55.0,2.0,55.0,1396
11175,9,43,52,3,7,55.0,2.0,55.0,1396
11176,0,50,50,1,0,55.0,2.0,55.0,1397
11177,20,0,20,1,1,55.0,2.0,55.0,1397
11178,0,100,100,2,2,55.0,2.0,55.0,1397
11179,48,50,98,2,3,55.0,2.0,55.0,1397
11180,0,50,50,3,4,55.0,2.0,55.0,1397
11181,38,25,63,3,5,55.0,2.0,55.0,1397
11182,-1,50,49,3,6,55.0,2.0,55.0,1397
11183,0,0,0,3,7,55.0,2.0,55.0,1397
11184,18,53,71,1,0,55.0,2.0,55.0,1398
11185,0,0,0,1,1,55.0,2.0,55.0,1398
11186,-12,12,0,2,2,55.0,2.0,55.0,1398
11187,0,0,0,2,3,55.0,2.0,55.0,1398
11188,21,79,100,3,4,55.0,2.0,55.0,1398
11189,50,0,50,3,5,55.0,2.0,55.0,1398
11190,16,84,100,3,6,55.0,2.0,55.0,1398
11191,37,19,56,3,7,55.0,2.0,55.0,1398
11192,85,0,85,1,0,55.0,2.0,55.0,1399
11193,82,8,90,1,1,55.0,2.0,55.0,1399
11194,89,4,93,2,2,55.0,2.0,55.0,1399
11195,61,35,96,2,3,55.0,2.0,55.0,1399
11196,28,72,100,3,4,55.0,2.0,55.0,1399
11197,74,19,93,3,5,55.0,2.0,55.0,1399
11198,97,1,98,3,6,55.0,2.0,55.0,1399
11199,87,3,90,3,7,55.0,2.0,55.0,1399
11200,9,58,67,1,0,55.0,2.0,55.0,1400
11201,10,50,60,1,1,55.0,2.0,55.0,1400
11202,9,50,59,2,2,55.0,2.0,55.0,1400
11203,-2,79,77,2,3,55.0,2.0,55.0,1400
11204,43,57,100,3,4,55.0,2.0,55.0,1400
11205,8,62,70,3,5,55.0,2.0,55.0,1400
11206,-2,72,70,3,6,55.0,2.0,55.0,1400
11207,37,50,87,3,7,55.0,2.0,55.0,1400
11208,4,55,59,1,0,55.0,2.0,55.0,1401
11209,12,60,72,1,1,55.0,2.0,55.0,1401
11210,31,11,42,2,2,55.0,2.0,55.0,1401
11211,7,23,30,2,3,55.0,2.0,55.0,1401
11212,29,63,92,3,4,55.0,2.0,55.0,1401
11213,13,50,63,3,5,55.0,2.0,55.0,1401
11214,-1,69,68,3,6,55.0,2.0,55.0,1401
11215,30,7,37,3,7,55.0,2.0,55.0,1401
11216,2,92,94,1,0,55.0,2.0,55.0,1402
11217,26,16,42,1,1,55.0,2.0,55.0,1402
11218,20,64,84,2,2,55.0,2.0,55.0,1402
11219,-8,35,27,2,3,55.0,2.0,55.0,1402
11220,24,48,72,3,4,55.0,2.0,55.0,1402
11221,14,47,61,3,5,55.0,2.0,55.0,1402
11222,17,72,89,3,6,55.0,2.0,55.0,1402
11223,41,56,97,3,7,55.0,2.0,55.0,1402
11224,6,71,77,1,0,55.0,2.0,55.0,1403
11225,-18,95,77,1,1,55.0,2.0,55.0,1403
11226,18,38,56,2,2,55.0,2.0,55.0,1403
11227,34,66,100,2,3,55.0,2.0,55.0,1403
11228,36,60,96,3,4,55.0,2.0,55.0,1403
11229,34,45,79,3,5,55.0,2.0,55.0,1403
11230,11,64,75,3,6,55.0,2.0,55.0,1403
11231,35,54,89,3,7,55.0,2.0,55.0,1403
11232,1,99,100,1,0,55.0,2.0,55.0,1404
11233,5,95,100,1,1,55.0,2.0,55.0,1404
11234,52,48,100,2,2,55.0,2.0,55.0,1404
11235,45,55,100,2,3,55.0,2.0,55.0,1404
11236,84,1,85,3,4,55.0,2.0,55.0,1404
11237,48,52,100,3,5,55.0,2.0,55.0,1404
11238,-22,48,26,3,6,55.0,2.0,55.0,1404
11239,39,61,100,3,7,55.0,2.0,55.0,1404
11240,28,72,100,1,0,56.0,2.0,56.0,1405
11241,47,53,100,1,1,56.0,2.0,56.0,1405
11242,68,21,89,2,2,56.0,2.0,56.0,1405
11243,-4,4,0,2,3,56.0,2.0,56.0,1405
11244,32,68,100,3,4,56.0,2.0,56.0,1405
11245,-57,57,0,3,5,56.0,2.0,56.0,1405
11246,4,76,80,3,6,56.0,2.0,56.0,1405
11247,92,6,98,3,7,56.0,2.0,56.0,1405
11248,7,50,57,1,0,56.0,2.0,56.0,1406
11249,0,58,58,1,1,56.0,2.0,56.0,1406
11250,-3,59,56,2,2,56.0,2.0,56.0,1406
11251,12,58,70,2,3,56.0,2.0,56.0,1406
11252,-6,61,55,3,4,56.0,2.0,56.0,1406
11253,10,50,60,3,5,56.0,2.0,56.0,1406
11254,24,44,68,3,6,56.0,2.0,56.0,1406
11255,-44,100,56,3,7,56.0,2.0,56.0,1406
11256,65,25,90,1,0,56.0,2.0,56.0,1407
11257,27,38,65,1,1,56.0,2.0,56.0,1407
11258,36,44,80,2,2,56.0,2.0,56.0,1407
11259,-11,19,8,2,3,56.0,2.0,56.0,1407
11260,18,59,77,3,4,56.0,2.0,56.0,1407
11261,100,0,100,3,5,56.0,2.0,56.0,1407
11262,-23,73,50,3,6,56.0,2.0,56.0,1407
11263,6,0,6,3,7,56.0,2.0,56.0,1407
11264,100,0,100,1,0,56.0,2.0,56.0,1408
11265,0,100,100,1,1,56.0,2.0,56.0,1408
11266,100,0,100,2,2,56.0,2.0,56.0,1408
11267,100,0,100,2,3,56.0,2.0,56.0,1408
11268,100,0,100,3,4,56.0,2.0,56.0,1408
11269,100,0,100,3,5,56.0,2.0,56.0,1408
11270,66,34,100,3,6,56.0,2.0,56.0,1408
11271,100,0,100,3,7,56.0,2.0,56.0,1408
11272,0,100,100,1,0,56.0,2.0,56.0,1409
11273,0,100,100,1,1,56.0,2.0,56.0,1409
11274,72,28,100,2,2,56.0,2.0,56.0,1409
11275,100,0,100,2,3,56.0,2.0,56.0,1409
11276,34,66,100,3,4,56.0,2.0,56.0,1409
11277,50,50,100,3,5,56.0,2.0,56.0,1409
11278,84,16,100,3,6,56.0,2.0,56.0,1409
11279,-17,17,0,3,7,56.0,2.0,56.0,1409
11280,33,67,100,1,0,56.0,2.0,56.0,1410
11281,88,12,100,1,1,56.0,2.0,56.0,1410
11282,28,72,100,2,2,56.0,2.0,56.0,1410
11283,70,30,100,2,3,56.0,2.0,56.0,1410
11284,16,84,100,3,4,56.0,2.0,56.0,1410
11285,72,28,100,3,5,56.0,2.0,56.0,1410
11286,41,59,100,3,6,56.0,2.0,56.0,1410
11287,-24,24,0,3,7,56.0,2.0,56.0,1410
11288,64,15,79,1,0,56.0,2.0,56.0,1411
11289,-5,35,30,1,1,56.0,2.0,56.0,1411
11290,41,59,100,2,2,56.0,2.0,56.0,1411
11291,51,23,74,2,3,56.0,2.0,56.0,1411
11292,74,18,92,3,4,56.0,2.0,56.0,1411
11293,36,64,100,3,5,56.0,2.0,56.0,1411
11294,62,16,78,3,6,56.0,2.0,56.0,1411
11295,69,12,81,3,7,56.0,2.0,56.0,1411
11296,-8,79,71,1,0,56.0,2.0,56.0,1412
11297,0,0,0,1,1,56.0,2.0,56.0,1412
11298,40,34,74,2,2,56.0,2.0,56.0,1412
11299,12,63,75,2,3,56.0,2.0,56.0,1412
11300,5,63,68,3,4,56.0,2.0,56.0,1412
11301,0,50,50,3,5,56.0,2.0,56.0,1412
11302,16,77,93,3,6,56.0,2.0,56.0,1412
11303,17,17,34,3,7,56.0,2.0,56.0,1412
11304,33,32,65,1,0,56.0,2.0,56.0,1413
11305,0,0,0,1,1,56.0,2.0,56.0,1413
11306,-6,72,66,2,2,56.0,2.0,56.0,1413
11307,-15,93,78,2,3,56.0,2.0,56.0,1413
11308,17,62,79,3,4,56.0,2.0,56.0,1413
11309,0,34,34,3,5,56.0,2.0,56.0,1413
11310,0,100,100,3,6,56.0,2.0,56.0,1413
11311,9,28,37,3,7,56.0,2.0,56.0,1413
11312,5,33,38,1,0,56.0,2.0,56.0,1414
11313,23,58,81,1,1,56.0,2.0,56.0,1414
11314,1,40,41,2,2,56.0,2.0,56.0,1414
11315,-11,42,31,2,3,56.0,2.0,56.0,1414
11316,3,80,83,3,4,56.0,2.0,56.0,1414
11317,-14,37,23,3,5,56.0,2.0,56.0,1414
11318,-32,69,37,3,6,56.0,2.0,56.0,1414
11319,-28,32,4,3,7,56.0,2.0,56.0,1414
11320,84,3,87,1,0,56.0,2.0,56.0,1415
11321,-4,96,92,1,1,56.0,2.0,56.0,1415
11322,97,0,97,2,2,56.0,2.0,56.0,1415
11323,91,0,91,2,3,56.0,2.0,56.0,1415
11324,26,72,98,3,4,56.0,2.0,56.0,1415
11325,82,12,94,3,5,56.0,2.0,56.0,1415
11326,-2,100,98,3,6,56.0,2.0,56.0,1415
11327,96,0,96,3,7,56.0,2.0,56.0,1415
11328,47,39,86,1,0,56.0,2.0,56.0,1416
11329,-4,85,81,1,1,56.0,2.0,56.0,1416
11330,61,36,97,2,2,56.0,2.0,56.0,1416
11331,48,42,90,2,3,56.0,2.0,56.0,1416
11332,43,49,92,3,4,56.0,2.0,56.0,1416
11333,35,54,89,3,5,56.0,2.0,56.0,1416
11334,44,36,80,3,6,56.0,2.0,56.0,1416
11335,86,0,86,3,7,56.0,2.0,56.0,1416
11336,95,0,95,1,0,56.0,2.0,56.0,1417
11337,-10,55,45,1,1,56.0,2.0,56.0,1417
11338,50,45,95,2,2,56.0,2.0,56.0,1417
11339,80,15,95,2,3,56.0,2.0,56.0,1417
11340,30,65,95,3,4,56.0,2.0,56.0,1417
11341,95,0,95,3,5,56.0,2.0,56.0,1417
11342,50,45,95,3,6,56.0,2.0,56.0,1417
11343,94,1,95,3,7,56.0,2.0,56.0,1417
11344,-9,39,30,1,0,56.0,2.0,56.0,1418
11345,40,37,77,1,1,56.0,2.0,56.0,1418
11346,1,63,64,2,2,56.0,2.0,56.0,1418
11347,12,63,75,2,3,56.0,2.0,56.0,1418
11348,3,75,78,3,4,56.0,2.0,56.0,1418
11349,13,23,36,3,5,56.0,2.0,56.0,1418
11350,25,38,63,3,6,56.0,2.0,56.0,1418
11351,48,25,73,3,7,56.0,2.0,56.0,1418
11352,29,71,100,1,0,56.0,2.0,56.0,1419
11353,-19,27,8,1,1,56.0,2.0,56.0,1419
11354,75,24,99,2,2,56.0,2.0,56.0,1419
11355,98,2,100,2,3,56.0,2.0,56.0,1419
11356,31,69,100,3,4,56.0,2.0,56.0,1419
11357,73,22,95,3,5,56.0,2.0,56.0,1419
11358,11,89,100,3,6,56.0,2.0,56.0,1419
11359,98,2,100,3,7,56.0,2.0,56.0,1419
11360,49,51,100,1,0,56.0,2.0,56.0,1420
11361,-27,57,30,1,1,56.0,2.0,56.0,1420
11362,1,88,89,2,2,56.0,2.0,56.0,1420
11363,34,66,100,2,3,56.0,2.0,56.0,1420
11364,43,40,83,3,4,56.0,2.0,56.0,1420
11365,-33,63,30,3,5,56.0,2.0,56.0,1420
11366,-36,100,64,3,6,56.0,2.0,56.0,1420
11367,62,0,62,3,7,56.0,2.0,56.0,1420
11368,-48,48,0,1,0,56.0,2.0,56.0,1421
11369,11,44,55,1,1,56.0,2.0,56.0,1421
11370,0,100,100,2,2,56.0,2.0,56.0,1421
11371,6,80,86,2,3,56.0,2.0,56.0,1421
11372,4,78,82,3,4,56.0,2.0,56.0,1421
11373,-6,50,44,3,5,56.0,2.0,56.0,1421
11374,92,8,100,3,6,56.0,2.0,56.0,1421
11375,25,0,25,3,7,56.0,2.0,56.0,1421
11376,29,42,71,1,0,57.0,2.0,57.0,1422
11377,21,50,71,1,1,57.0,2.0,57.0,1422
11378,0,50,50,2,2,57.0,2.0,57.0,1422
11379,4,50,54,2,3,57.0,2.0,57.0,1422
11380,4,68,72,3,4,57.0,2.0,57.0,1422
11381,48,35,83,3,5,57.0,2.0,57.0,1422
11382,-7,96,89,3,6,57.0,2.0,57.0,1422
11383,33,0,33,3,7,57.0,2.0,57.0,1422
11384,2,93,95,1,0,57.0,2.0,57.0,1423
11385,0,100,100,1,1,57.0,2.0,57.0,1423
11386,0,50,50,2,2,57.0,2.0,57.0,1423
11387,0,100,100,2,3,57.0,2.0,57.0,1423
11388,0,0,0,3,4,57.0,2.0,57.0,1423
11389,-10,100,90,3,5,57.0,2.0,57.0,1423
11390,-1,36,35,3,6,57.0,2.0,57.0,1423
11391,-11,50,39,3,7,57.0,2.0,57.0,1423
11392,55,20,75,1,0,57.0,2.0,57.0,1424
11393,11,7,18,1,1,57.0,2.0,57.0,1424
11394,-5,13,8,2,2,57.0,2.0,57.0,1424
11395,92,0,92,2,3,57.0,2.0,57.0,1424
11396,0,66,66,3,4,57.0,2.0,57.0,1424
11397,11,75,86,3,5,57.0,2.0,57.0,1424
11398,0,0,0,3,6,57.0,2.0,57.0,1424
11399,6,0,6,3,7,57.0,2.0,57.0,1424
11400,47,23,70,1,0,57.0,2.0,57.0,1425
11401,13,87,100,1,1,57.0,2.0,57.0,1425
11402,44,33,77,2,2,57.0,2.0,57.0,1425
11403,30,65,95,2,3,57.0,2.0,57.0,1425
11404,28,62,90,3,4,57.0,2.0,57.0,1425
11405,50,35,85,3,5,57.0,2.0,57.0,1425
11406,48,36,84,3,6,57.0,2.0,57.0,1425
11407,33,31,64,3,7,57.0,2.0,57.0,1425
11408,6,71,77,1,0,57.0,2.0,57.0,1426
11409,13,86,99,1,1,57.0,2.0,57.0,1426
11410,-9,32,23,2,2,57.0,2.0,57.0,1426
11411,25,42,67,2,3,57.0,2.0,57.0,1426
11412,55,33,88,3,4,57.0,2.0,57.0,1426
11413,70,23,93,3,5,57.0,2.0,57.0,1426
11414,-3,76,73,3,6,57.0,2.0,57.0,1426
11415,66,21,87,3,7,57.0,2.0,57.0,1426
11416,-6,6,0,1,0,57.0,2.0,57.0,1427
11417,0,0,0,1,1,57.0,2.0,57.0,1427
11418,-45,45,0,2,2,57.0,2.0,57.0,1427
11419,0,100,100,2,3,57.0,2.0,57.0,1427
11420,16,84,100,3,4,57.0,2.0,57.0,1427
11421,-15,34,19,3,5,57.0,2.0,57.0,1427
11422,-16,64,48,3,6,57.0,2.0,57.0,1427
11423,0,0,0,3,7,57.0,2.0,57.0,1427
11424,15,40,55,1,0,57.0,2.0,57.0,1428
11425,17,50,67,1,1,57.0,2.0,57.0,1428
11426,9,60,69,2,2,57.0,2.0,57.0,1428
11427,88,11,99,2,3,57.0,2.0,57.0,1428
11428,43,26,69,3,4,57.0,2.0,57.0,1428
11429,64,36,100,3,5,57.0,2.0,57.0,1428
11430,66,34,100,3,6,57.0,2.0,57.0,1428
11431,45,20,65,3,7,57.0,2.0,57.0,1428
11432,-11,49,38,1,0,57.0,2.0,57.0,1429
11433,0,59,59,1,1,57.0,2.0,57.0,1429
11434,-1,38,37,2,2,57.0,2.0,57.0,1429
11435,-3,62,59,2,3,57.0,2.0,57.0,1429
11436,-6,42,36,3,4,57.0,2.0,57.0,1429
11437,-2,41,39,3,5,57.0,2.0,57.0,1429
11438,-2,62,60,3,6,57.0,2.0,57.0,1429
11439,1,38,39,3,7,57.0,2.0,57.0,1429
11440,49,51,100,1,0,57.0,2.0,57.0,1430
11441,72,28,100,1,1,57.0,2.0,57.0,1430
11442,47,53,100,2,2,57.0,2.0,57.0,1430
11443,50,50,100,2,3,57.0,2.0,57.0,1430
11444,0,100,100,3,4,57.0,2.0,57.0,1430
11445,51,49,100,3,5,57.0,2.0,57.0,1430
11446,79,21,100,3,6,57.0,2.0,57.0,1430
11447,85,15,100,3,7,57.0,2.0,57.0,1430
11448,32,60,92,1,0,57.0,2.0,57.0,1431
11449,-33,100,67,1,1,57.0,2.0,57.0,1431
11450,1,65,66,2,2,57.0,2.0,57.0,1431
11451,42,27,69,2,3,57.0,2.0,57.0,1431
11452,-9,77,68,3,4,57.0,2.0,57.0,1431
11453,10,59,69,3,5,57.0,2.0,57.0,1431
11454,-12,83,71,3,6,57.0,2.0,57.0,1431
11455,-1,66,65,3,7,57.0,2.0,57.0,1431
11456,-3,21,18,1,0,57.0,2.0,57.0,1432
11457,-23,50,27,1,1,57.0,2.0,57.0,1432
11458,9,64,73,2,2,57.0,2.0,57.0,1432
11459,0,86,86,2,3,57.0,2.0,57.0,1432
11460,3,67,70,3,4,57.0,2.0,57.0,1432
11461,1,34,35,3,5,57.0,2.0,57.0,1432
11462,-1,17,16,3,6,57.0,2.0,57.0,1432
11463,-8,23,15,3,7,57.0,2.0,57.0,1432
11464,-19,82,63,1,0,57.0,2.0,57.0,1433
11465,82,0,82,1,1,57.0,2.0,57.0,1433
11466,0,13,13,2,2,57.0,2.0,57.0,1433
11467,0,20,20,2,3,57.0,2.0,57.0,1433
11468,4,93,97,3,4,57.0,2.0,57.0,1433
11469,-7,86,79,3,5,57.0,2.0,57.0,1433
11470,10,1,11,3,6,57.0,2.0,57.0,1433
11471,-5,10,5,3,7,57.0,2.0,57.0,1433
11472,40,42,82,1,0,57.0,2.0,57.0,1434
11473,0,69,69,1,1,57.0,2.0,57.0,1434
11474,-28,60,32,2,2,57.0,2.0,57.0,1434
11475,6,94,100,2,3,57.0,2.0,57.0,1434
11476,48,52,100,3,4,57.0,2.0,57.0,1434
11477,63,37,100,3,5,57.0,2.0,57.0,1434
11478,0,100,100,3,6,57.0,2.0,57.0,1434
11479,33,67,100,3,7,57.0,2.0,57.0,1434
11480,55,23,78,1,0,57.0,2.0,57.0,1435
11481,9,30,39,1,1,57.0,2.0,57.0,1435
11482,3,61,64,2,2,57.0,2.0,57.0,1435
11483,59,20,79,2,3,57.0,2.0,57.0,1435
11484,23,58,81,3,4,57.0,2.0,57.0,1435
11485,1,50,51,3,5,57.0,2.0,57.0,1435
11486,46,34,80,3,6,57.0,2.0,57.0,1435
11487,36,26,62,3,7,57.0,2.0,57.0,1435
11488,34,31,65,1,0,57.0,2.0,57.0,1436
11489,-51,78,27,1,1,57.0,2.0,57.0,1436
11490,-32,53,21,2,2,57.0,2.0,57.0,1436
11491,-8,29,21,2,3,57.0,2.0,57.0,1436
11492,-22,75,53,3,4,57.0,2.0,57.0,1436
11493,-2,34,32,3,5,57.0,2.0,57.0,1436
11494,-44,61,17,3,6,57.0,2.0,57.0,1436
11495,0,17,17,3,7,57.0,2.0,57.0,1436
11496,-51,62,11,1,0,57.0,2.0,57.0,1437
11497,-18,23,5,1,1,57.0,2.0,57.0,1437
11498,-5,7,2,2,2,57.0,2.0,57.0,1437
11499,-7,28,21,2,3,57.0,2.0,57.0,1437
11500,-12,21,9,3,4,57.0,2.0,57.0,1437
11501,-14,15,1,3,5,57.0,2.0,57.0,1437
11502,-3,87,84,3,6,57.0,2.0,57.0,1437
11503,-10,16,6,3,7,57.0,2.0,57.0,1437
11504,-30,70,40,1,0,58.0,2.0,58.0,1438
11505,9,91,100,1,1,58.0,2.0,58.0,1438
11506,-44,52,8,2,2,58.0,2.0,58.0,1438
11507,-32,89,57,2,3,58.0,2.0,58.0,1438
11508,-46,59,13,3,4,58.0,2.0,58.0,1438
11509,-25,44,19,3,5,58.0,2.0,58.0,1438
11510,-30,57,27,3,6,58.0,2.0,58.0,1438
11511,-47,53,6,3,7,58.0,2.0,58.0,1438
11512,-98,100,2,1,0,58.0,2.0,58.0,1439
11513,1,99,100,1,1,58.0,2.0,58.0,1439
11514,99,0,99,2,2,58.0,2.0,58.0,1439
11515,1,0,1,2,3,58.0,2.0,58.0,1439
11516,98,1,99,3,4,58.0,2.0,58.0,1439
11517,99,1,100,3,5,58.0,2.0,58.0,1439
11518,100,0,100,3,6,58.0,2.0,58.0,1439
11519,12,88,100,3,7,58.0,2.0,58.0,1439
11520,7,33,40,1,0,58.0,2.0,58.0,1440
11521,14,20,34,1,1,58.0,2.0,58.0,1440
11522,-2,35,33,2,2,58.0,2.0,58.0,1440
11523,-2,36,34,2,3,58.0,2.0,58.0,1440
11524,14,32,46,3,4,58.0,2.0,58.0,1440
11525,29,34,63,3,5,58.0,2.0,58.0,1440
11526,18,74,92,3,6,58.0,2.0,58.0,1440
11527,0,28,28,3,7,58.0,2.0,58.0,1440
11528,66,34,100,1,0,58.0,2.0,58.0,1441
11529,5,95,100,1,1,58.0,2.0,58.0,1441
11530,30,70,100,2,2,58.0,2.0,58.0,1441
11531,61,39,100,2,3,58.0,2.0,58.0,1441
11532,39,61,100,3,4,58.0,2.0,58.0,1441
11533,68,32,100,3,5,58.0,2.0,58.0,1441
11534,15,85,100,3,6,58.0,2.0,58.0,1441
11535,78,22,100,3,7,58.0,2.0,58.0,1441
11536,37,34,71,1,0,58.0,2.0,58.0,1442
11537,51,30,81,1,1,58.0,2.0,58.0,1442
11538,1,80,81,2,2,58.0,2.0,58.0,1442
11539,0,70,70,2,3,58.0,2.0,58.0,1442
11540,16,67,83,3,4,58.0,2.0,58.0,1442
11541,39,44,83,3,5,58.0,2.0,58.0,1442
11542,20,5,25,3,6,58.0,2.0,58.0,1442
11543,40,35,75,3,7,58.0,2.0,58.0,1442
11544,61,31,92,1,0,58.0,2.0,58.0,1443
11545,58,35,93,1,1,58.0,2.0,58.0,1443
11546,0,50,50,2,2,58.0,2.0,58.0,1443
11547,70,25,95,2,3,58.0,2.0,58.0,1443
11548,41,50,91,3,4,58.0,2.0,58.0,1443
11549,42,50,92,3,5,58.0,2.0,58.0,1443
11550,50,50,100,3,6,58.0,2.0,58.0,1443
11551,78,11,89,3,7,58.0,2.0,58.0,1443
11552,-23,51,28,1,0,58.0,2.0,58.0,1444
11553,51,35,86,1,1,58.0,2.0,58.0,1444
11554,14,59,73,2,2,58.0,2.0,58.0,1444
11555,11,81,92,2,3,58.0,2.0,58.0,1444
11556,32,55,87,3,4,58.0,2.0,58.0,1444
11557,48,42,90,3,5,58.0,2.0,58.0,1444
11558,30,55,85,3,6,58.0,2.0,58.0,1444
11559,65,17,82,3,7,58.0,2.0,58.0,1444
11560,3,49,52,1,0,58.0,2.0,58.0,1445
11561,41,5,46,1,1,58.0,2.0,58.0,1445
11562,16,52,68,2,2,58.0,2.0,58.0,1445
11563,27,26,53,2,3,58.0,2.0,58.0,1445
11564,4,73,77,3,4,58.0,2.0,58.0,1445
11565,71,13,84,3,5,58.0,2.0,58.0,1445
11566,10,84,94,3,6,58.0,2.0,58.0,1445
11567,40,7,47,3,7,58.0,2.0,58.0,1445
11568,45,50,95,1,0,58.0,2.0,58.0,1446
11569,34,50,84,1,1,58.0,2.0,58.0,1446
11570,40,50,90,2,2,58.0,2.0,58.0,1446
11571,40,50,90,2,3,58.0,2.0,58.0,1446
11572,19,66,85,3,4,58.0,2.0,58.0,1446
11573,33,50,83,3,5,58.0,2.0,58.0,1446
11574,55,38,93,3,6,58.0,2.0,58.0,1446
11575,77,12,89,3,7,58.0,2.0,58.0,1446
11576,19,50,69,1,0,58.0,2.0,58.0,1447
11577,46,19,65,1,1,58.0,2.0,58.0,1447
11578,12,51,63,2,2,58.0,2.0,58.0,1447
11579,15,48,63,2,3,58.0,2.0,58.0,1447
11580,11,53,64,3,4,58.0,2.0,58.0,1447
11581,17,53,70,3,5,58.0,2.0,58.0,1447
11582,22,49,71,3,6,58.0,2.0,58.0,1447
11583,18,52,70,3,7,58.0,2.0,58.0,1447
11584,0,0,0,1,0,58.0,2.0,58.0,1448
11585,8,92,100,1,1,58.0,2.0,58.0,1448
11586,0,100,100,2,2,58.0,2.0,58.0,1448
11587,63,0,63,2,3,58.0,2.0,58.0,1448
11588,19,81,100,3,4,58.0,2.0,58.0,1448
11589,0,26,26,3,5,58.0,2.0,58.0,1448
11590,64,0,64,3,6,58.0,2.0,58.0,1448
11591,92,1,93,3,7,58.0,2.0,58.0,1448
11592,77,9,86,1,0,58.0,2.0,58.0,1449
11593,-17,17,0,1,1,58.0,2.0,58.0,1449
11594,30,68,98,2,2,58.0,2.0,58.0,1449
11595,-13,87,74,2,3,58.0,2.0,58.0,1449
11596,23,50,73,3,4,58.0,2.0,58.0,1449
11597,28,49,77,3,5,58.0,2.0,58.0,1449
11598,21,77,98,3,6,58.0,2.0,58.0,1449
11599,25,74,99,3,7,58.0,2.0,58.0,1449
11600,0,50,50,1,0,59.0,2.0,59.0,1450
11601,0,0,0,1,1,59.0,2.0,59.0,1450
11602,1,0,1,2,2,59.0,2.0,59.0,1450
11603,0,0,0,2,3,59.0,2.0,59.0,1450
11604,0,0,0,3,4,59.0,2.0,59.0,1450
11605,0,0,0,3,5,59.0,2.0,59.0,1450
11606,5,50,55,3,6,59.0,2.0,59.0,1450
11607,0,0,0,3,7,59.0,2.0,59.0,1450
11608,100,0,100,1,0,59.0,2.0,59.0,1451
11609,33,23,56,1,1,59.0,2.0,59.0,1451
11610,100,0,100,2,2,59.0,2.0,59.0,1451
11611,-7,87,80,2,3,59.0,2.0,59.0,1451
11612,12,88,100,3,4,59.0,2.0,59.0,1451
11613,87,13,100,3,5,59.0,2.0,59.0,1451
11614,31,69,100,3,6,59.0,2.0,59.0,1451
11615,100,0,100,3,7,59.0,2.0,59.0,1451
11616,21,0,21,1,0,59.0,2.0,59.0,1452
11617,0,100,100,1,1,59.0,2.0,59.0,1452
11618,100,0,100,2,2,59.0,2.0,59.0,1452
11619,100,0,100,2,3,59.0,2.0,59.0,1452
11620,86,14,100,3,4,59.0,2.0,59.0,1452
11621,13,0,13,3,5,59.0,2.0,59.0,1452
11622,82,0,82,3,6,59.0,2.0,59.0,1452
11623,29,71,100,3,7,59.0,2.0,59.0,1452
11624,75,18,93,1,0,59.0,2.0,59.0,1453
11625,68,30,98,1,1,59.0,2.0,59.0,1453
11626,10,85,95,2,2,59.0,2.0,59.0,1453
11627,2,88,90,2,3,59.0,2.0,59.0,1453
11628,-3,89,86,3,4,59.0,2.0,59.0,1453
11629,64,26,90,3,5,59.0,2.0,59.0,1453
11630,74,26,100,3,6,59.0,2.0,59.0,1453
11631,15,0,15,3,7,59.0,2.0,59.0,1453
11632,48,30,78,1,0,59.0,2.0,59.0,1454
11633,-11,100,89,1,1,59.0,2.0,59.0,1454
11634,57,16,73,2,2,59.0,2.0,59.0,1454
11635,76,0,76,2,3,59.0,2.0,59.0,1454
11636,29,44,73,3,4,59.0,2.0,59.0,1454
11637,81,11,92,3,5,59.0,2.0,59.0,1454
11638,97,3,100,3,6,59.0,2.0,59.0,1454
11639,71,8,79,3,7,59.0,2.0,59.0,1454
11640,-37,64,27,1,0,59.0,2.0,59.0,1455
11641,2,65,67,1,1,59.0,2.0,59.0,1455
11642,1,59,60,2,2,59.0,2.0,59.0,1455
11643,0,61,61,2,3,59.0,2.0,59.0,1455
11644,9,61,70,3,4,59.0,2.0,59.0,1455
11645,9,73,82,3,5,59.0,2.0,59.0,1455
11646,9,78,87,3,6,59.0,2.0,59.0,1455
11647,-2,23,21,3,7,59.0,2.0,59.0,1455
11648,22,50,72,1,0,59.0,2.0,59.0,1456
11649,-10,85,75,1,1,59.0,2.0,59.0,1456
11650,50,26,76,2,2,59.0,2.0,59.0,1456
11651,34,14,48,2,3,59.0,2.0,59.0,1456
11652,14,54,68,3,4,59.0,2.0,59.0,1456
11653,28,44,72,3,5,59.0,2.0,59.0,1456
11654,42,42,84,3,6,59.0,2.0,59.0,1456
11655,50,19,69,3,7,59.0,2.0,59.0,1456
11656,50,50,100,1,0,59.0,2.0,59.0,1457
11657,0,100,100,1,1,59.0,2.0,59.0,1457
11658,93,7,100,2,2,59.0,2.0,59.0,1457
11659,6,91,97,2,3,59.0,2.0,59.0,1457
11660,43,57,100,3,4,59.0,2.0,59.0,1457
11661,99,1,100,3,5,59.0,2.0,59.0,1457
11662,21,79,100,3,6,59.0,2.0,59.0,1457
11663,0,0,0,3,7,59.0,2.0,59.0,1457
11664,57,43,100,1,0,59.0,2.0,59.0,1458
11665,-36,36,0,1,1,59.0,2.0,59.0,1458
11666,100,0,100,2,2,59.0,2.0,59.0,1458
11667,100,0,100,2,3,59.0,2.0,59.0,1458
11668,58,42,100,3,4,59.0,2.0,59.0,1458
11669,-48,48,0,3,5,59.0,2.0,59.0,1458
11670,-49,49,0,3,6,59.0,2.0,59.0,1458
11671,100,0,100,3,7,59.0,2.0,59.0,1458
11672,98,0,98,1,0,59.0,2.0,59.0,1459
11673,52,24,76,1,1,59.0,2.0,59.0,1459
11674,51,49,100,2,2,59.0,2.0,59.0,1459
11675,24,76,100,2,3,59.0,2.0,59.0,1459
11676,59,37,96,3,4,59.0,2.0,59.0,1459
11677,51,49,100,3,5,59.0,2.0,59.0,1459
11678,90,10,100,3,6,59.0,2.0,59.0,1459
11679,0,11,11,3,7,59.0,2.0,59.0,1459
11680,3,0,3,1,0,59.0,2.0,59.0,1460
11681,57,41,98,1,1,59.0,2.0,59.0,1460
11682,73,26,99,2,2,59.0,2.0,59.0,1460
11683,88,11,99,2,3,59.0,2.0,59.0,1460
11684,95,4,99,3,4,59.0,2.0,59.0,1460
11685,85,12,97,3,5,59.0,2.0,59.0,1460
11686,13,87,100,3,6,59.0,2.0,59.0,1460
11687,99,0,99,3,7,59.0,2.0,59.0,1460
11688,-36,57,21,1,0,59.0,2.0,59.0,1461
11689,8,73,81,1,1,59.0,2.0,59.0,1461
11690,13,65,78,2,2,59.0,2.0,59.0,1461
11691,1,29,30,2,3,59.0,2.0,59.0,1461
11692,100,0,100,3,4,59.0,2.0,59.0,1461
11693,23,0,23,3,5,59.0,2.0,59.0,1461
11694,-2,34,32,3,6,59.0,2.0,59.0,1461
11695,15,1,16,3,7,59.0,2.0,59.0,1461
11696,10,90,100,1,0,59.0,2.0,59.0,1462
11697,-10,77,67,1,1,59.0,2.0,59.0,1462
11698,-23,89,66,2,2,59.0,2.0,59.0,1462
11699,-11,77,66,2,3,59.0,2.0,59.0,1462
11700,96,4,100,3,4,59.0,2.0,59.0,1462
11701,39,61,100,3,5,59.0,2.0,59.0,1462
11702,7,70,77,3,6,59.0,2.0,59.0,1462
11703,-13,77,64,3,7,59.0,2.0,59.0,1462
11704,3,44,47,1,0,59.0,2.0,59.0,1463
11705,-11,35,24,1,1,59.0,2.0,59.0,1463
11706,0,100,100,2,2,59.0,2.0,59.0,1463
11707,0,100,100,2,3,59.0,2.0,59.0,1463
11708,24,62,86,3,4,59.0,2.0,59.0,1463
11709,45,46,91,3,5,59.0,2.0,59.0,1463
11710,7,93,100,3,6,59.0,2.0,59.0,1463
11711,22,48,70,3,7,59.0,2.0,59.0,1463
11712,47,21,68,1,0,59.0,2.0,59.0,1464
11713,-22,43,21,1,1,59.0,2.0,59.0,1464
11714,0,26,26,2,2,59.0,2.0,59.0,1464
11715,2,66,68,2,3,59.0,2.0,59.0,1464
11716,24,67,91,3,4,59.0,2.0,59.0,1464
11717,44,34,78,3,5,59.0,2.0,59.0,1464
11718,15,81,96,3,6,59.0,2.0,59.0,1464
11719,-1,21,20,3,7,59.0,2.0,59.0,1464
11720,-12,50,38,1,0,59.0,2.0,59.0,1465
11721,-13,63,50,1,1,59.0,2.0,59.0,1465
11722,3,41,44,2,2,59.0,2.0,59.0,1465
11723,-22,66,44,2,3,59.0,2.0,59.0,1465
11724,18,48,66,3,4,59.0,2.0,59.0,1465
11725,17,37,54,3,5,59.0,2.0,59.0,1465
11726,11,50,61,3,6,59.0,2.0,59.0,1465
11727,15,40,55,3,7,59.0,2.0,59.0,1465
11728,47,25,72,1,0,59.0,2.0,59.0,1466
11729,-75,87,12,1,1,59.0,2.0,59.0,1466
11730,-12,100,88,2,2,59.0,2.0,59.0,1466
11731,0,100,100,2,3,59.0,2.0,59.0,1466
11732,-6,21,15,3,4,59.0,2.0,59.0,1466
11733,6,69,75,3,5,59.0,2.0,59.0,1466
11734,7,75,82,3,6,59.0,2.0,59.0,1466
11735,8,4,12,3,7,59.0,2.0,59.0,1466
11736,83,2,85,1,0,59.0,2.0,59.0,1467
11737,97,3,100,1,1,59.0,2.0,59.0,1467
11738,93,7,100,2,2,59.0,2.0,59.0,1467
11739,100,0,100,2,3,59.0,2.0,59.0,1467
11740,48,52,100,3,4,59.0,2.0,59.0,1467
11741,0,0,0,3,5,59.0,2.0,59.0,1467
11742,5,95,100,3,6,59.0,2.0,59.0,1467
11743,-1,1,0,3,7,59.0,2.0,59.0,1467
11744,-20,21,1,1,0,59.0,2.0,59.0,1468
11745,1,63,64,1,1,59.0,2.0,59.0,1468
11746,1,76,77,2,2,59.0,2.0,59.0,1468
11747,-6,48,42,2,3,59.0,2.0,59.0,1468
11748,6,89,95,3,4,59.0,2.0,59.0,1468
11749,16,9,25,3,5,59.0,2.0,59.0,1468
11750,22,78,100,3,6,59.0,2.0,59.0,1468
11751,-24,25,1,3,7,59.0,2.0,59.0,1468
11752,96,4,100,1,0,60.0,2.0,60.0,1469
11753,80,20,100,1,1,60.0,2.0,60.0,1469
11754,71,29,100,2,2,60.0,2.0,60.0,1469
11755,-35,35,0,2,3,60.0,2.0,60.0,1469
11756,19,81,100,3,4,60.0,2.0,60.0,1469
11757,50,50,100,3,5,60.0,2.0,60.0,1469
11758,64,36,100,3,6,60.0,2.0,60.0,1469
11759,100,0,100,3,7,60.0,2.0,60.0,1469
11760,97,3,100,1,0,60.0,2.0,60.0,1470
11761,66,34,100,1,1,60.0,2.0,60.0,1470
11762,82,18,100,2,2,60.0,2.0,60.0,1470
11763,30,70,100,2,3,60.0,2.0,60.0,1470
11764,26,74,100,3,4,60.0,2.0,60.0,1470
11765,50,50,100,3,5,60.0,2.0,60.0,1470
11766,73,27,100,3,6,60.0,2.0,60.0,1470
11767,100,0,100,3,7,60.0,2.0,60.0,1470
11768,41,41,82,1,0,60.0,2.0,60.0,1471
11769,14,71,85,1,1,60.0,2.0,60.0,1471
11770,20,50,70,2,2,60.0,2.0,60.0,1471
11771,8,57,65,2,3,60.0,2.0,60.0,1471
11772,5,75,80,3,4,60.0,2.0,60.0,1471
11773,26,66,92,3,5,60.0,2.0,60.0,1471
11774,64,32,96,3,6,60.0,2.0,60.0,1471
11775,20,39,59,3,7,60.0,2.0,60.0,1471
11776,52,25,77,1,0,60.0,2.0,60.0,1472
11777,13,77,90,1,1,60.0,2.0,60.0,1472
11778,0,50,50,2,2,60.0,2.0,60.0,1472
11779,27,50,77,2,3,60.0,2.0,60.0,1472
11780,1,75,76,3,4,60.0,2.0,60.0,1472
11781,84,0,84,3,5,60.0,2.0,60.0,1472
11782,23,77,100,3,6,60.0,2.0,60.0,1472
11783,52,11,63,3,7,60.0,2.0,60.0,1472
11784,65,35,100,1,0,60.0,2.0,60.0,1473
11785,-2,2,0,1,1,60.0,2.0,60.0,1473
11786,-62,62,0,2,2,60.0,2.0,60.0,1473
11787,-39,39,0,2,3,60.0,2.0,60.0,1473
11788,-36,36,0,3,4,60.0,2.0,60.0,1473
11789,-40,40,0,3,5,60.0,2.0,60.0,1473
11790,-37,37,0,3,6,60.0,2.0,60.0,1473
11791,0,0,0,3,7,60.0,2.0,60.0,1473
11792,0,0,0,1,0,60.0,2.0,60.0,1474
11793,13,49,62,1,1,60.0,2.0,60.0,1474
11794,16,55,71,2,2,60.0,2.0,60.0,1474
11795,74,0,74,2,3,60.0,2.0,60.0,1474
11796,1,50,51,3,4,60.0,2.0,60.0,1474
11797,13,50,63,3,5,60.0,2.0,60.0,1474
11798,1,50,51,3,6,60.0,2.0,60.0,1474
11799,13,51,64,3,7,60.0,2.0,60.0,1474
11800,12,81,93,1,0,60.0,2.0,60.0,1475
11801,-2,85,83,1,1,60.0,2.0,60.0,1475
11802,-20,61,41,2,2,60.0,2.0,60.0,1475
11803,-33,99,66,2,3,60.0,2.0,60.0,1475
11804,-9,85,76,3,4,60.0,2.0,60.0,1475
11805,-7,48,41,3,5,60.0,2.0,60.0,1475
11806,0,100,100,3,6,60.0,2.0,60.0,1475
11807,22,14,36,3,7,60.0,2.0,60.0,1475
11808,23,77,100,1,0,60.0,2.0,60.0,1476
11809,0,100,100,1,1,60.0,2.0,60.0,1476
11810,52,37,89,2,2,60.0,2.0,60.0,1476
11811,74,25,99,2,3,60.0,2.0,60.0,1476
11812,20,74,94,3,4,60.0,2.0,60.0,1476
11813,38,49,87,3,5,60.0,2.0,60.0,1476
11814,65,26,91,3,6,60.0,2.0,60.0,1476
11815,69,16,85,3,7,60.0,2.0,60.0,1476
11816,49,19,68,1,0,60.0,2.0,60.0,1477
11817,63,23,86,1,1,60.0,2.0,60.0,1477
11818,25,38,63,2,2,60.0,2.0,60.0,1477
11819,54,31,85,2,3,60.0,2.0,60.0,1477
11820,20,12,32,3,4,60.0,2.0,60.0,1477
11821,33,34,67,3,5,60.0,2.0,60.0,1477
11822,40,60,100,3,6,60.0,2.0,60.0,1477
11823,86,0,86,3,7,60.0,2.0,60.0,1477
11824,41,0,41,1,0,60.0,2.0,60.0,1478
11825,15,21,36,1,1,60.0,2.0,60.0,1478
11826,25,50,75,2,2,60.0,2.0,60.0,1478
11827,-19,100,81,2,3,60.0,2.0,60.0,1478
11828,18,66,84,3,4,60.0,2.0,60.0,1478
11829,38,32,70,3,5,60.0,2.0,60.0,1478
11830,6,21,27,3,6,60.0,2.0,60.0,1478
11831,43,50,93,3,7,60.0,2.0,60.0,1478
11832,93,0,93,1,0,60.0,2.0,60.0,1479
11833,26,60,86,1,1,60.0,2.0,60.0,1479
11834,3,88,91,2,2,60.0,2.0,60.0,1479
11835,26,64,90,2,3,60.0,2.0,60.0,1479
11836,0,94,94,3,4,60.0,2.0,60.0,1479
11837,53,38,91,3,5,60.0,2.0,60.0,1479
11838,45,41,86,3,6,60.0,2.0,60.0,1479
11839,9,12,21,3,7,60.0,2.0,60.0,1479
11840,40,50,90,1,0,60.0,2.0,60.0,1480
11841,20,80,100,1,1,60.0,2.0,60.0,1480
11842,50,50,100,2,2,60.0,2.0,60.0,1480
11843,10,90,100,2,3,60.0,2.0,60.0,1480
11844,0,100,100,3,4,60.0,2.0,60.0,1480
11845,90,10,100,3,5,60.0,2.0,60.0,1480
11846,0,100,100,3,6,60.0,2.0,60.0,1480
11847,90,10,100,3,7,60.0,2.0,60.0,1480
11848,50,50,100,1,0,60.0,2.0,60.0,1481
11849,80,0,80,1,1,60.0,2.0,60.0,1481
11850,75,0,75,2,2,60.0,2.0,60.0,1481
11851,-100,100,0,2,3,60.0,2.0,60.0,1481
11852,70,30,100,3,4,60.0,2.0,60.0,1481
11853,15,85,100,3,5,60.0,2.0,60.0,1481
11854,50,50,100,3,6,60.0,2.0,60.0,1481
11855,70,0,70,3,7,60.0,2.0,60.0,1481
11856,-22,100,78,1,0,60.0,2.0,60.0,1482
11857,0,1,1,1,1,60.0,2.0,60.0,1482
11858,-26,26,0,2,2,60.0,2.0,60.0,1482
11859,-3,56,53,2,3,60.0,2.0,60.0,1482
11860,-13,72,59,3,4,60.0,2.0,60.0,1482
11861,-37,72,35,3,5,60.0,2.0,60.0,1482
11862,9,27,36,3,6,60.0,2.0,60.0,1482
11863,0,0,0,3,7,60.0,2.0,60.0,1482
11864,-14,64,50,1,0,60.0,2.0,60.0,1483
11865,6,25,31,1,1,60.0,2.0,60.0,1483
11866,0,50,50,2,2,60.0,2.0,60.0,1483
11867,-64,90,26,2,3,60.0,2.0,60.0,1483
11868,-3,72,69,3,4,60.0,2.0,60.0,1483
11869,14,50,64,3,5,60.0,2.0,60.0,1483
11870,0,50,50,3,6,60.0,2.0,60.0,1483
11871,17,8,25,3,7,60.0,2.0,60.0,1483
11872,-10,25,15,1,0,60.0,2.0,60.0,1484
11873,-8,85,77,1,1,60.0,2.0,60.0,1484
11874,-11,50,39,2,2,60.0,2.0,60.0,1484
11875,50,20,70,2,3,60.0,2.0,60.0,1484
11876,-6,80,74,3,4,60.0,2.0,60.0,1484
11877,73,0,73,3,5,60.0,2.0,60.0,1484
11878,-100,100,0,3,6,60.0,2.0,60.0,1484
11879,70,0,70,3,7,60.0,2.0,60.0,1484
11880,0,0,0,1,0,60.0,2.0,60.0,1485
11881,0,100,100,1,1,60.0,2.0,60.0,1485
11882,98,2,100,2,2,60.0,2.0,60.0,1485
11883,-100,100,0,2,3,60.0,2.0,60.0,1485
11884,0,100,100,3,4,60.0,2.0,60.0,1485
11885,37,63,100,3,5,60.0,2.0,60.0,1485
11886,100,0,100,3,6,60.0,2.0,60.0,1485
11887,100,0,100,3,7,60.0,2.0,60.0,1485
11888,27,10,37,1,0,60.0,2.0,60.0,1486
11889,40,25,65,1,1,60.0,2.0,60.0,1486
11890,26,24,50,2,2,60.0,2.0,60.0,1486
11891,-14,77,63,2,3,60.0,2.0,60.0,1486
11892,27,50,77,3,4,60.0,2.0,60.0,1486
11893,25,50,75,3,5,60.0,2.0,60.0,1486
11894,64,25,89,3,6,60.0,2.0,60.0,1486
11895,62,1,63,3,7,60.0,2.0,60.0,1486
11896,49,15,64,1,0,60.0,2.0,60.0,1487
11897,22,78,100,1,1,60.0,2.0,60.0,1487
11898,1,12,13,2,2,60.0,2.0,60.0,1487
11899,1,14,15,2,3,60.0,2.0,60.0,1487
11900,49,24,73,3,4,60.0,2.0,60.0,1487
11901,5,12,17,3,5,60.0,2.0,60.0,1487
11902,0,100,100,3,6,60.0,2.0,60.0,1487
11903,94,6,100,3,7,60.0,2.0,60.0,1487
11904,75,25,100,1,0,60.0,2.0,60.0,1488
11905,66,20,86,1,1,60.0,2.0,60.0,1488
11906,35,55,90,2,2,60.0,2.0,60.0,1488
11907,40,60,100,2,3,60.0,2.0,60.0,1488
11908,18,70,88,3,4,60.0,2.0,60.0,1488
11909,50,50,100,3,5,60.0,2.0,60.0,1488
11910,35,63,98,3,6,60.0,2.0,60.0,1488
11911,75,25,100,3,7,60.0,2.0,60.0,1488
11912,0,89,89,1,0,60.0,2.0,60.0,1489
11913,47,44,91,1,1,60.0,2.0,60.0,1489
11914,77,20,97,2,2,60.0,2.0,60.0,1489
11915,46,44,90,2,3,60.0,2.0,60.0,1489
11916,38,62,100,3,4,60.0,2.0,60.0,1489
11917,71,20,91,3,5,60.0,2.0,60.0,1489
11918,20,73,93,3,6,60.0,2.0,60.0,1489
11919,67,8,75,3,7,60.0,2.0,60.0,1489
11920,0,0,0,1,0,60.0,2.0,60.0,1490
11921,0,0,0,1,1,60.0,2.0,60.0,1490
11922,-13,63,50,2,2,60.0,2.0,60.0,1490
11923,8,86,94,2,3,60.0,2.0,60.0,1490
11924,-4,93,89,3,4,60.0,2.0,60.0,1490
11925,15,67,82,3,5,60.0,2.0,60.0,1490
11926,0,100,100,3,6,60.0,2.0,60.0,1490
11927,0,0,0,3,7,60.0,2.0,60.0,1490
11928,0,0,0,1,0,60.0,2.0,60.0,1491
11929,0,100,100,1,1,60.0,2.0,60.0,1491
11930,0,100,100,2,2,60.0,2.0,60.0,1491
11931,-100,100,0,2,3,60.0,2.0,60.0,1491
11932,0,0,0,3,4,60.0,2.0,60.0,1491
11933,47,23,70,3,5,60.0,2.0,60.0,1491
11934,-8,85,77,3,6,60.0,2.0,60.0,1491
11935,-4,4,0,3,7,60.0,2.0,60.0,1491
11936,26,24,50,1,0,60.0,2.0,60.0,1492
11937,-11,23,12,1,1,60.0,2.0,60.0,1492
11938,-13,76,63,2,2,60.0,2.0,60.0,1492
11939,0,100,100,2,3,60.0,2.0,60.0,1492
11940,14,42,56,3,4,60.0,2.0,60.0,1492
11941,40,24,64,3,5,60.0,2.0,60.0,1492
11942,14,76,90,3,6,60.0,2.0,60.0,1492
11943,52,11,63,3,7,60.0,2.0,60.0,1492
11944,-9,76,67,1,0,60.0,2.0,60.0,1493
11945,72,10,82,1,1,60.0,2.0,60.0,1493
11946,15,55,70,2,2,60.0,2.0,60.0,1493
11947,-6,55,49,2,3,60.0,2.0,60.0,1493
11948,8,40,48,3,4,60.0,2.0,60.0,1493
11949,20,40,60,3,5,60.0,2.0,60.0,1493
11950,47,30,77,3,6,60.0,2.0,60.0,1493
11951,40,44,84,3,7,60.0,2.0,60.0,1493
11952,11,14,25,1,0,60.0,2.0,60.0,1494
11953,36,27,63,1,1,60.0,2.0,60.0,1494
11954,-10,25,15,2,2,60.0,2.0,60.0,1494
11955,-1,80,79,2,3,60.0,2.0,60.0,1494
11956,10,75,85,3,4,60.0,2.0,60.0,1494
11957,-64,81,17,3,5,60.0,2.0,60.0,1494
11958,3,22,25,3,6,60.0,2.0,60.0,1494
11959,7,18,25,3,7,60.0,2.0,60.0,1494
11960,46,39,85,1,0,60.0,2.0,60.0,1495
11961,44,56,100,1,1,60.0,2.0,60.0,1495
11962,38,62,100,2,2,60.0,2.0,60.0,1495
11963,42,58,100,2,3,60.0,2.0,60.0,1495
11964,61,39,100,3,4,60.0,2.0,60.0,1495
11965,79,21,100,3,5,60.0,2.0,60.0,1495
11966,63,37,100,3,6,60.0,2.0,60.0,1495
11967,66,34,100,3,7,60.0,2.0,60.0,1495
11968,25,75,100,1,0,60.0,2.0,60.0,1496
11969,50,50,100,1,1,60.0,2.0,60.0,1496
11970,0,100,100,2,2,60.0,2.0,60.0,1496
11971,-100,100,0,2,3,60.0,2.0,60.0,1496
11972,30,70,100,3,4,60.0,2.0,60.0,1496
11973,50,50,100,3,5,60.0,2.0,60.0,1496
11974,25,75,100,3,6,60.0,2.0,60.0,1496
11975,50,50,100,3,7,60.0,2.0,60.0,1496
11976,45,7,52,1,0,60.0,2.0,60.0,1497
11977,16,79,95,1,1,60.0,2.0,60.0,1497
11978,21,77,98,2,2,60.0,2.0,60.0,1497
11979,62,31,93,2,3,60.0,2.0,60.0,1497
11980,58,26,84,3,4,60.0,2.0,60.0,1497
11981,77,17,94,3,5,60.0,2.0,60.0,1497
11982,70,19,89,3,6,60.0,2.0,60.0,1497
11983,42,49,91,3,7,60.0,2.0,60.0,1497
11984,0,40,40,1,0,60.0,2.0,60.0,1498
11985,0,40,40,1,1,60.0,2.0,60.0,1498
11986,-4,64,60,2,2,60.0,2.0,60.0,1498
11987,-1,40,39,2,3,60.0,2.0,60.0,1498
11988,0,40,40,3,4,60.0,2.0,60.0,1498
11989,0,40,40,3,5,60.0,2.0,60.0,1498
11990,2,38,40,3,6,60.0,2.0,60.0,1498
11991,4,36,40,3,7,60.0,2.0,60.0,1498
11992,0,0,0,1,0,60.0,2.0,60.0,1499
11993,100,0,100,1,1,60.0,2.0,60.0,1499
11994,23,77,100,2,2,60.0,2.0,60.0,1499
11995,0,100,100,2,3,60.0,2.0,60.0,1499
11996,22,78,100,3,4,60.0,2.0,60.0,1499
11997,26,50,76,3,5,60.0,2.0,60.0,1499
11998,0,50,50,3,6,60.0,2.0,60.0,1499
11999,0,0,0,3,7,60.0,2.0,60.0,1499
12000,-4,41,37,1,0,60.0,2.0,60.0,1500
12001,56,9,65,1,1,60.0,2.0,60.0,1500
12002,3,18,21,2,2,60.0,2.0,60.0,1500
12003,-3,37,34,2,3,60.0,2.0,60.0,1500
12004,15,60,75,3,4,60.0,2.0,60.0,1500
12005,-8,38,30,3,5,60.0,2.0,60.0,1500
12006,6,25,31,3,6,60.0,2.0,60.0,1500
12007,61,23,84,3,7,60.0,2.0,60.0,1500
12008,89,11,100,1,0,60.0,2.0,60.0,1501
12009,50,50,100,1,1,60.0,2.0,60.0,1501
12010,50,50,100,2,2,60.0,2.0,60.0,1501
12011,50,50,100,2,3,60.0,2.0,60.0,1501
12012,36,64,100,3,4,60.0,2.0,60.0,1501
12013,89,11,100,3,5,60.0,2.0,60.0,1501
12014,50,50,100,3,6,60.0,2.0,60.0,1501
12015,88,12,100,3,7,60.0,2.0,60.0,1501
12016,17,33,50,1,0,60.0,2.0,60.0,1502
12017,37,13,50,1,1,60.0,2.0,60.0,1502
12018,21,29,50,2,2,60.0,2.0,60.0,1502
12019,15,35,50,2,3,60.0,2.0,60.0,1502
12020,22,28,50,3,4,60.0,2.0,60.0,1502
12021,19,31,50,3,5,60.0,2.0,60.0,1502
12022,75,25,100,3,6,60.0,2.0,60.0,1502
12023,23,27,50,3,7,60.0,2.0,60.0,1502
12024,13,50,63,1,0,60.0,2.0,60.0,1503
12025,7,50,57,1,1,60.0,2.0,60.0,1503
12026,1,55,56,2,2,60.0,2.0,60.0,1503
12027,-9,30,21,2,3,60.0,2.0,60.0,1503
12028,0,50,50,3,4,60.0,2.0,60.0,1503
12029,-17,50,33,3,5,60.0,2.0,60.0,1503
12030,13,54,67,3,6,60.0,2.0,60.0,1503
12031,-12,32,20,3,7,60.0,2.0,60.0,1503
12032,0,0,0,1,0,60.0,2.0,60.0,1504
12033,0,0,0,1,1,60.0,2.0,60.0,1504
12034,-100,100,0,2,2,60.0,2.0,60.0,1504
12035,0,100,100,2,3,60.0,2.0,60.0,1504
12036,-78,78,0,3,4,60.0,2.0,60.0,1504
12037,0,0,0,3,5,60.0,2.0,60.0,1504
12038,100,0,100,3,6,60.0,2.0,60.0,1504
12039,-100,100,0,3,7,60.0,2.0,60.0,1504
12040,100,0,100,1,0,60.0,2.0,60.0,1505
12041,35,65,100,1,1,60.0,2.0,60.0,1505
12042,29,71,100,2,2,60.0,2.0,60.0,1505
12043,60,40,100,2,3,60.0,2.0,60.0,1505
12044,50,50,100,3,4,60.0,2.0,60.0,1505
12045,34,66,100,3,5,60.0,2.0,60.0,1505
12046,35,65,100,3,6,60.0,2.0,60.0,1505
12047,100,0,100,3,7,60.0,2.0,60.0,1505
12048,90,1,91,1,0,60.0,2.0,60.0,1506
12049,47,3,50,1,1,60.0,2.0,60.0,1506
12050,0,100,100,2,2,60.0,2.0,60.0,1506
12051,1,99,100,2,3,60.0,2.0,60.0,1506
12052,49,50,99,3,4,60.0,2.0,60.0,1506
12053,49,50,99,3,5,60.0,2.0,60.0,1506
12054,24,76,100,3,6,60.0,2.0,60.0,1506
12055,1,99,100,3,7,60.0,2.0,60.0,1506
12056,89,11,100,1,0,60.0,2.0,60.0,1507
12057,65,25,90,1,1,60.0,2.0,60.0,1507
12058,62,38,100,2,2,60.0,2.0,60.0,1507
12059,23,77,100,2,3,60.0,2.0,60.0,1507
12060,50,50,100,3,4,60.0,2.0,60.0,1507
12061,88,12,100,3,5,60.0,2.0,60.0,1507
12062,10,90,100,3,6,60.0,2.0,60.0,1507
12063,99,0,99,3,7,60.0,2.0,60.0,1507
12064,31,54,85,1,0,60.0,2.0,60.0,1508
12065,20,65,85,1,1,60.0,2.0,60.0,1508
12066,26,57,83,2,2,60.0,2.0,60.0,1508
12067,29,56,85,2,3,60.0,2.0,60.0,1508
12068,12,77,89,3,4,60.0,2.0,60.0,1508
12069,62,21,83,3,5,60.0,2.0,60.0,1508
12070,41,41,82,3,6,60.0,2.0,60.0,1508
12071,41,41,82,3,7,60.0,2.0,60.0,1508
12072,0,0,0,1,0,60.0,2.0,60.0,1509
12073,37,0,37,1,1,60.0,2.0,60.0,1509
12074,-1,82,81,2,2,60.0,2.0,60.0,1509
12075,0,100,100,2,3,60.0,2.0,60.0,1509
12076,0,75,75,3,4,60.0,2.0,60.0,1509
12077,0,0,0,3,5,60.0,2.0,60.0,1509
12078,100,0,100,3,6,60.0,2.0,60.0,1509
12079,0,0,0,3,7,60.0,2.0,60.0,1509
12080,-27,59,32,1,0,60.0,2.0,60.0,1510
12081,15,44,59,1,1,60.0,2.0,60.0,1510
12082,31,36,67,2,2,60.0,2.0,60.0,1510
12083,6,66,72,2,3,60.0,2.0,60.0,1510
12084,31,39,70,3,4,60.0,2.0,60.0,1510
12085,16,43,59,3,5,60.0,2.0,60.0,1510
12086,5,57,62,3,6,60.0,2.0,60.0,1510
12087,13,45,58,3,7,60.0,2.0,60.0,1510
12088,100,0,100,1,0,60.0,2.0,60.0,1511
12089,0,100,100,1,1,60.0,2.0,60.0,1511
12090,0,100,100,2,2,60.0,2.0,60.0,1511
12091,100,0,100,2,3,60.0,2.0,60.0,1511
12092,0,100,100,3,4,60.0,2.0,60.0,1511
12093,100,0,100,3,5,60.0,2.0,60.0,1511
12094,0,100,100,3,6,60.0,2.0,60.0,1511
12095,100,0,100,3,7,60.0,2.0,60.0,1511
12096,30,25,55,1,0,60.0,2.0,60.0,1512
12097,30,30,60,1,1,60.0,2.0,60.0,1512
12098,20,25,45,2,2,60.0,2.0,60.0,1512
12099,40,20,60,2,3,60.0,2.0,60.0,1512
12100,5,55,60,3,4,60.0,2.0,60.0,1512
12101,30,30,60,3,5,60.0,2.0,60.0,1512
12102,35,25,60,3,6,60.0,2.0,60.0,1512
12103,35,25,60,3,7,60.0,2.0,60.0,1512
12104,5,20,25,1,0,60.0,2.0,60.0,1513
12105,-15,25,10,1,1,60.0,2.0,60.0,1513
12106,0,75,75,2,2,60.0,2.0,60.0,1513
12107,60,40,100,2,3,60.0,2.0,60.0,1513
12108,35,25,60,3,4,60.0,2.0,60.0,1513
12109,10,90,100,3,5,60.0,2.0,60.0,1513
12110,15,10,25,3,6,60.0,2.0,60.0,1513
12111,0,0,0,3,7,60.0,2.0,60.0,1513
12112,-1,5,4,1,0,60.0,2.0,60.0,1514
12113,2,75,77,1,1,60.0,2.0,60.0,1514
12114,-6,94,88,2,2,60.0,2.0,60.0,1514
12115,0,46,46,2,3,60.0,2.0,60.0,1514
12116,-4,94,90,3,4,60.0,2.0,60.0,1514
12117,-10,50,40,3,5,60.0,2.0,60.0,1514
12118,0,50,50,3,6,60.0,2.0,60.0,1514
12119,18,22,40,3,7,60.0,2.0,60.0,1514
12120,0,100,100,1,0,61.0,2.0,61.0,1515
12121,0,100,100,1,1,61.0,2.0,61.0,1515
12122,16,80,96,2,2,61.0,2.0,61.0,1515
12123,0,100,100,2,3,61.0,2.0,61.0,1515
12124,-96,100,4,3,4,61.0,2.0,61.0,1515
12125,0,100,100,3,5,61.0,2.0,61.0,1515
12126,0,100,100,3,6,61.0,2.0,61.0,1515
12127,0,0,0,3,7,61.0,2.0,61.0,1515
12128,65,34,99,1,0,61.0,2.0,61.0,1516
12129,0,100,100,1,1,61.0,2.0,61.0,1516
12130,-13,26,13,2,2,61.0,2.0,61.0,1516
12131,17,77,94,2,3,61.0,2.0,61.0,1516
12132,23,77,100,3,4,61.0,2.0,61.0,1516
12133,60,29,89,3,5,61.0,2.0,61.0,1516
12134,74,26,100,3,6,61.0,2.0,61.0,1516
12135,62,17,79,3,7,61.0,2.0,61.0,1516
12136,100,0,100,1,0,61.0,2.0,61.0,1517
12137,100,0,100,1,1,61.0,2.0,61.0,1517
12138,-100,100,0,2,2,61.0,2.0,61.0,1517
12139,0,100,100,2,3,61.0,2.0,61.0,1517
12140,0,100,100,3,4,61.0,2.0,61.0,1517
12141,74,26,100,3,5,61.0,2.0,61.0,1517
12142,25,75,100,3,6,61.0,2.0,61.0,1517
12143,100,0,100,3,7,61.0,2.0,61.0,1517
12144,6,84,90,1,0,61.0,2.0,61.0,1518
12145,80,20,100,1,1,61.0,2.0,61.0,1518
12146,-69,69,0,2,2,61.0,2.0,61.0,1518
12147,15,78,93,2,3,61.0,2.0,61.0,1518
12148,34,66,100,3,4,61.0,2.0,61.0,1518
12149,35,63,98,3,5,61.0,2.0,61.0,1518
12150,33,67,100,3,6,61.0,2.0,61.0,1518
12151,60,40,100,3,7,61.0,2.0,61.0,1518
12152,50,20,70,1,0,61.0,2.0,61.0,1519
12153,19,72,91,1,1,61.0,2.0,61.0,1519
12154,18,64,82,2,2,61.0,2.0,61.0,1519
12155,55,24,79,2,3,61.0,2.0,61.0,1519
12156,12,70,82,3,4,61.0,2.0,61.0,1519
12157,35,37,72,3,5,61.0,2.0,61.0,1519
12158,31,40,71,3,6,61.0,2.0,61.0,1519
12159,60,30,90,3,7,61.0,2.0,61.0,1519
12160,81,0,81,1,0,61.0,2.0,61.0,1520
12161,44,21,65,1,1,61.0,2.0,61.0,1520
12162,17,50,67,2,2,61.0,2.0,61.0,1520
12163,80,0,80,2,3,61.0,2.0,61.0,1520
12164,16,60,76,3,4,61.0,2.0,61.0,1520
12165,11,49,60,3,5,61.0,2.0,61.0,1520
12166,37,50,87,3,6,61.0,2.0,61.0,1520
12167,39,25,64,3,7,61.0,2.0,61.0,1520
12168,72,23,95,1,0,61.0,2.0,61.0,1521
12169,7,81,88,1,1,61.0,2.0,61.0,1521
12170,-2,85,83,2,2,61.0,2.0,61.0,1521
12171,17,75,92,2,3,61.0,2.0,61.0,1521
12172,-12,100,88,3,4,61.0,2.0,61.0,1521
12173,58,21,79,3,5,61.0,2.0,61.0,1521
12174,-5,95,90,3,6,61.0,2.0,61.0,1521
12175,57,26,83,3,7,61.0,2.0,61.0,1521
12176,10,26,36,1,0,61.0,2.0,61.0,1522
12177,0,0,0,1,1,61.0,2.0,61.0,1522
12178,51,1,52,2,2,61.0,2.0,61.0,1522
12179,-2,43,41,2,3,61.0,2.0,61.0,1522
12180,-1,40,39,3,4,61.0,2.0,61.0,1522
12181,-1,51,50,3,5,61.0,2.0,61.0,1522
12182,0,50,50,3,6,61.0,2.0,61.0,1522
12183,0,0,0,3,7,61.0,2.0,61.0,1522
12184,16,84,100,1,0,61.0,2.0,61.0,1523
12185,56,44,100,1,1,61.0,2.0,61.0,1523
12186,50,50,100,2,2,61.0,2.0,61.0,1523
12187,42,58,100,2,3,61.0,2.0,61.0,1523
12188,41,59,100,3,4,61.0,2.0,61.0,1523
12189,50,50,100,3,5,61.0,2.0,61.0,1523
12190,-43,43,0,3,6,61.0,2.0,61.0,1523
12191,80,20,100,3,7,61.0,2.0,61.0,1523
12192,13,25,38,1,0,61.0,2.0,61.0,1524
12193,19,25,44,1,1,61.0,2.0,61.0,1524
12194,32,25,57,2,2,61.0,2.0,61.0,1524
12195,0,84,84,2,3,61.0,2.0,61.0,1524
12196,1,57,58,3,4,61.0,2.0,61.0,1524
12197,3,50,53,3,5,61.0,2.0,61.0,1524
12198,6,70,76,3,6,61.0,2.0,61.0,1524
12199,43,0,43,3,7,61.0,2.0,61.0,1524
12200,28,50,78,1,0,61.0,2.0,61.0,1525
12201,31,50,81,1,1,61.0,2.0,61.0,1525
12202,25,50,75,2,2,61.0,2.0,61.0,1525
12203,16,74,90,2,3,61.0,2.0,61.0,1525
12204,16,67,83,3,4,61.0,2.0,61.0,1525
12205,31,50,81,3,5,61.0,2.0,61.0,1525
12206,38,50,88,3,6,61.0,2.0,61.0,1525
12207,55,30,85,3,7,61.0,2.0,61.0,1525
12208,16,84,100,1,0,61.0,2.0,61.0,1526
12209,6,57,63,1,1,61.0,2.0,61.0,1526
12210,-6,50,44,2,2,61.0,2.0,61.0,1526
12211,38,62,100,2,3,61.0,2.0,61.0,1526
12212,44,56,100,3,4,61.0,2.0,61.0,1526
12213,51,49,100,3,5,61.0,2.0,61.0,1526
12214,1,38,39,3,6,61.0,2.0,61.0,1526
12215,-14,14,0,3,7,61.0,2.0,61.0,1526
12216,0,100,100,1,0,61.0,2.0,61.0,1527
12217,-14,100,86,1,1,61.0,2.0,61.0,1527
12218,13,87,100,2,2,61.0,2.0,61.0,1527
12219,9,91,100,2,3,61.0,2.0,61.0,1527
12220,61,39,100,3,4,61.0,2.0,61.0,1527
12221,-20,76,56,3,5,61.0,2.0,61.0,1527
12222,68,32,100,3,6,61.0,2.0,61.0,1527
12223,74,0,74,3,7,61.0,2.0,61.0,1527
12224,88,0,88,1,0,61.0,2.0,61.0,1528
12225,62,0,62,1,1,61.0,2.0,61.0,1528
12226,-1,100,99,2,2,61.0,2.0,61.0,1528
12227,0,100,100,2,3,61.0,2.0,61.0,1528
12228,41,56,97,3,4,61.0,2.0,61.0,1528
12229,38,50,88,3,5,61.0,2.0,61.0,1528
12230,90,0,90,3,6,61.0,2.0,61.0,1528
12231,100,0,100,3,7,61.0,2.0,61.0,1528
12232,-17,40,23,1,0,61.0,2.0,61.0,1529
12233,90,1,91,1,1,61.0,2.0,61.0,1529
12234,7,90,97,2,2,61.0,2.0,61.0,1529
12235,-100,100,0,2,3,61.0,2.0,61.0,1529
12236,2,98,100,3,4,61.0,2.0,61.0,1529
12237,67,31,98,3,5,61.0,2.0,61.0,1529
12238,98,2,100,3,6,61.0,2.0,61.0,1529
12239,-7,10,3,3,7,61.0,2.0,61.0,1529
12240,-46,64,18,1,0,61.0,2.0,61.0,1530
12241,22,57,79,1,1,61.0,2.0,61.0,1530
12242,34,50,84,2,2,61.0,2.0,61.0,1530
12243,37,49,86,2,3,61.0,2.0,61.0,1530
12244,-1,96,95,3,4,61.0,2.0,61.0,1530
12245,21,73,94,3,5,61.0,2.0,61.0,1530
12246,54,43,97,3,6,61.0,2.0,61.0,1530
12247,39,50,89,3,7,61.0,2.0,61.0,1530
12248,-19,81,62,1,0,61.0,2.0,61.0,1531
12249,15,50,65,1,1,61.0,2.0,61.0,1531
12250,-4,54,50,2,2,61.0,2.0,61.0,1531
12251,-22,72,50,2,3,61.0,2.0,61.0,1531
12252,-21,76,55,3,4,61.0,2.0,61.0,1531
12253,10,60,70,3,5,61.0,2.0,61.0,1531
12254,-6,75,69,3,6,61.0,2.0,61.0,1531
12255,-36,71,35,3,7,61.0,2.0,61.0,1531
12256,-60,100,40,1,0,61.0,2.0,61.0,1532
12257,-10,53,43,1,1,61.0,2.0,61.0,1532
12258,-7,58,51,2,2,61.0,2.0,61.0,1532
12259,-10,100,90,2,3,61.0,2.0,61.0,1532
12260,0,100,100,3,4,61.0,2.0,61.0,1532
12261,4,57,61,3,5,61.0,2.0,61.0,1532
12262,59,41,100,3,6,61.0,2.0,61.0,1532
12263,28,13,41,3,7,61.0,2.0,61.0,1532
12264,14,0,14,1,0,61.0,2.0,61.0,1533
12265,0,0,0,1,1,61.0,2.0,61.0,1533
12266,21,79,100,2,2,61.0,2.0,61.0,1533
12267,0,100,100,2,3,61.0,2.0,61.0,1533
12268,33,67,100,3,4,61.0,2.0,61.0,1533
12269,71,29,100,3,5,61.0,2.0,61.0,1533
12270,13,87,100,3,6,61.0,2.0,61.0,1533
12271,67,29,96,3,7,61.0,2.0,61.0,1533
12272,45,41,86,1,0,61.0,2.0,61.0,1534
12273,38,50,88,1,1,61.0,2.0,61.0,1534
12274,20,80,100,2,2,61.0,2.0,61.0,1534
12275,24,76,100,2,3,61.0,2.0,61.0,1534
12276,10,90,100,3,4,61.0,2.0,61.0,1534
12277,96,0,96,3,5,61.0,2.0,61.0,1534
12278,83,16,99,3,6,61.0,2.0,61.0,1534
12279,63,36,99,3,7,61.0,2.0,61.0,1534
12280,0,0,0,1,0,61.0,2.0,61.0,1535
12281,0,0,0,1,1,61.0,2.0,61.0,1535
12282,14,70,84,2,2,61.0,2.0,61.0,1535
12283,0,90,90,2,3,61.0,2.0,61.0,1535
12284,0,50,50,3,4,61.0,2.0,61.0,1535
12285,0,50,50,3,5,61.0,2.0,61.0,1535
12286,25,50,75,3,6,61.0,2.0,61.0,1535
12287,0,0,0,3,7,61.0,2.0,61.0,1535
12288,17,77,94,1,0,61.0,2.0,61.0,1536
12289,5,80,85,1,1,61.0,2.0,61.0,1536
12290,35,37,72,2,2,61.0,2.0,61.0,1536
12291,-24,100,76,2,3,61.0,2.0,61.0,1536
12292,-4,79,75,3,4,61.0,2.0,61.0,1536
12293,1,84,85,3,5,61.0,2.0,61.0,1536
12294,5,70,75,3,6,61.0,2.0,61.0,1536
12295,1,71,72,3,7,61.0,2.0,61.0,1536
12296,100,0,100,1,0,61.0,2.0,61.0,1537
12297,48,52,100,1,1,61.0,2.0,61.0,1537
12298,50,50,100,2,2,61.0,2.0,61.0,1537
12299,22,78,100,2,3,61.0,2.0,61.0,1537
12300,50,50,100,3,4,61.0,2.0,61.0,1537
12301,11,89,100,3,5,61.0,2.0,61.0,1537
12302,100,0,100,3,6,61.0,2.0,61.0,1537
12303,0,0,0,3,7,61.0,2.0,61.0,1537
12304,43,24,67,1,0,61.0,2.0,61.0,1538
12305,3,78,81,1,1,61.0,2.0,61.0,1538
12306,21,65,86,2,2,61.0,2.0,61.0,1538
12307,17,64,81,2,3,61.0,2.0,61.0,1538
12308,37,38,75,3,4,61.0,2.0,61.0,1538
12309,59,12,71,3,5,61.0,2.0,61.0,1538
12310,63,25,88,3,6,61.0,2.0,61.0,1538
12311,61,12,73,3,7,61.0,2.0,61.0,1538
12312,34,33,67,1,0,61.0,2.0,61.0,1539
12313,61,0,61,1,1,61.0,2.0,61.0,1539
12314,-20,100,80,2,2,61.0,2.0,61.0,1539
12315,0,84,84,2,3,61.0,2.0,61.0,1539
12316,-4,84,80,3,4,61.0,2.0,61.0,1539
12317,0,50,50,3,5,61.0,2.0,61.0,1539
12318,11,50,61,3,6,61.0,2.0,61.0,1539
12319,18,13,31,3,7,61.0,2.0,61.0,1539
12320,14,75,89,1,0,61.0,2.0,61.0,1540
12321,6,62,68,1,1,61.0,2.0,61.0,1540
12322,1,76,77,2,2,61.0,2.0,61.0,1540
12323,-8,88,80,2,3,61.0,2.0,61.0,1540
12324,-77,100,23,3,4,61.0,2.0,61.0,1540
12325,0,100,100,3,5,61.0,2.0,61.0,1540
12326,-60,86,26,3,6,61.0,2.0,61.0,1540
12327,70,30,100,3,7,61.0,2.0,61.0,1540
12328,-7,35,28,1,0,62.0,2.0,62.0,1541
12329,-6,66,60,1,1,62.0,2.0,62.0,1541
12330,-2,69,67,2,2,62.0,2.0,62.0,1541
12331,11,50,61,2,3,62.0,2.0,62.0,1541
12332,2,71,73,3,4,62.0,2.0,62.0,1541
12333,-5,59,54,3,5,62.0,2.0,62.0,1541
12334,-39,77,38,3,6,62.0,2.0,62.0,1541
12335,9,20,29,3,7,62.0,2.0,62.0,1541
12336,-7,38,31,1,0,62.0,2.0,62.0,1542
12337,0,39,39,1,1,62.0,2.0,62.0,1542
12338,-87,87,0,2,2,62.0,2.0,62.0,1542
12339,-6,75,69,2,3,62.0,2.0,62.0,1542
12340,31,69,100,3,4,62.0,2.0,62.0,1542
12341,-18,51,33,3,5,62.0,2.0,62.0,1542
12342,69,31,100,3,6,62.0,2.0,62.0,1542
12343,-26,43,17,3,7,62.0,2.0,62.0,1542
12344,35,65,100,1,0,62.0,2.0,62.0,1543
12345,33,67,100,1,1,62.0,2.0,62.0,1543
12346,0,66,66,2,2,62.0,2.0,62.0,1543
12347,33,67,100,2,3,62.0,2.0,62.0,1543
12348,37,63,100,3,4,62.0,2.0,62.0,1543
12349,37,63,100,3,5,62.0,2.0,62.0,1543
12350,41,59,100,3,6,62.0,2.0,62.0,1543
12351,33,67,100,3,7,62.0,2.0,62.0,1543
12352,0,50,50,1,0,62.0,2.0,62.0,1544
12353,17,33,50,1,1,62.0,2.0,62.0,1544
12354,29,49,78,2,2,62.0,2.0,62.0,1544
12355,16,64,80,2,3,62.0,2.0,62.0,1544
12356,11,65,76,3,4,62.0,2.0,62.0,1544
12357,19,51,70,3,5,62.0,2.0,62.0,1544
12358,25,50,75,3,6,62.0,2.0,62.0,1544
12359,25,38,63,3,7,62.0,2.0,62.0,1544
12360,0,0,0,1,0,62.0,2.0,62.0,1545
12361,17,58,75,1,1,62.0,2.0,62.0,1545
12362,32,48,80,2,2,62.0,2.0,62.0,1545
12363,0,0,0,2,3,62.0,2.0,62.0,1545
12364,-13,100,87,3,4,62.0,2.0,62.0,1545
12365,52,48,100,3,5,62.0,2.0,62.0,1545
12366,37,63,100,3,6,62.0,2.0,62.0,1545
12367,25,36,61,3,7,62.0,2.0,62.0,1545
12368,1,25,26,1,0,62.0,2.0,62.0,1546
12369,-49,75,26,1,1,62.0,2.0,62.0,1546
12370,-12,36,24,2,2,62.0,2.0,62.0,1546
12371,0,20,20,2,3,62.0,2.0,62.0,1546
12372,44,33,77,3,4,62.0,2.0,62.0,1546
12373,8,63,71,3,5,62.0,2.0,62.0,1546
12374,4,71,75,3,6,62.0,2.0,62.0,1546
12375,24,0,24,3,7,62.0,2.0,62.0,1546
12376,0,0,0,1,0,62.0,2.0,62.0,1547
12377,1,0,1,1,1,62.0,2.0,62.0,1547
12378,50,50,100,2,2,62.0,2.0,62.0,1547
12379,1,0,1,2,3,62.0,2.0,62.0,1547
12380,9,91,100,3,4,62.0,2.0,62.0,1547
12381,98,1,99,3,5,62.0,2.0,62.0,1547
12382,0,100,100,3,6,62.0,2.0,62.0,1547
12383,-2,2,0,3,7,62.0,2.0,62.0,1547
12384,-39,50,11,1,0,62.0,2.0,62.0,1548
12385,13,37,50,1,1,62.0,2.0,62.0,1548
12386,40,50,90,2,2,62.0,2.0,62.0,1548
12387,12,88,100,2,3,62.0,2.0,62.0,1548
12388,-14,64,50,3,4,62.0,2.0,62.0,1548
12389,0,50,50,3,5,62.0,2.0,62.0,1548
12390,76,24,100,3,6,62.0,2.0,62.0,1548
12391,50,50,100,3,7,62.0,2.0,62.0,1548
12392,38,50,88,1,0,62.0,2.0,62.0,1549
12393,25,75,100,1,1,62.0,2.0,62.0,1549
12394,53,22,75,2,2,62.0,2.0,62.0,1549
12395,-58,72,14,2,3,62.0,2.0,62.0,1549
12396,40,50,90,3,4,62.0,2.0,62.0,1549
12397,59,41,100,3,5,62.0,2.0,62.0,1549
12398,50,50,100,3,6,62.0,2.0,62.0,1549
12399,78,12,90,3,7,62.0,2.0,62.0,1549
12400,0,0,0,1,0,62.0,2.0,62.0,1550
12401,3,21,24,1,1,62.0,2.0,62.0,1550
12402,0,0,0,2,2,62.0,2.0,62.0,1550
12403,0,0,0,2,3,62.0,2.0,62.0,1550
12404,0,51,51,3,4,62.0,2.0,62.0,1550
12405,7,7,14,3,5,62.0,2.0,62.0,1550
12406,2,33,35,3,6,62.0,2.0,62.0,1550
12407,0,0,0,3,7,62.0,2.0,62.0,1550
12408,75,0,75,1,0,62.0,2.0,62.0,1551
12409,19,0,19,1,1,62.0,2.0,62.0,1551
12410,24,0,24,2,2,62.0,2.0,62.0,1551
12411,0,0,0,2,3,62.0,2.0,62.0,1551
12412,8,50,58,3,4,62.0,2.0,62.0,1551
12413,28,50,78,3,5,62.0,2.0,62.0,1551
12414,19,18,37,3,6,62.0,2.0,62.0,1551
12415,83,0,83,3,7,62.0,2.0,62.0,1551
12416,2,0,2,1,0,62.0,2.0,62.0,1552
12417,0,100,100,1,1,62.0,2.0,62.0,1552
12418,13,81,94,2,2,62.0,2.0,62.0,1552
12419,5,13,18,2,3,62.0,2.0,62.0,1552
12420,2,32,34,3,4,62.0,2.0,62.0,1552
12421,-37,39,2,3,5,62.0,2.0,62.0,1552
12422,1,26,27,3,6,62.0,2.0,62.0,1552
12423,19,17,36,3,7,62.0,2.0,62.0,1552
12424,73,15,88,1,0,62.0,2.0,62.0,1553
12425,-8,78,70,1,1,62.0,2.0,62.0,1553
12426,58,21,79,2,2,62.0,2.0,62.0,1553
12427,37,63,100,2,3,62.0,2.0,62.0,1553
12428,-13,94,81,3,4,62.0,2.0,62.0,1553
12429,-3,68,65,3,5,62.0,2.0,62.0,1553
12430,7,28,35,3,6,62.0,2.0,62.0,1553
12431,22,0,22,3,7,62.0,2.0,62.0,1553
12432,24,43,67,1,0,62.0,2.0,62.0,1554
12433,-4,74,70,1,1,62.0,2.0,62.0,1554
12434,-14,77,63,2,2,62.0,2.0,62.0,1554
12435,-33,96,63,2,3,62.0,2.0,62.0,1554
12436,2,86,88,3,4,62.0,2.0,62.0,1554
12437,-35,64,29,3,5,62.0,2.0,62.0,1554
12438,-56,76,20,3,6,62.0,2.0,62.0,1554
12439,9,19,28,3,7,62.0,2.0,62.0,1554
12440,9,31,40,1,0,62.0,2.0,62.0,1555
12441,21,10,31,1,1,62.0,2.0,62.0,1555
12442,8,92,100,2,2,62.0,2.0,62.0,1555
12443,0,100,100,2,3,62.0,2.0,62.0,1555
12444,16,76,92,3,4,62.0,2.0,62.0,1555
12445,-3,33,30,3,5,62.0,2.0,62.0,1555
12446,-11,24,13,3,6,62.0,2.0,62.0,1555
12447,52,12,64,3,7,62.0,2.0,62.0,1555
12448,27,35,62,1,0,62.0,2.0,62.0,1556
12449,14,41,55,1,1,62.0,2.0,62.0,1556
12450,16,60,76,2,2,62.0,2.0,62.0,1556
12451,-19,22,3,2,3,62.0,2.0,62.0,1556
12452,8,64,72,3,4,62.0,2.0,62.0,1556
12453,51,49,100,3,5,62.0,2.0,62.0,1556
12454,26,74,100,3,6,62.0,2.0,62.0,1556
12455,11,0,11,3,7,62.0,2.0,62.0,1556
12456,-2,33,31,1,0,62.0,2.0,62.0,1557
12457,11,42,53,1,1,62.0,2.0,62.0,1557
12458,-8,25,17,2,2,62.0,2.0,62.0,1557
12459,-15,29,14,2,3,62.0,2.0,62.0,1557
12460,5,62,67,3,4,62.0,2.0,62.0,1557
12461,-48,78,30,3,5,62.0,2.0,62.0,1557
12462,-5,31,26,3,6,62.0,2.0,62.0,1557
12463,10,8,18,3,7,62.0,2.0,62.0,1557
12464,35,33,68,1,0,62.0,2.0,62.0,1558
12465,1,63,64,1,1,62.0,2.0,62.0,1558
12466,33,32,65,2,2,62.0,2.0,62.0,1558
12467,-5,66,61,2,3,62.0,2.0,62.0,1558
12468,7,63,70,3,4,62.0,2.0,62.0,1558
12469,42,28,70,3,5,62.0,2.0,62.0,1558
12470,55,17,72,3,6,62.0,2.0,62.0,1558
12471,-48,70,22,3,7,62.0,2.0,62.0,1558
12472,50,50,100,1,0,62.0,2.0,62.0,1559
12473,10,90,100,1,1,62.0,2.0,62.0,1559
12474,88,12,100,2,2,62.0,2.0,62.0,1559
12475,100,0,100,2,3,62.0,2.0,62.0,1559
12476,50,50,100,3,4,62.0,2.0,62.0,1559
12477,-50,50,0,3,5,62.0,2.0,62.0,1559
12478,50,50,100,3,6,62.0,2.0,62.0,1559
12479,38,12,50,3,7,62.0,2.0,62.0,1559
12480,70,30,100,1,0,62.0,2.0,62.0,1560
12481,-95,95,0,1,1,62.0,2.0,62.0,1560
12482,100,0,100,2,2,62.0,2.0,62.0,1560
12483,25,75,100,2,3,62.0,2.0,62.0,1560
12484,19,81,100,3,4,62.0,2.0,62.0,1560
12485,0,0,0,3,5,62.0,2.0,62.0,1560
12486,-40,40,0,3,6,62.0,2.0,62.0,1560
12487,70,30,100,3,7,62.0,2.0,62.0,1560
12488,0,50,50,1,0,62.0,2.0,62.0,1561
12489,91,2,93,1,1,62.0,2.0,62.0,1561
12490,7,91,98,2,2,62.0,2.0,62.0,1561
12491,3,95,98,2,3,62.0,2.0,62.0,1561
12492,15,64,79,3,4,62.0,2.0,62.0,1561
12493,12,12,24,3,5,62.0,2.0,62.0,1561
12494,-13,25,12,3,6,62.0,2.0,62.0,1561
12495,10,11,21,3,7,62.0,2.0,62.0,1561
12496,-17,55,38,1,0,62.0,2.0,62.0,1562
12497,-5,70,65,1,1,62.0,2.0,62.0,1562
12498,63,18,81,2,2,62.0,2.0,62.0,1562
12499,4,57,61,2,3,62.0,2.0,62.0,1562
12500,0,100,100,3,4,62.0,2.0,62.0,1562
12501,-21,100,79,3,5,62.0,2.0,62.0,1562
12502,21,61,82,3,6,62.0,2.0,62.0,1562
12503,30,2,32,3,7,62.0,2.0,62.0,1562
12504,40,24,64,1,0,62.0,2.0,62.0,1563
12505,42,13,55,1,1,62.0,2.0,62.0,1563
12506,11,89,100,2,2,62.0,2.0,62.0,1563
12507,42,37,79,2,3,62.0,2.0,62.0,1563
12508,24,76,100,3,4,62.0,2.0,62.0,1563
12509,51,13,64,3,5,62.0,2.0,62.0,1563
12510,42,33,75,3,6,62.0,2.0,62.0,1563
12511,52,9,61,3,7,62.0,2.0,62.0,1563
12512,-40,64,24,1,0,62.0,2.0,62.0,1564
12513,-31,57,26,1,1,62.0,2.0,62.0,1564
12514,52,26,78,2,2,62.0,2.0,62.0,1564
12515,9,72,81,2,3,62.0,2.0,62.0,1564
12516,-23,50,27,3,4,62.0,2.0,62.0,1564
12517,-29,50,21,3,5,62.0,2.0,62.0,1564
12518,-8,14,6,3,6,62.0,2.0,62.0,1564
12519,53,26,79,3,7,62.0,2.0,62.0,1564
12520,73,0,73,1,0,63.0,2.0,63.0,1565
12521,-14,25,11,1,1,63.0,2.0,63.0,1565
12522,-72,94,22,2,2,63.0,2.0,63.0,1565
12523,-75,83,8,2,3,63.0,2.0,63.0,1565
12524,-4,88,84,3,4,63.0,2.0,63.0,1565
12525,15,12,27,3,5,63.0,2.0,63.0,1565
12526,43,34,77,3,6,63.0,2.0,63.0,1565
12527,-18,82,64,3,7,63.0,2.0,63.0,1565
12528,8,0,8,1,0,63.0,2.0,63.0,1566
12529,5,30,35,1,1,63.0,2.0,63.0,1566
12530,-22,67,45,2,2,63.0,2.0,63.0,1566
12531,16,12,28,2,3,63.0,2.0,63.0,1566
12532,4,30,34,3,4,63.0,2.0,63.0,1566
12533,-13,40,27,3,5,63.0,2.0,63.0,1566
12534,0,100,100,3,6,63.0,2.0,63.0,1566
12535,-32,32,0,3,7,63.0,2.0,63.0,1566
12536,15,18,33,1,0,63.0,2.0,63.0,1567
12537,11,23,34,1,1,63.0,2.0,63.0,1567
12538,20,41,61,2,2,63.0,2.0,63.0,1567
12539,-31,64,33,2,3,63.0,2.0,63.0,1567
12540,29,37,66,3,4,63.0,2.0,63.0,1567
12541,32,34,66,3,5,63.0,2.0,63.0,1567
12542,32,34,66,3,6,63.0,2.0,63.0,1567
12543,15,67,82,3,7,63.0,2.0,63.0,1567
12544,6,10,16,1,0,63.0,2.0,63.0,1568
12545,68,16,84,1,1,63.0,2.0,63.0,1568
12546,-15,97,82,2,2,63.0,2.0,63.0,1568
12547,16,71,87,2,3,63.0,2.0,63.0,1568
12548,2,93,95,3,4,63.0,2.0,63.0,1568
12549,77,10,87,3,5,63.0,2.0,63.0,1568
12550,33,53,86,3,6,63.0,2.0,63.0,1568
12551,53,30,83,3,7,63.0,2.0,63.0,1568
12552,58,21,79,1,0,63.0,2.0,63.0,1569
12553,-3,82,79,1,1,63.0,2.0,63.0,1569
12554,20,20,40,2,2,63.0,2.0,63.0,1569
12555,24,66,90,2,3,63.0,2.0,63.0,1569
12556,10,7,17,3,4,63.0,2.0,63.0,1569
12557,-8,97,89,3,5,63.0,2.0,63.0,1569
12558,90,10,100,3,6,63.0,2.0,63.0,1569
12559,0,100,100,3,7,63.0,2.0,63.0,1569
12560,3,4,7,1,0,63.0,2.0,63.0,1570
12561,-4,9,5,1,1,63.0,2.0,63.0,1570
12562,81,11,92,2,2,63.0,2.0,63.0,1570
12563,-76,85,9,2,3,63.0,2.0,63.0,1570
12564,5,87,92,3,4,63.0,2.0,63.0,1570
12565,7,10,17,3,5,63.0,2.0,63.0,1570
12566,13,77,90,3,6,63.0,2.0,63.0,1570
12567,-3,6,3,3,7,63.0,2.0,63.0,1570
12568,10,33,43,1,0,63.0,2.0,63.0,1571
12569,53,28,81,1,1,63.0,2.0,63.0,1571
12570,5,61,66,2,2,63.0,2.0,63.0,1571
12571,27,38,65,2,3,63.0,2.0,63.0,1571
12572,2,59,61,3,4,63.0,2.0,63.0,1571
12573,4,36,40,3,5,63.0,2.0,63.0,1571
12574,12,15,27,3,6,63.0,2.0,63.0,1571
12575,56,24,80,3,7,63.0,2.0,63.0,1571
12576,35,30,65,1,0,63.0,2.0,63.0,1572
12577,30,32,62,1,1,63.0,2.0,63.0,1572
12578,12,80,92,2,2,63.0,2.0,63.0,1572
12579,17,78,95,2,3,63.0,2.0,63.0,1572
12580,12,61,73,3,4,63.0,2.0,63.0,1572
12581,50,38,88,3,5,63.0,2.0,63.0,1572
12582,49,34,83,3,6,63.0,2.0,63.0,1572
12583,-3,36,33,3,7,63.0,2.0,63.0,1572
12584,58,42,100,1,0,63.0,2.0,63.0,1573
12585,57,43,100,1,1,63.0,2.0,63.0,1573
12586,76,24,100,2,2,63.0,2.0,63.0,1573
12587,38,62,100,2,3,63.0,2.0,63.0,1573
12588,63,37,100,3,4,63.0,2.0,63.0,1573
12589,62,38,100,3,5,63.0,2.0,63.0,1573
12590,61,39,100,3,6,63.0,2.0,63.0,1573
12591,61,39,100,3,7,63.0,2.0,63.0,1573
12592,100,0,100,1,0,63.0,2.0,63.0,1574
12593,83,17,100,1,1,63.0,2.0,63.0,1574
12594,37,63,100,2,2,63.0,2.0,63.0,1574
12595,88,12,100,2,3,63.0,2.0,63.0,1574
12596,36,64,100,3,4,63.0,2.0,63.0,1574
12597,100,0,100,3,5,63.0,2.0,63.0,1574
12598,22,78,100,3,6,63.0,2.0,63.0,1574
12599,-20,20,0,3,7,63.0,2.0,63.0,1574
12600,11,52,63,1,0,63.0,2.0,63.0,1575
12601,8,60,68,1,1,63.0,2.0,63.0,1575
12602,16,50,66,2,2,63.0,2.0,63.0,1575
12603,12,57,69,2,3,63.0,2.0,63.0,1575
12604,13,58,71,3,4,63.0,2.0,63.0,1575
12605,-22,97,75,3,5,63.0,2.0,63.0,1575
12606,38,22,60,3,6,63.0,2.0,63.0,1575
12607,8,59,67,3,7,63.0,2.0,63.0,1575
12608,57,17,74,1,0,63.0,2.0,63.0,1576
12609,17,81,98,1,1,63.0,2.0,63.0,1576
12610,89,11,100,2,2,63.0,2.0,63.0,1576
12611,12,88,100,2,3,63.0,2.0,63.0,1576
12612,1,99,100,3,4,63.0,2.0,63.0,1576
12613,100,0,100,3,5,63.0,2.0,63.0,1576
12614,0,100,100,3,6,63.0,2.0,63.0,1576
12615,88,12,100,3,7,63.0,2.0,63.0,1576
12616,70,9,79,1,0,63.0,2.0,63.0,1577
12617,-31,43,12,1,1,63.0,2.0,63.0,1577
12618,-6,90,84,2,2,63.0,2.0,63.0,1577
12619,36,59,95,2,3,63.0,2.0,63.0,1577
12620,50,35,85,3,4,63.0,2.0,63.0,1577
12621,62,22,84,3,5,63.0,2.0,63.0,1577
12622,44,50,94,3,6,63.0,2.0,63.0,1577
12623,74,8,82,3,7,63.0,2.0,63.0,1577
12624,-4,87,83,1,0,63.0,2.0,63.0,1578
12625,27,69,96,1,1,63.0,2.0,63.0,1578
12626,25,72,97,2,2,63.0,2.0,63.0,1578
12627,-3,100,97,2,3,63.0,2.0,63.0,1578
12628,89,9,98,3,4,63.0,2.0,63.0,1578
12629,65,32,97,3,5,63.0,2.0,63.0,1578
12630,19,81,100,3,6,63.0,2.0,63.0,1578
12631,20,74,94,3,7,63.0,2.0,63.0,1578
12632,-54,86,32,1,0,63.0,2.0,63.0,1579
12633,45,39,84,1,1,63.0,2.0,63.0,1579
12634,19,73,92,2,2,63.0,2.0,63.0,1579
12635,15,84,99,2,3,63.0,2.0,63.0,1579
12636,-15,50,35,3,4,63.0,2.0,63.0,1579
12637,4,70,74,3,5,63.0,2.0,63.0,1579
12638,-3,74,71,3,6,63.0,2.0,63.0,1579
12639,-5,37,32,3,7,63.0,2.0,63.0,1579
12640,49,38,87,1,0,64.0,2.0,64.0,1580
12641,18,70,88,1,1,64.0,2.0,64.0,1580
12642,22,7,29,2,2,64.0,2.0,64.0,1580
12643,1,21,22,2,3,64.0,2.0,64.0,1580
12644,-40,70,30,3,4,64.0,2.0,64.0,1580
12645,49,27,76,3,5,64.0,2.0,64.0,1580
12646,-21,92,71,3,6,64.0,2.0,64.0,1580
12647,-2,37,35,3,7,64.0,2.0,64.0,1580
12648,-8,24,16,1,0,64.0,2.0,64.0,1581
12649,2,84,86,1,1,64.0,2.0,64.0,1581
12650,40,24,64,2,2,64.0,2.0,64.0,1581
12651,-4,98,94,2,3,64.0,2.0,64.0,1581
12652,57,18,75,3,4,64.0,2.0,64.0,1581
12653,30,50,80,3,5,64.0,2.0,64.0,1581
12654,16,84,100,3,6,64.0,2.0,64.0,1581
12655,51,18,69,3,7,64.0,2.0,64.0,1581
12656,37,50,87,1,0,64.0,2.0,64.0,1582
12657,76,12,88,1,1,64.0,2.0,64.0,1582
12658,79,10,89,2,2,64.0,2.0,64.0,1582
12659,37,50,87,2,3,64.0,2.0,64.0,1582
12660,32,50,82,3,4,64.0,2.0,64.0,1582
12661,45,50,95,3,5,64.0,2.0,64.0,1582
12662,0,100,100,3,6,64.0,2.0,64.0,1582
12663,93,0,93,3,7,64.0,2.0,64.0,1582
12664,53,45,98,1,0,64.0,2.0,64.0,1583
12665,6,94,100,1,1,64.0,2.0,64.0,1583
12666,34,50,84,2,2,64.0,2.0,64.0,1583
12667,4,36,40,2,3,64.0,2.0,64.0,1583
12668,42,55,97,3,4,64.0,2.0,64.0,1583
12669,72,25,97,3,5,64.0,2.0,64.0,1583
12670,3,97,100,3,6,64.0,2.0,64.0,1583
12671,60,30,90,3,7,64.0,2.0,64.0,1583
12672,-15,53,38,1,0,64.0,2.0,64.0,1584
12673,18,2,20,1,1,64.0,2.0,64.0,1584
12674,1,58,59,2,2,64.0,2.0,64.0,1584
12675,29,16,45,2,3,64.0,2.0,64.0,1584
12676,15,29,44,3,4,64.0,2.0,64.0,1584
12677,29,38,67,3,5,64.0,2.0,64.0,1584
12678,-7,18,11,3,6,64.0,2.0,64.0,1584
12679,22,2,24,3,7,64.0,2.0,64.0,1584
12680,44,56,100,1,0,64.0,2.0,64.0,1585
12681,0,100,100,1,1,64.0,2.0,64.0,1585
12682,30,70,100,2,2,64.0,2.0,64.0,1585
12683,17,83,100,2,3,64.0,2.0,64.0,1585
12684,22,78,100,3,4,64.0,2.0,64.0,1585
12685,56,44,100,3,5,64.0,2.0,64.0,1585
12686,43,57,100,3,6,64.0,2.0,64.0,1585
12687,-51,63,12,3,7,64.0,2.0,64.0,1585
12688,14,36,50,1,0,64.0,2.0,64.0,1586
12689,1,37,38,1,1,64.0,2.0,64.0,1586
12690,14,36,50,2,2,64.0,2.0,64.0,1586
12691,0,50,50,2,3,64.0,2.0,64.0,1586
12692,-9,59,50,3,4,64.0,2.0,64.0,1586
12693,14,36,50,3,5,64.0,2.0,64.0,1586
12694,4,34,38,3,6,64.0,2.0,64.0,1586
12695,13,37,50,3,7,64.0,2.0,64.0,1586
12696,17,83,100,1,0,64.0,2.0,64.0,1587
12697,0,100,100,1,1,64.0,2.0,64.0,1587
12698,29,71,100,2,2,64.0,2.0,64.0,1587
12699,18,82,100,2,3,64.0,2.0,64.0,1587
12700,65,35,100,3,4,64.0,2.0,64.0,1587
12701,77,23,100,3,5,64.0,2.0,64.0,1587
12702,0,100,100,3,6,64.0,2.0,64.0,1587
12703,40,60,100,3,7,64.0,2.0,64.0,1587
12704,84,7,91,1,0,64.0,2.0,64.0,1588
12705,2,90,92,1,1,64.0,2.0,64.0,1588
12706,63,31,94,2,2,64.0,2.0,64.0,1588
12707,3,76,79,2,3,64.0,2.0,64.0,1588
12708,10,72,82,3,4,64.0,2.0,64.0,1588
12709,64,28,92,3,5,64.0,2.0,64.0,1588
12710,-12,88,76,3,6,64.0,2.0,64.0,1588
12711,53,28,81,3,7,64.0,2.0,64.0,1588
12712,65,35,100,1,0,64.0,2.0,64.0,1589
12713,43,57,100,1,1,64.0,2.0,64.0,1589
12714,77,23,100,2,2,64.0,2.0,64.0,1589
12715,63,37,100,2,3,64.0,2.0,64.0,1589
12716,36,64,100,3,4,64.0,2.0,64.0,1589
12717,37,63,100,3,5,64.0,2.0,64.0,1589
12718,50,50,100,3,6,64.0,2.0,64.0,1589
12719,50,50,100,3,7,64.0,2.0,64.0,1589
12720,46,27,73,1,0,64.0,2.0,64.0,1590
12721,28,50,78,1,1,64.0,2.0,64.0,1590
12722,30,50,80,2,2,64.0,2.0,64.0,1590
12723,4,76,80,2,3,64.0,2.0,64.0,1590
12724,27,65,92,3,4,64.0,2.0,64.0,1590
12725,49,39,88,3,5,64.0,2.0,64.0,1590
12726,12,64,76,3,6,64.0,2.0,64.0,1590
12727,52,27,79,3,7,64.0,2.0,64.0,1590
12728,22,19,41,1,0,64.0,2.0,64.0,1591
12729,-42,52,10,1,1,64.0,2.0,64.0,1591
12730,6,17,23,2,2,64.0,2.0,64.0,1591
12731,16,10,26,2,3,64.0,2.0,64.0,1591
12732,2,45,47,3,4,64.0,2.0,64.0,1591
12733,4,47,51,3,5,64.0,2.0,64.0,1591
12734,34,48,82,3,6,64.0,2.0,64.0,1591
12735,27,12,39,3,7,64.0,2.0,64.0,1591
12736,-77,88,11,1,0,64.0,2.0,64.0,1592
12737,-12,13,1,1,1,64.0,2.0,64.0,1592
12738,-12,18,6,2,2,64.0,2.0,64.0,1592
12739,1,0,1,2,3,64.0,2.0,64.0,1592
12740,16,74,90,3,4,64.0,2.0,64.0,1592
12741,-2,100,98,3,5,64.0,2.0,64.0,1592
12742,-80,100,20,3,6,64.0,2.0,64.0,1592
12743,-11,11,0,3,7,64.0,2.0,64.0,1592
12744,55,33,88,1,0,64.0,2.0,64.0,1593
12745,7,85,92,1,1,64.0,2.0,64.0,1593
12746,13,84,97,2,2,64.0,2.0,64.0,1593
12747,32,65,97,2,3,64.0,2.0,64.0,1593
12748,30,65,95,3,4,64.0,2.0,64.0,1593
12749,66,32,98,3,5,64.0,2.0,64.0,1593
12750,44,53,97,3,6,64.0,2.0,64.0,1593
12751,66,32,98,3,7,64.0,2.0,64.0,1593
12752,0,0,0,1,0,64.0,2.0,64.0,1594
12753,0,0,0,1,1,64.0,2.0,64.0,1594
12754,-5,97,92,2,2,64.0,2.0,64.0,1594
12755,-6,100,94,2,3,64.0,2.0,64.0,1594
12756,-16,91,75,3,4,64.0,2.0,64.0,1594
12757,13,59,72,3,5,64.0,2.0,64.0,1594
12758,11,20,31,3,6,64.0,2.0,64.0,1594
12759,-11,25,14,3,7,64.0,2.0,64.0,1594
12760,62,21,83,1,0,64.0,2.0,64.0,1595
12761,3,24,27,1,1,64.0,2.0,64.0,1595
12762,23,65,88,2,2,64.0,2.0,64.0,1595
12763,5,20,25,2,3,64.0,2.0,64.0,1595
12764,8,69,77,3,4,64.0,2.0,64.0,1595
12765,48,43,91,3,5,64.0,2.0,64.0,1595
12766,19,76,95,3,6,64.0,2.0,64.0,1595
12767,66,19,85,3,7,64.0,2.0,64.0,1595
12768,-21,100,79,1,0,64.0,2.0,64.0,1596
12769,0,100,100,1,1,64.0,2.0,64.0,1596
12770,3,77,80,2,2,64.0,2.0,64.0,1596
12771,-14,83,69,2,3,64.0,2.0,64.0,1596
12772,-80,80,0,3,4,64.0,2.0,64.0,1596
12773,32,68,100,3,5,64.0,2.0,64.0,1596
12774,24,76,100,3,6,64.0,2.0,64.0,1596
12775,10,90,100,3,7,64.0,2.0,64.0,1596
12776,-18,66,48,1,0,64.0,2.0,64.0,1597
12777,38,32,70,1,1,64.0,2.0,64.0,1597
12778,-57,83,26,2,2,64.0,2.0,64.0,1597
12779,18,65,83,2,3,64.0,2.0,64.0,1597
12780,20,54,74,3,4,64.0,2.0,64.0,1597
12781,14,78,92,3,5,64.0,2.0,64.0,1597
12782,41,46,87,3,6,64.0,2.0,64.0,1597
12783,52,27,79,3,7,64.0,2.0,64.0,1597
12784,20,18,38,1,0,64.0,2.0,64.0,1598
12785,-6,34,28,1,1,64.0,2.0,64.0,1598
12786,-7,71,64,2,2,64.0,2.0,64.0,1598
12787,0,100,100,2,3,64.0,2.0,64.0,1598
12788,38,33,71,3,4,64.0,2.0,64.0,1598
12789,23,37,60,3,5,64.0,2.0,64.0,1598
12790,23,77,100,3,6,64.0,2.0,64.0,1598
12791,8,75,83,3,7,64.0,2.0,64.0,1598
12792,51,1,52,1,0,65.0,2.0,65.0,1599
12793,-2,11,9,1,1,65.0,2.0,65.0,1599
12794,3,88,91,2,2,65.0,2.0,65.0,1599
12795,-6,98,92,2,3,65.0,2.0,65.0,1599
12796,27,59,86,3,4,65.0,2.0,65.0,1599
12797,40,50,90,3,5,65.0,2.0,65.0,1599
12798,76,24,100,3,6,65.0,2.0,65.0,1599
12799,75,9,84,3,7,65.0,2.0,65.0,1599
12800,16,84,100,1,0,65.0,2.0,65.0,1600
12801,7,22,29,1,1,65.0,2.0,65.0,1600
12802,4,61,65,2,2,65.0,2.0,65.0,1600
12803,3,0,3,2,3,65.0,2.0,65.0,1600
12804,2,17,19,3,4,65.0,2.0,65.0,1600
12805,-13,43,30,3,5,65.0,2.0,65.0,1600
12806,8,17,25,3,6,65.0,2.0,65.0,1600
12807,10,0,10,3,7,65.0,2.0,65.0,1600
12808,88,0,88,1,0,65.0,2.0,65.0,1601
12809,82,0,82,1,1,65.0,2.0,65.0,1601
12810,-8,96,88,2,2,65.0,2.0,65.0,1601
12811,0,100,100,2,3,65.0,2.0,65.0,1601
12812,16,84,100,3,4,65.0,2.0,65.0,1601
12813,50,50,100,3,5,65.0,2.0,65.0,1601
12814,90,10,100,3,6,65.0,2.0,65.0,1601
12815,0,0,0,3,7,65.0,2.0,65.0,1601
12816,0,100,100,1,0,65.0,2.0,65.0,1602
12817,0,100,100,1,1,65.0,2.0,65.0,1602
12818,26,50,76,2,2,65.0,2.0,65.0,1602
12819,50,0,50,2,3,65.0,2.0,65.0,1602
12820,11,9,20,3,4,65.0,2.0,65.0,1602
12821,2,50,52,3,5,65.0,2.0,65.0,1602
12822,7,59,66,3,6,65.0,2.0,65.0,1602
12823,-11,80,69,3,7,65.0,2.0,65.0,1602
12824,11,24,35,1,0,65.0,2.0,65.0,1603
12825,3,32,35,1,1,65.0,2.0,65.0,1603
12826,29,40,69,2,2,65.0,2.0,65.0,1603
12827,49,28,77,2,3,65.0,2.0,65.0,1603
12828,7,74,81,3,4,65.0,2.0,65.0,1603
12829,5,58,63,3,5,65.0,2.0,65.0,1603
12830,4,96,100,3,6,65.0,2.0,65.0,1603
12831,34,34,68,3,7,65.0,2.0,65.0,1603
12832,8,56,64,1,0,65.0,2.0,65.0,1604
12833,33,27,60,1,1,65.0,2.0,65.0,1604
12834,1,61,62,2,2,65.0,2.0,65.0,1604
12835,6,50,56,2,3,65.0,2.0,65.0,1604
12836,-23,74,51,3,4,65.0,2.0,65.0,1604
12837,-14,79,65,3,5,65.0,2.0,65.0,1604
12838,-2,58,56,3,6,65.0,2.0,65.0,1604
12839,-2,62,60,3,7,65.0,2.0,65.0,1604
12840,56,36,92,1,0,65.0,2.0,65.0,1605
12841,24,69,93,1,1,65.0,2.0,65.0,1605
12842,-2,72,70,2,2,65.0,2.0,65.0,1605
12843,-87,91,4,2,3,65.0,2.0,65.0,1605
12844,12,77,89,3,4,65.0,2.0,65.0,1605
12845,52,30,82,3,5,65.0,2.0,65.0,1605
12846,-3,27,24,3,6,65.0,2.0,65.0,1605
12847,-2,24,22,3,7,65.0,2.0,65.0,1605
12848,51,39,90,1,0,65.0,2.0,65.0,1606
12849,9,69,78,1,1,65.0,2.0,65.0,1606
12850,-1,74,73,2,2,65.0,2.0,65.0,1606
12851,10,30,40,2,3,65.0,2.0,65.0,1606
12852,64,28,92,3,4,65.0,2.0,65.0,1606
12853,-7,79,72,3,5,65.0,2.0,65.0,1606
12854,6,76,82,3,6,65.0,2.0,65.0,1606
12855,50,37,87,3,7,65.0,2.0,65.0,1606
12856,82,18,100,1,0,65.0,2.0,65.0,1607
12857,-50,50,0,1,1,65.0,2.0,65.0,1607
12858,4,96,100,2,2,65.0,2.0,65.0,1607
12859,50,50,100,2,3,65.0,2.0,65.0,1607
12860,52,48,100,3,4,65.0,2.0,65.0,1607
12861,50,50,100,3,5,65.0,2.0,65.0,1607
12862,47,53,100,3,6,65.0,2.0,65.0,1607
12863,44,56,100,3,7,65.0,2.0,65.0,1607
12864,89,0,89,1,0,65.0,2.0,65.0,1608
12865,10,10,20,1,1,65.0,2.0,65.0,1608
12866,10,90,100,2,2,65.0,2.0,65.0,1608
12867,0,100,100,2,3,65.0,2.0,65.0,1608
12868,25,75,100,3,4,65.0,2.0,65.0,1608
12869,39,50,89,3,5,65.0,2.0,65.0,1608
12870,10,90,100,3,6,65.0,2.0,65.0,1608
12871,89,10,99,3,7,65.0,2.0,65.0,1608
12872,0,70,70,1,0,65.0,2.0,65.0,1609
12873,2,74,76,1,1,65.0,2.0,65.0,1609
12874,-4,77,73,2,2,65.0,2.0,65.0,1609
12875,40,34,74,2,3,65.0,2.0,65.0,1609
12876,2,73,75,3,4,65.0,2.0,65.0,1609
12877,-1,73,72,3,5,65.0,2.0,65.0,1609
12878,5,2,7,3,6,65.0,2.0,65.0,1609
12879,38,30,68,3,7,65.0,2.0,65.0,1609
12880,11,56,67,1,0,65.0,2.0,65.0,1610
12881,0,100,100,1,1,65.0,2.0,65.0,1610
12882,19,0,19,2,2,65.0,2.0,65.0,1610
12883,21,79,100,2,3,65.0,2.0,65.0,1610
12884,38,54,92,3,4,65.0,2.0,65.0,1610
12885,39,38,77,3,5,65.0,2.0,65.0,1610
12886,32,68,100,3,6,65.0,2.0,65.0,1610
12887,-22,47,25,3,7,65.0,2.0,65.0,1610
12888,17,3,20,1,0,65.0,2.0,65.0,1611
12889,55,20,75,1,1,65.0,2.0,65.0,1611
12890,23,77,100,2,2,65.0,2.0,65.0,1611
12891,0,100,100,2,3,65.0,2.0,65.0,1611
12892,20,50,70,3,4,65.0,2.0,65.0,1611
12893,50,0,50,3,5,65.0,2.0,65.0,1611
12894,0,0,0,3,6,65.0,2.0,65.0,1611
12895,10,0,10,3,7,65.0,2.0,65.0,1611
12896,-9,71,62,1,0,65.0,2.0,65.0,1612
12897,-18,77,59,1,1,65.0,2.0,65.0,1612
12898,-19,81,62,2,2,65.0,2.0,65.0,1612
12899,8,65,73,2,3,65.0,2.0,65.0,1612
12900,-3,88,85,3,4,65.0,2.0,65.0,1612
12901,-7,79,72,3,5,65.0,2.0,65.0,1612
12902,-66,79,13,3,6,65.0,2.0,65.0,1612
12903,-49,86,37,3,7,65.0,2.0,65.0,1612
12904,13,67,80,1,0,65.0,2.0,65.0,1613
12905,-66,93,27,1,1,65.0,2.0,65.0,1613
12906,-38,72,34,2,2,65.0,2.0,65.0,1613
12907,14,73,87,2,3,65.0,2.0,65.0,1613
12908,4,71,75,3,4,65.0,2.0,65.0,1613
12909,-5,33,28,3,5,65.0,2.0,65.0,1613
12910,-31,65,34,3,6,65.0,2.0,65.0,1613
12911,-39,70,31,3,7,65.0,2.0,65.0,1613
12912,36,0,36,1,0,65.0,2.0,65.0,1614
12913,-14,50,36,1,1,65.0,2.0,65.0,1614
12914,0,100,100,2,2,65.0,2.0,65.0,1614
12915,51,25,76,2,3,65.0,2.0,65.0,1614
12916,1,75,76,3,4,65.0,2.0,65.0,1614
12917,63,0,63,3,5,65.0,2.0,65.0,1614
12918,38,25,63,3,6,65.0,2.0,65.0,1614
12919,52,25,77,3,7,65.0,2.0,65.0,1614
12920,50,50,100,1,0,65.0,2.0,65.0,1615
12921,85,15,100,1,1,65.0,2.0,65.0,1615
12922,30,70,100,2,2,65.0,2.0,65.0,1615
12923,0,100,100,2,3,65.0,2.0,65.0,1615
12924,40,60,100,3,4,65.0,2.0,65.0,1615
12925,50,50,100,3,5,65.0,2.0,65.0,1615
12926,10,90,100,3,6,65.0,2.0,65.0,1615
12927,100,0,100,3,7,65.0,2.0,65.0,1615
12928,65,20,85,1,0,65.0,2.0,65.0,1616
12929,-16,44,28,1,1,65.0,2.0,65.0,1616
12930,-35,54,19,2,2,65.0,2.0,65.0,1616
12931,0,100,100,2,3,65.0,2.0,65.0,1616
12932,22,45,67,3,4,65.0,2.0,65.0,1616
12933,3,50,53,3,5,65.0,2.0,65.0,1616
12934,-15,72,57,3,6,65.0,2.0,65.0,1616
12935,-7,44,37,3,7,65.0,2.0,65.0,1616
12936,11,77,88,1,0,65.0,2.0,65.0,1617
12937,9,68,77,1,1,65.0,2.0,65.0,1617
12938,71,12,83,2,2,65.0,2.0,65.0,1617
12939,0,50,50,2,3,65.0,2.0,65.0,1617
12940,52,39,91,3,4,65.0,2.0,65.0,1617
12941,44,40,84,3,5,65.0,2.0,65.0,1617
12942,51,39,90,3,6,65.0,2.0,65.0,1617
12943,39,50,89,3,7,65.0,2.0,65.0,1617
12944,50,0,50,1,0,65.0,2.0,65.0,1618
12945,40,60,100,1,1,65.0,2.0,65.0,1618
12946,55,45,100,2,2,65.0,2.0,65.0,1618
12947,23,77,100,2,3,65.0,2.0,65.0,1618
12948,24,76,100,3,4,65.0,2.0,65.0,1618
12949,50,50,100,3,5,65.0,2.0,65.0,1618
12950,60,40,100,3,6,65.0,2.0,65.0,1618
12951,100,0,100,3,7,65.0,2.0,65.0,1618
12952,16,29,45,1,0,65.0,2.0,65.0,1619
12953,0,50,50,1,1,65.0,2.0,65.0,1619
12954,0,38,38,2,2,65.0,2.0,65.0,1619
12955,4,81,85,2,3,65.0,2.0,65.0,1619
12956,1,76,77,3,4,65.0,2.0,65.0,1619
12957,-12,60,48,3,5,65.0,2.0,65.0,1619
12958,-2,43,41,3,6,65.0,2.0,65.0,1619
12959,16,34,50,3,7,65.0,2.0,65.0,1619
12960,-7,75,68,1,0,65.0,2.0,65.0,1620
12961,-41,76,35,1,1,65.0,2.0,65.0,1620
12962,-6,70,64,2,2,65.0,2.0,65.0,1620
12963,-35,100,65,2,3,65.0,2.0,65.0,1620
12964,-2,69,67,3,4,65.0,2.0,65.0,1620
12965,19,67,86,3,5,65.0,2.0,65.0,1620
12966,4,62,66,3,6,65.0,2.0,65.0,1620
12967,-33,97,64,3,7,65.0,2.0,65.0,1620
12968,1,30,31,1,0,66.0,2.0,66.0,1621
12969,5,26,31,1,1,66.0,2.0,66.0,1621
12970,9,26,35,2,2,66.0,2.0,66.0,1621
12971,-4,37,33,2,3,66.0,2.0,66.0,1621
12972,0,50,50,3,4,66.0,2.0,66.0,1621
12973,5,60,65,3,5,66.0,2.0,66.0,1621
12974,-6,66,60,3,6,66.0,2.0,66.0,1621
12975,4,26,30,3,7,66.0,2.0,66.0,1621
12976,11,89,100,1,0,66.0,2.0,66.0,1622
12977,88,12,100,1,1,66.0,2.0,66.0,1622
12978,-23,23,0,2,2,66.0,2.0,66.0,1622
12979,-18,24,6,2,3,66.0,2.0,66.0,1622
12980,17,83,100,3,4,66.0,2.0,66.0,1622
12981,79,21,100,3,5,66.0,2.0,66.0,1622
12982,93,7,100,3,6,66.0,2.0,66.0,1622
12983,100,0,100,3,7,66.0,2.0,66.0,1622
12984,-37,70,33,1,0,66.0,2.0,66.0,1623
12985,12,20,32,1,1,66.0,2.0,66.0,1623
12986,-5,71,66,2,2,66.0,2.0,66.0,1623
12987,13,62,75,2,3,66.0,2.0,66.0,1623
12988,17,73,90,3,4,66.0,2.0,66.0,1623
12989,-1,67,66,3,5,66.0,2.0,66.0,1623
12990,-23,100,77,3,6,66.0,2.0,66.0,1623
12991,-22,71,49,3,7,66.0,2.0,66.0,1623
12992,42,19,61,1,0,66.0,2.0,66.0,1624
12993,42,23,65,1,1,66.0,2.0,66.0,1624
12994,55,34,89,2,2,66.0,2.0,66.0,1624
12995,51,31,82,2,3,66.0,2.0,66.0,1624
12996,46,41,87,3,4,66.0,2.0,66.0,1624
12997,52,20,72,3,5,66.0,2.0,66.0,1624
12998,25,63,88,3,6,66.0,2.0,66.0,1624
12999,72,22,94,3,7,66.0,2.0,66.0,1624
13000,50,50,100,1,0,66.0,2.0,66.0,1625
13001,0,100,100,1,1,66.0,2.0,66.0,1625
13002,74,26,100,2,2,66.0,2.0,66.0,1625
13003,50,50,100,2,3,66.0,2.0,66.0,1625
13004,67,33,100,3,4,66.0,2.0,66.0,1625
13005,100,0,100,3,5,66.0,2.0,66.0,1625
13006,4,80,84,3,6,66.0,2.0,66.0,1625
13007,-61,61,0,3,7,66.0,2.0,66.0,1625
13008,-33,48,15,1,0,66.0,2.0,66.0,1626
13009,-62,94,32,1,1,66.0,2.0,66.0,1626
13010,57,20,77,2,2,66.0,2.0,66.0,1626
13011,60,17,77,2,3,66.0,2.0,66.0,1626
13012,9,0,9,3,4,66.0,2.0,66.0,1626
13013,4,62,66,3,5,66.0,2.0,66.0,1626
13014,0,0,0,3,6,66.0,2.0,66.0,1626
13015,-33,49,16,3,7,66.0,2.0,66.0,1626
13016,23,50,73,1,0,66.0,2.0,66.0,1627
13017,66,12,78,1,1,66.0,2.0,66.0,1627
13018,73,0,73,2,2,66.0,2.0,66.0,1627
13019,19,10,29,2,3,66.0,2.0,66.0,1627
13020,4,64,68,3,4,66.0,2.0,66.0,1627
13021,71,0,71,3,5,66.0,2.0,66.0,1627
13022,14,11,25,3,6,66.0,2.0,66.0,1627
13023,37,0,37,3,7,66.0,2.0,66.0,1627
13024,12,65,77,1,0,66.0,2.0,66.0,1628
13025,13,60,73,1,1,66.0,2.0,66.0,1628
13026,28,40,68,2,2,66.0,2.0,66.0,1628
13027,22,51,73,2,3,66.0,2.0,66.0,1628
13028,9,57,66,3,4,66.0,2.0,66.0,1628
13029,-21,58,37,3,5,66.0,2.0,66.0,1628
13030,-40,65,25,3,6,66.0,2.0,66.0,1628
13031,30,35,65,3,7,66.0,2.0,66.0,1628
13032,71,0,71,1,0,66.0,2.0,66.0,1629
13033,39,12,51,1,1,66.0,2.0,66.0,1629
13034,69,18,87,2,2,66.0,2.0,66.0,1629
13035,4,90,94,2,3,66.0,2.0,66.0,1629
13036,54,21,75,3,4,66.0,2.0,66.0,1629
13037,63,18,81,3,5,66.0,2.0,66.0,1629
13038,81,19,100,3,6,66.0,2.0,66.0,1629
13039,68,19,87,3,7,66.0,2.0,66.0,1629
13040,10,37,47,1,0,66.0,2.0,66.0,1630
13041,0,80,80,1,1,66.0,2.0,66.0,1630
13042,-7,49,42,2,2,66.0,2.0,66.0,1630
13043,0,68,68,2,3,66.0,2.0,66.0,1630
13044,8,68,76,3,4,66.0,2.0,66.0,1630
13045,-3,41,38,3,5,66.0,2.0,66.0,1630
13046,15,85,100,3,6,66.0,2.0,66.0,1630
13047,0,0,0,3,7,66.0,2.0,66.0,1630
13048,15,77,92,1,0,66.0,2.0,66.0,1631
13049,16,76,92,1,1,66.0,2.0,66.0,1631
13050,28,50,78,2,2,66.0,2.0,66.0,1631
13051,4,62,66,2,3,66.0,2.0,66.0,1631
13052,22,50,72,3,4,66.0,2.0,66.0,1631
13053,27,50,77,3,5,66.0,2.0,66.0,1631
13054,17,77,94,3,6,66.0,2.0,66.0,1631
13055,25,50,75,3,7,66.0,2.0,66.0,1631
13056,17,60,77,1,0,66.0,2.0,66.0,1632
13057,10,65,75,1,1,66.0,2.0,66.0,1632
13058,-27,90,63,2,2,66.0,2.0,66.0,1632
13059,-12,74,62,2,3,66.0,2.0,66.0,1632
13060,-6,72,66,3,4,66.0,2.0,66.0,1632
13061,-5,77,72,3,5,66.0,2.0,66.0,1632
13062,-14,67,53,3,6,66.0,2.0,66.0,1632
13063,16,71,87,3,7,66.0,2.0,66.0,1632
13064,0,0,0,1,0,66.0,2.0,66.0,1633
13065,8,20,28,1,1,66.0,2.0,66.0,1633
13066,-26,26,0,2,2,66.0,2.0,66.0,1633
13067,-15,28,13,2,3,66.0,2.0,66.0,1633
13068,-7,38,31,3,4,66.0,2.0,66.0,1633
13069,15,0,15,3,5,66.0,2.0,66.0,1633
13070,-37,59,22,3,6,66.0,2.0,66.0,1633
13071,0,0,0,3,7,66.0,2.0,66.0,1633
13072,-21,100,79,1,0,66.0,2.0,66.0,1634
13073,0,100,100,1,1,66.0,2.0,66.0,1634
13074,0,100,100,2,2,66.0,2.0,66.0,1634
13075,0,100,100,2,3,66.0,2.0,66.0,1634
13076,19,68,87,3,4,66.0,2.0,66.0,1634
13077,87,0,87,3,5,66.0,2.0,66.0,1634
13078,-7,84,77,3,6,66.0,2.0,66.0,1634
13079,0,0,0,3,7,66.0,2.0,66.0,1634
13080,4,16,20,1,0,66.0,2.0,66.0,1635
13081,22,3,25,1,1,66.0,2.0,66.0,1635
13082,-1,20,19,2,2,66.0,2.0,66.0,1635
13083,-4,13,9,2,3,66.0,2.0,66.0,1635
13084,-14,36,22,3,4,66.0,2.0,66.0,1635
13085,1,3,4,3,5,66.0,2.0,66.0,1635
13086,27,12,39,3,6,66.0,2.0,66.0,1635
13087,-2,7,5,3,7,66.0,2.0,66.0,1635
13088,9,25,34,1,0,66.0,2.0,66.0,1636
13089,5,79,84,1,1,66.0,2.0,66.0,1636
13090,9,64,73,2,2,66.0,2.0,66.0,1636
13091,63,37,100,2,3,66.0,2.0,66.0,1636
13092,43,52,95,3,4,66.0,2.0,66.0,1636
13093,41,53,94,3,5,66.0,2.0,66.0,1636
13094,12,79,91,3,6,66.0,2.0,66.0,1636
13095,23,5,28,3,7,66.0,2.0,66.0,1636
13096,39,28,67,1,0,66.0,2.0,66.0,1637
13097,-5,60,55,1,1,66.0,2.0,66.0,1637
13098,22,38,60,2,2,66.0,2.0,66.0,1637
13099,35,3,38,2,3,66.0,2.0,66.0,1637
13100,9,51,60,3,4,66.0,2.0,66.0,1637
13101,10,50,60,3,5,66.0,2.0,66.0,1637
13102,12,71,83,3,6,66.0,2.0,66.0,1637
13103,37,18,55,3,7,66.0,2.0,66.0,1637
13104,42,34,76,1,0,66.0,2.0,66.0,1638
13105,-63,83,20,1,1,66.0,2.0,66.0,1638
13106,0,100,100,2,2,66.0,2.0,66.0,1638
13107,0,100,100,2,3,66.0,2.0,66.0,1638
13108,7,82,89,3,4,66.0,2.0,66.0,1638
13109,-13,27,14,3,5,66.0,2.0,66.0,1638
13110,0,0,0,3,6,66.0,2.0,66.0,1638
13111,0,0,0,3,7,66.0,2.0,66.0,1638
13112,-3,80,77,1,0,66.0,2.0,66.0,1639
13113,18,78,96,1,1,66.0,2.0,66.0,1639
13114,15,73,88,2,2,66.0,2.0,66.0,1639
13115,17,73,90,2,3,66.0,2.0,66.0,1639
13116,1,91,92,3,4,66.0,2.0,66.0,1639
13117,65,26,91,3,5,66.0,2.0,66.0,1639
13118,68,23,91,3,6,66.0,2.0,66.0,1639
13119,5,88,93,3,7,66.0,2.0,66.0,1639
13120,-7,63,56,1,0,66.0,2.0,66.0,1640
13121,30,65,95,1,1,66.0,2.0,66.0,1640
13122,-3,61,58,2,2,66.0,2.0,66.0,1640
13123,33,36,69,2,3,66.0,2.0,66.0,1640
13124,-25,54,29,3,4,66.0,2.0,66.0,1640
13125,-7,73,66,3,5,66.0,2.0,66.0,1640
13126,-24,98,74,3,6,66.0,2.0,66.0,1640
13127,47,30,77,3,7,66.0,2.0,66.0,1640
13128,7,76,83,1,0,66.0,2.0,66.0,1641
13129,-1,84,83,1,1,66.0,2.0,66.0,1641
13130,-3,79,76,2,2,66.0,2.0,66.0,1641
13131,-8,75,67,2,3,66.0,2.0,66.0,1641
13132,-3,77,74,3,4,66.0,2.0,66.0,1641
13133,-6,80,74,3,5,66.0,2.0,66.0,1641
13134,8,76,84,3,6,66.0,2.0,66.0,1641
13135,9,76,85,3,7,66.0,2.0,66.0,1641
13136,52,16,68,1,0,66.0,2.0,66.0,1642
13137,-37,69,32,1,1,66.0,2.0,66.0,1642
13138,-6,41,35,2,2,66.0,2.0,66.0,1642
13139,32,52,84,2,3,66.0,2.0,66.0,1642
13140,13,48,61,3,4,66.0,2.0,66.0,1642
13141,6,67,73,3,5,66.0,2.0,66.0,1642
13142,58,30,88,3,6,66.0,2.0,66.0,1642
13143,59,9,68,3,7,66.0,2.0,66.0,1642
13144,-4,38,34,1,0,67.0,2.0,67.0,1643
13145,-30,64,34,1,1,67.0,2.0,67.0,1643
13146,-39,73,34,2,2,67.0,2.0,67.0,1643
13147,-3,34,31,2,3,67.0,2.0,67.0,1643
13148,11,70,81,3,4,67.0,2.0,67.0,1643
13149,-2,35,33,3,5,67.0,2.0,67.0,1643
13150,-31,61,30,3,6,67.0,2.0,67.0,1643
13151,-2,34,32,3,7,67.0,2.0,67.0,1643
13152,6,0,6,1,0,67.0,2.0,67.0,1644
13153,73,27,100,1,1,67.0,2.0,67.0,1644
13154,88,3,91,2,2,67.0,2.0,67.0,1644
13155,-28,92,64,2,3,67.0,2.0,67.0,1644
13156,-61,61,0,3,4,67.0,2.0,67.0,1644
13157,98,2,100,3,5,67.0,2.0,67.0,1644
13158,72,2,74,3,6,67.0,2.0,67.0,1644
13159,82,6,88,3,7,67.0,2.0,67.0,1644
13160,25,50,75,1,0,67.0,2.0,67.0,1645
13161,5,16,21,1,1,67.0,2.0,67.0,1645
13162,41,57,98,2,2,67.0,2.0,67.0,1645
13163,-21,100,79,2,3,67.0,2.0,67.0,1645
13164,7,84,91,3,4,67.0,2.0,67.0,1645
13165,6,74,80,3,5,67.0,2.0,67.0,1645
13166,87,13,100,3,6,67.0,2.0,67.0,1645
13167,96,0,96,3,7,67.0,2.0,67.0,1645
13168,0,0,0,1,0,67.0,2.0,67.0,1646
13169,-6,39,33,1,1,67.0,2.0,67.0,1646
13170,0,50,50,2,2,67.0,2.0,67.0,1646
13171,-10,10,0,2,3,67.0,2.0,67.0,1646
13172,4,60,64,3,4,67.0,2.0,67.0,1646
13173,0,50,50,3,5,67.0,2.0,67.0,1646
13174,-77,77,0,3,6,67.0,2.0,67.0,1646
13175,-4,4,0,3,7,67.0,2.0,67.0,1646
13176,62,0,62,1,0,67.0,2.0,67.0,1647
13177,-2,5,3,1,1,67.0,2.0,67.0,1647
13178,11,51,62,2,2,67.0,2.0,67.0,1647
13179,-15,100,85,2,3,67.0,2.0,67.0,1647
13180,2,53,55,3,4,67.0,2.0,67.0,1647
13181,-3,53,50,3,5,67.0,2.0,67.0,1647
13182,25,29,54,3,6,67.0,2.0,67.0,1647
13183,11,0,11,3,7,67.0,2.0,67.0,1647
13184,-4,79,75,1,0,67.0,2.0,67.0,1648
13185,-13,88,75,1,1,67.0,2.0,67.0,1648
13186,-1,89,88,2,2,67.0,2.0,67.0,1648
13187,14,68,82,2,3,67.0,2.0,67.0,1648
13188,-22,98,76,3,4,67.0,2.0,67.0,1648
13189,-5,91,86,3,5,67.0,2.0,67.0,1648
13190,-14,85,71,3,6,67.0,2.0,67.0,1648
13191,-6,89,83,3,7,67.0,2.0,67.0,1648
13192,80,20,100,1,0,67.0,2.0,67.0,1649
13193,50,50,100,1,1,67.0,2.0,67.0,1649
13194,27,73,100,2,2,67.0,2.0,67.0,1649
13195,74,26,100,2,3,67.0,2.0,67.0,1649
13196,90,10,100,3,4,67.0,2.0,67.0,1649
13197,92,8,100,3,5,67.0,2.0,67.0,1649
13198,95,5,100,3,6,67.0,2.0,67.0,1649
13199,3,47,50,3,7,67.0,2.0,67.0,1649
13200,26,12,38,1,0,67.0,2.0,67.0,1650
13201,14,36,50,1,1,67.0,2.0,67.0,1650
13202,2,98,100,2,2,67.0,2.0,67.0,1650
13203,10,87,97,2,3,67.0,2.0,67.0,1650
13204,22,36,58,3,4,67.0,2.0,67.0,1650
13205,23,54,77,3,5,67.0,2.0,67.0,1650
13206,29,50,79,3,6,67.0,2.0,67.0,1650
13207,4,60,64,3,7,67.0,2.0,67.0,1650
13208,76,24,100,1,0,67.0,2.0,67.0,1651
13209,42,50,92,1,1,67.0,2.0,67.0,1651
13210,62,38,100,2,2,67.0,2.0,67.0,1651
13211,35,65,100,2,3,67.0,2.0,67.0,1651
13212,38,62,100,3,4,67.0,2.0,67.0,1651
13213,50,50,100,3,5,67.0,2.0,67.0,1651
13214,16,25,41,3,6,67.0,2.0,67.0,1651
13215,-2,2,0,3,7,67.0,2.0,67.0,1651
13216,26,74,100,1,0,67.0,2.0,67.0,1652
13217,0,100,100,1,1,67.0,2.0,67.0,1652
13218,100,0,100,2,2,67.0,2.0,67.0,1652
13219,0,100,100,2,3,67.0,2.0,67.0,1652
13220,19,81,100,3,4,67.0,2.0,67.0,1652
13221,6,94,100,3,5,67.0,2.0,67.0,1652
13222,0,100,100,3,6,67.0,2.0,67.0,1652
13223,0,0,0,3,7,67.0,2.0,67.0,1652
13224,100,0,100,1,0,67.0,2.0,67.0,1653
13225,100,0,100,1,1,67.0,2.0,67.0,1653
13226,0,100,100,2,2,67.0,2.0,67.0,1653
13227,0,100,100,2,3,67.0,2.0,67.0,1653
13228,46,54,100,3,4,67.0,2.0,67.0,1653
13229,100,0,100,3,5,67.0,2.0,67.0,1653
13230,0,100,100,3,6,67.0,2.0,67.0,1653
13231,100,0,100,3,7,67.0,2.0,67.0,1653
13232,100,0,100,1,0,67.0,2.0,67.0,1654
13233,92,8,100,1,1,67.0,2.0,67.0,1654
13234,4,96,100,2,2,67.0,2.0,67.0,1654
13235,14,86,100,2,3,67.0,2.0,67.0,1654
13236,30,70,100,3,4,67.0,2.0,67.0,1654
13237,22,78,100,3,5,67.0,2.0,67.0,1654
13238,88,12,100,3,6,67.0,2.0,67.0,1654
13239,90,10,100,3,7,67.0,2.0,67.0,1654
13240,17,38,55,1,0,67.0,2.0,67.0,1655
13241,13,50,63,1,1,67.0,2.0,67.0,1655
13242,3,63,66,2,2,67.0,2.0,67.0,1655
13243,25,68,93,2,3,67.0,2.0,67.0,1655
13244,29,33,62,3,4,67.0,2.0,67.0,1655
13245,0,50,50,3,5,67.0,2.0,67.0,1655
13246,24,50,74,3,6,67.0,2.0,67.0,1655
13247,8,50,58,3,7,67.0,2.0,67.0,1655
13248,35,31,66,1,0,67.0,2.0,67.0,1656
13249,30,34,64,1,1,67.0,2.0,67.0,1656
13250,2,64,66,2,2,67.0,2.0,67.0,1656
13251,20,66,86,2,3,67.0,2.0,67.0,1656
13252,46,34,80,3,4,67.0,2.0,67.0,1656
13253,56,22,78,3,5,67.0,2.0,67.0,1656
13254,59,41,100,3,6,67.0,2.0,67.0,1656
13255,29,34,63,3,7,67.0,2.0,67.0,1656
13256,89,0,89,1,0,67.0,2.0,67.0,1657
13257,79,0,79,1,1,67.0,2.0,67.0,1657
13258,31,65,96,2,2,67.0,2.0,67.0,1657
13259,1,84,85,2,3,67.0,2.0,67.0,1657
13260,22,67,89,3,4,67.0,2.0,67.0,1657
13261,93,6,99,3,5,67.0,2.0,67.0,1657
13262,0,100,100,3,6,67.0,2.0,67.0,1657
13263,95,0,95,3,7,67.0,2.0,67.0,1657
13264,28,51,79,1,0,67.0,2.0,67.0,1658
13265,82,3,85,1,1,67.0,2.0,67.0,1658
13266,18,82,100,2,2,67.0,2.0,67.0,1658
13267,-3,3,0,2,3,67.0,2.0,67.0,1658
13268,38,57,95,3,4,67.0,2.0,67.0,1658
13269,25,52,77,3,5,67.0,2.0,67.0,1658
13270,-3,56,53,3,6,67.0,2.0,67.0,1658
13271,8,25,33,3,7,67.0,2.0,67.0,1658
13272,15,73,88,1,0,67.0,2.0,67.0,1659
13273,44,27,71,1,1,67.0,2.0,67.0,1659
13274,59,24,83,2,2,67.0,2.0,67.0,1659
13275,62,30,92,2,3,67.0,2.0,67.0,1659
13276,-10,27,17,3,4,67.0,2.0,67.0,1659
13277,69,24,93,3,5,67.0,2.0,67.0,1659
13278,14,70,84,3,6,67.0,2.0,67.0,1659
13279,17,72,89,3,7,67.0,2.0,67.0,1659
13280,-32,63,31,1,0,67.0,2.0,67.0,1660
13281,-31,69,38,1,1,67.0,2.0,67.0,1660
13282,-4,62,58,2,2,67.0,2.0,67.0,1660
13283,13,56,69,2,3,67.0,2.0,67.0,1660
13284,-6,65,59,3,4,67.0,2.0,67.0,1660
13285,-23,64,41,3,5,67.0,2.0,67.0,1660
13286,-4,71,67,3,6,67.0,2.0,67.0,1660
13287,1,73,74,3,7,67.0,2.0,67.0,1660
13288,9,14,23,1,0,68.0,2.0,68.0,1661
13289,-9,33,24,1,1,68.0,2.0,68.0,1661
13290,6,65,71,2,2,68.0,2.0,68.0,1661
13291,1,80,81,2,3,68.0,2.0,68.0,1661
13292,5,67,72,3,4,68.0,2.0,68.0,1661
13293,7,59,66,3,5,68.0,2.0,68.0,1661
13294,7,59,66,3,6,68.0,2.0,68.0,1661
13295,-4,40,36,3,7,68.0,2.0,68.0,1661
13296,32,36,68,1,0,68.0,2.0,68.0,1662
13297,22,67,89,1,1,68.0,2.0,68.0,1662
13298,-4,72,68,2,2,68.0,2.0,68.0,1662
13299,38,37,75,2,3,68.0,2.0,68.0,1662
13300,28,56,84,3,4,68.0,2.0,68.0,1662
13301,49,25,74,3,5,68.0,2.0,68.0,1662
13302,43,46,89,3,6,68.0,2.0,68.0,1662
13303,22,37,59,3,7,68.0,2.0,68.0,1662
13304,10,25,35,1,0,68.0,2.0,68.0,1663
13305,31,32,63,1,1,68.0,2.0,68.0,1663
13306,15,60,75,2,2,68.0,2.0,68.0,1663
13307,-20,59,39,2,3,68.0,2.0,68.0,1663
13308,25,55,80,3,4,68.0,2.0,68.0,1663
13309,20,56,76,3,5,68.0,2.0,68.0,1663
13310,19,45,64,3,6,68.0,2.0,68.0,1663
13311,-10,34,24,3,7,68.0,2.0,68.0,1663
13312,16,7,23,1,0,68.0,2.0,68.0,1664
13313,-1,16,15,1,1,68.0,2.0,68.0,1664
13314,-25,64,39,2,2,68.0,2.0,68.0,1664
13315,8,73,81,2,3,68.0,2.0,68.0,1664
13316,-25,37,12,3,4,68.0,2.0,68.0,1664
13317,-1,64,63,3,5,68.0,2.0,68.0,1664
13318,4,26,30,3,6,68.0,2.0,68.0,1664
13319,9,11,20,3,7,68.0,2.0,68.0,1664
13320,11,40,51,1,0,68.0,2.0,68.0,1665
13321,-10,50,40,1,1,68.0,2.0,68.0,1665
13322,0,50,50,2,2,68.0,2.0,68.0,1665
13323,0,50,50,2,3,68.0,2.0,68.0,1665
13324,11,67,78,3,4,68.0,2.0,68.0,1665
13325,28,29,57,3,5,68.0,2.0,68.0,1665
13326,18,32,50,3,6,68.0,2.0,68.0,1665
13327,31,21,52,3,7,68.0,2.0,68.0,1665
13328,80,20,100,1,0,68.0,2.0,68.0,1666
13329,18,82,100,1,1,68.0,2.0,68.0,1666
13330,73,27,100,2,2,68.0,2.0,68.0,1666
13331,44,56,100,2,3,68.0,2.0,68.0,1666
13332,33,67,100,3,4,68.0,2.0,68.0,1666
13333,60,40,100,3,5,68.0,2.0,68.0,1666
13334,66,34,100,3,6,68.0,2.0,68.0,1666
13335,73,27,100,3,7,68.0,2.0,68.0,1666
13336,75,21,96,1,0,68.0,2.0,68.0,1667
13337,88,12,100,1,1,68.0,2.0,68.0,1667
13338,-67,71,4,2,2,68.0,2.0,68.0,1667
13339,0,100,100,2,3,68.0,2.0,68.0,1667
13340,38,62,100,3,4,68.0,2.0,68.0,1667
13341,45,50,95,3,5,68.0,2.0,68.0,1667
13342,79,21,100,3,6,68.0,2.0,68.0,1667
13343,-21,21,0,3,7,68.0,2.0,68.0,1667
13344,51,40,91,1,0,68.0,2.0,68.0,1668
13345,20,67,87,1,1,68.0,2.0,68.0,1668
13346,13,76,89,2,2,68.0,2.0,68.0,1668
13347,-1,82,81,2,3,68.0,2.0,68.0,1668
13348,50,30,80,3,4,68.0,2.0,68.0,1668
13349,24,52,76,3,5,68.0,2.0,68.0,1668
13350,46,46,92,3,6,68.0,2.0,68.0,1668
13351,39,34,73,3,7,68.0,2.0,68.0,1668
13352,2,31,33,1,0,68.0,2.0,68.0,1669
13353,4,19,23,1,1,68.0,2.0,68.0,1669
13354,-19,96,77,2,2,68.0,2.0,68.0,1669
13355,3,0,3,2,3,68.0,2.0,68.0,1669
13356,7,22,29,3,4,68.0,2.0,68.0,1669
13357,-2,79,77,3,5,68.0,2.0,68.0,1669
13358,7,24,31,3,6,68.0,2.0,68.0,1669
13359,14,19,33,3,7,68.0,2.0,68.0,1669
13360,-10,85,75,1,0,68.0,2.0,68.0,1670
13361,15,60,75,1,1,68.0,2.0,68.0,1670
13362,-10,92,82,2,2,68.0,2.0,68.0,1670
13363,-3,85,82,2,3,68.0,2.0,68.0,1670
13364,2,77,79,3,4,68.0,2.0,68.0,1670
13365,0,75,75,3,5,68.0,2.0,68.0,1670
13366,-5,80,75,3,6,68.0,2.0,68.0,1670
13367,1,77,78,3,7,68.0,2.0,68.0,1670
13368,19,10,29,1,0,68.0,2.0,68.0,1671
13369,2,60,62,1,1,68.0,2.0,68.0,1671
13370,7,60,67,2,2,68.0,2.0,68.0,1671
13371,31,41,72,2,3,68.0,2.0,68.0,1671
13372,9,32,41,3,4,68.0,2.0,68.0,1671
13373,19,41,60,3,5,68.0,2.0,68.0,1671
13374,33,36,69,3,6,68.0,2.0,68.0,1671
13375,11,10,21,3,7,68.0,2.0,68.0,1671
13376,43,27,70,1,0,69.0,2.0,69.0,1672
13377,53,33,86,1,1,69.0,2.0,69.0,1672
13378,54,35,89,2,2,69.0,2.0,69.0,1672
13379,18,11,29,2,3,69.0,2.0,69.0,1672
13380,49,38,87,3,4,69.0,2.0,69.0,1672
13381,47,34,81,3,5,69.0,2.0,69.0,1672
13382,61,39,100,3,6,69.0,2.0,69.0,1672
13383,52,38,90,3,7,69.0,2.0,69.0,1672
13384,40,30,70,1,0,69.0,2.0,69.0,1673
13385,58,11,69,1,1,69.0,2.0,69.0,1673
13386,49,20,69,2,2,69.0,2.0,69.0,1673
13387,-2,72,70,2,3,69.0,2.0,69.0,1673
13388,16,65,81,3,4,69.0,2.0,69.0,1673
13389,41,29,70,3,5,69.0,2.0,69.0,1673
13390,-2,67,65,3,6,69.0,2.0,69.0,1673
13391,-38,72,34,3,7,69.0,2.0,69.0,1673
13392,100,0,100,1,0,69.0,2.0,69.0,1674
13393,60,40,100,1,1,69.0,2.0,69.0,1674
13394,100,0,100,2,2,69.0,2.0,69.0,1674
13395,100,0,100,2,3,69.0,2.0,69.0,1674
13396,17,83,100,3,4,69.0,2.0,69.0,1674
13397,100,0,100,3,5,69.0,2.0,69.0,1674
13398,69,31,100,3,6,69.0,2.0,69.0,1674
13399,100,0,100,3,7,69.0,2.0,69.0,1674
13400,64,36,100,1,0,69.0,2.0,69.0,1675
13401,87,13,100,1,1,69.0,2.0,69.0,1675
13402,47,53,100,2,2,69.0,2.0,69.0,1675
13403,28,72,100,2,3,69.0,2.0,69.0,1675
13404,38,62,100,3,4,69.0,2.0,69.0,1675
13405,38,62,100,3,5,69.0,2.0,69.0,1675
13406,63,37,100,3,6,69.0,2.0,69.0,1675
13407,74,26,100,3,7,69.0,2.0,69.0,1675
13408,0,0,0,1,0,69.0,2.0,69.0,1676
13409,0,0,0,1,1,69.0,2.0,69.0,1676
13410,31,69,100,2,2,69.0,2.0,69.0,1676
13411,0,100,100,2,3,69.0,2.0,69.0,1676
13412,0,69,69,3,4,69.0,2.0,69.0,1676
13413,0,69,69,3,5,69.0,2.0,69.0,1676
13414,0,69,69,3,6,69.0,2.0,69.0,1676
13415,0,69,69,3,7,69.0,2.0,69.0,1676
13416,7,29,36,1,0,69.0,2.0,69.0,1677
13417,6,33,39,1,1,69.0,2.0,69.0,1677
13418,9,57,66,2,2,69.0,2.0,69.0,1677
13419,-4,76,72,2,3,69.0,2.0,69.0,1677
13420,4,58,62,3,4,69.0,2.0,69.0,1677
13421,9,34,43,3,5,69.0,2.0,69.0,1677
13422,11,59,70,3,6,69.0,2.0,69.0,1677
13423,-16,33,17,3,7,69.0,2.0,69.0,1677
13424,100,0,100,1,0,69.0,2.0,69.0,1678
13425,100,0,100,1,1,69.0,2.0,69.0,1678
13426,50,50,100,2,2,69.0,2.0,69.0,1678
13427,50,50,100,2,3,69.0,2.0,69.0,1678
13428,50,50,100,3,4,69.0,2.0,69.0,1678
13429,50,50,100,3,5,69.0,2.0,69.0,1678
13430,0,100,100,3,6,69.0,2.0,69.0,1678
13431,50,50,100,3,7,69.0,2.0,69.0,1678
13432,35,65,100,1,0,69.0,2.0,69.0,1679
13433,66,34,100,1,1,69.0,2.0,69.0,1679
13434,100,0,100,2,2,69.0,2.0,69.0,1679
13435,100,0,100,2,3,69.0,2.0,69.0,1679
13436,63,37,100,3,4,69.0,2.0,69.0,1679
13437,62,38,100,3,5,69.0,2.0,69.0,1679
13438,100,0,100,3,6,69.0,2.0,69.0,1679
13439,76,24,100,3,7,69.0,2.0,69.0,1679
13440,59,0,59,1,0,69.0,2.0,69.0,1680
13441,59,9,68,1,1,69.0,2.0,69.0,1680
13442,71,3,74,2,2,69.0,2.0,69.0,1680
13443,-3,39,36,2,3,69.0,2.0,69.0,1680
13444,29,19,48,3,4,69.0,2.0,69.0,1680
13445,42,50,92,3,5,69.0,2.0,69.0,1680
13446,45,48,93,3,6,69.0,2.0,69.0,1680
13447,46,4,50,3,7,69.0,2.0,69.0,1680
13448,0,0,0,1,0,69.0,2.0,69.0,1681
13449,0,0,0,1,1,69.0,2.0,69.0,1681
13450,0,50,50,2,2,69.0,2.0,69.0,1681
13451,-100,100,0,2,3,69.0,2.0,69.0,1681
13452,30,25,55,3,4,69.0,2.0,69.0,1681
13453,-9,59,50,3,5,69.0,2.0,69.0,1681
13454,0,100,100,3,6,69.0,2.0,69.0,1681
13455,50,0,50,3,7,69.0,2.0,69.0,1681
13456,0,0,0,1,0,69.0,2.0,69.0,1682
13457,-20,20,0,1,1,69.0,2.0,69.0,1682
13458,-4,65,61,2,2,69.0,2.0,69.0,1682
13459,7,56,63,2,3,69.0,2.0,69.0,1682
13460,-6,91,85,3,4,69.0,2.0,69.0,1682
13461,-6,41,35,3,5,69.0,2.0,69.0,1682
13462,2,36,38,3,6,69.0,2.0,69.0,1682
13463,-12,64,52,3,7,69.0,2.0,69.0,1682
13464,6,63,69,1,0,69.0,2.0,69.0,1683
13465,6,63,69,1,1,69.0,2.0,69.0,1683
13466,2,65,67,2,2,69.0,2.0,69.0,1683
13467,-34,72,38,2,3,69.0,2.0,69.0,1683
13468,6,30,36,3,4,69.0,2.0,69.0,1683
13469,-31,66,35,3,5,69.0,2.0,69.0,1683
13470,-2,39,37,3,6,69.0,2.0,69.0,1683
13471,9,65,74,3,7,69.0,2.0,69.0,1683
13472,57,20,77,1,0,69.0,2.0,69.0,1684
13473,-7,82,75,1,1,69.0,2.0,69.0,1684
13474,7,74,81,2,2,69.0,2.0,69.0,1684
13475,13,73,86,2,3,69.0,2.0,69.0,1684
13476,-1,76,75,3,4,69.0,2.0,69.0,1684
13477,44,35,79,3,5,69.0,2.0,69.0,1684
13478,40,40,80,3,6,69.0,2.0,69.0,1684
13479,36,40,76,3,7,69.0,2.0,69.0,1684
13480,0,50,50,1,0,69.0,2.0,69.0,1685
13481,80,8,88,1,1,69.0,2.0,69.0,1685
13482,41,9,50,2,2,69.0,2.0,69.0,1685
13483,-6,6,0,2,3,69.0,2.0,69.0,1685
13484,8,81,89,3,4,69.0,2.0,69.0,1685
13485,10,40,50,3,5,69.0,2.0,69.0,1685
13486,7,43,50,3,6,69.0,2.0,69.0,1685
13487,39,11,50,3,7,69.0,2.0,69.0,1685
13488,65,11,76,1,0,69.0,2.0,69.0,1686
13489,2,77,79,1,1,69.0,2.0,69.0,1686
13490,-10,91,81,2,2,69.0,2.0,69.0,1686
13491,32,50,82,2,3,69.0,2.0,69.0,1686
13492,79,21,100,3,4,69.0,2.0,69.0,1686
13493,90,0,90,3,5,69.0,2.0,69.0,1686
13494,18,0,18,3,6,69.0,2.0,69.0,1686
13495,9,5,14,3,7,69.0,2.0,69.0,1686
13496,30,43,73,1,0,69.0,2.0,69.0,1687
13497,-51,56,5,1,1,69.0,2.0,69.0,1687
13498,16,61,77,2,2,69.0,2.0,69.0,1687
13499,-17,79,62,2,3,69.0,2.0,69.0,1687
13500,9,62,71,3,4,69.0,2.0,69.0,1687
13501,12,50,62,3,5,69.0,2.0,69.0,1687
13502,-12,19,7,3,6,69.0,2.0,69.0,1687
13503,5,62,67,3,7,69.0,2.0,69.0,1687
13504,21,53,74,1,0,69.0,2.0,69.0,1688
13505,4,68,72,1,1,69.0,2.0,69.0,1688
13506,-7,75,68,2,2,69.0,2.0,69.0,1688
13507,-19,74,55,2,3,69.0,2.0,69.0,1688
13508,-1,68,67,3,4,69.0,2.0,69.0,1688
13509,0,62,62,3,5,69.0,2.0,69.0,1688
13510,-17,81,64,3,6,69.0,2.0,69.0,1688
13511,13,66,79,3,7,69.0,2.0,69.0,1688
13512,-2,57,55,1,0,69.0,2.0,69.0,1689
13513,6,55,61,1,1,69.0,2.0,69.0,1689
13514,1,58,59,2,2,69.0,2.0,69.0,1689
13515,-7,8,1,2,3,69.0,2.0,69.0,1689
13516,9,47,56,3,4,69.0,2.0,69.0,1689
13517,0,65,65,3,5,69.0,2.0,69.0,1689
13518,55,13,68,3,6,69.0,2.0,69.0,1689
13519,6,53,59,3,7,69.0,2.0,69.0,1689
13520,34,34,68,1,0,70.0,2.0,70.0,1690
13521,64,12,76,1,1,70.0,2.0,70.0,1690
13522,39,11,50,2,2,70.0,2.0,70.0,1690
13523,6,72,78,2,3,70.0,2.0,70.0,1690
13524,8,76,84,3,4,70.0,2.0,70.0,1690
13525,78,0,78,3,5,70.0,2.0,70.0,1690
13526,62,25,87,3,6,70.0,2.0,70.0,1690
13527,69,4,73,3,7,70.0,2.0,70.0,1690
13528,23,62,85,1,0,70.0,2.0,70.0,1691
13529,29,56,85,1,1,70.0,2.0,70.0,1691
13530,50,50,100,2,2,70.0,2.0,70.0,1691
13531,19,67,86,2,3,70.0,2.0,70.0,1691
13532,69,31,100,3,4,70.0,2.0,70.0,1691
13533,63,33,96,3,5,70.0,2.0,70.0,1691
13534,33,67,100,3,6,70.0,2.0,70.0,1691
13535,68,32,100,3,7,70.0,2.0,70.0,1691
13536,100,0,100,1,0,70.0,2.0,70.0,1692
13537,100,0,100,1,1,70.0,2.0,70.0,1692
13538,50,50,100,2,2,70.0,2.0,70.0,1692
13539,100,0,100,2,3,70.0,2.0,70.0,1692
13540,50,50,100,3,4,70.0,2.0,70.0,1692
13541,50,50,100,3,5,70.0,2.0,70.0,1692
13542,22,78,100,3,6,70.0,2.0,70.0,1692
13543,100,0,100,3,7,70.0,2.0,70.0,1692
13544,24,12,36,1,0,70.0,2.0,70.0,1693
13545,14,25,39,1,1,70.0,2.0,70.0,1693
13546,35,25,60,2,2,70.0,2.0,70.0,1693
13547,-26,100,74,2,3,70.0,2.0,70.0,1693
13548,17,41,58,3,4,70.0,2.0,70.0,1693
13549,34,38,72,3,5,70.0,2.0,70.0,1693
13550,5,95,100,3,6,70.0,2.0,70.0,1693
13551,25,19,44,3,7,70.0,2.0,70.0,1693
13552,2,23,25,1,0,70.0,2.0,70.0,1694
13553,0,40,40,1,1,70.0,2.0,70.0,1694
13554,0,50,50,2,2,70.0,2.0,70.0,1694
13555,10,50,60,2,3,70.0,2.0,70.0,1694
13556,0,45,45,3,4,70.0,2.0,70.0,1694
13557,5,45,50,3,5,70.0,2.0,70.0,1694
13558,0,50,50,3,6,70.0,2.0,70.0,1694
13559,10,50,60,3,7,70.0,2.0,70.0,1694
13560,38,37,75,1,0,70.0,2.0,70.0,1695
13561,64,12,76,1,1,70.0,2.0,70.0,1695
13562,65,24,89,2,2,70.0,2.0,70.0,1695
13563,13,63,76,2,3,70.0,2.0,70.0,1695
13564,40,24,64,3,4,70.0,2.0,70.0,1695
13565,0,63,63,3,5,70.0,2.0,70.0,1695
13566,63,12,75,3,6,70.0,2.0,70.0,1695
13567,39,36,75,3,7,70.0,2.0,70.0,1695
13568,20,10,30,1,0,70.0,2.0,70.0,1696
13569,50,10,60,1,1,70.0,2.0,70.0,1696
13570,20,0,20,2,2,70.0,2.0,70.0,1696
13571,5,15,20,2,3,70.0,2.0,70.0,1696
13572,20,80,100,3,4,70.0,2.0,70.0,1696
13573,50,50,100,3,5,70.0,2.0,70.0,1696
13574,40,40,80,3,6,70.0,2.0,70.0,1696
13575,40,0,40,3,7,70.0,2.0,70.0,1696
13576,10,40,50,1,0,70.0,2.0,70.0,1697
13577,15,60,75,1,1,70.0,2.0,70.0,1697
13578,10,50,60,2,2,70.0,2.0,70.0,1697
13579,15,60,75,2,3,70.0,2.0,70.0,1697
13580,5,55,60,3,4,70.0,2.0,70.0,1697
13581,10,50,60,3,5,70.0,2.0,70.0,1697
13582,30,50,80,3,6,70.0,2.0,70.0,1697
13583,5,50,55,3,7,70.0,2.0,70.0,1697
13584,0,10,10,1,0,70.0,2.0,70.0,1698
13585,0,30,30,1,1,70.0,2.0,70.0,1698
13586,5,65,70,2,2,70.0,2.0,70.0,1698
13587,0,90,90,2,3,70.0,2.0,70.0,1698
13588,0,50,50,3,4,70.0,2.0,70.0,1698
13589,30,65,95,3,5,70.0,2.0,70.0,1698
13590,10,85,95,3,6,70.0,2.0,70.0,1698
13591,80,5,85,3,7,70.0,2.0,70.0,1698
13592,-5,95,90,1,0,70.0,2.0,70.0,1699
13593,15,77,92,1,1,70.0,2.0,70.0,1699
13594,6,63,69,2,2,70.0,2.0,70.0,1699
13595,3,38,41,2,3,70.0,2.0,70.0,1699
13596,4,58,62,3,4,70.0,2.0,70.0,1699
13597,-13,35,22,3,5,70.0,2.0,70.0,1699
13598,-24,37,13,3,6,70.0,2.0,70.0,1699
13599,-1,1,0,3,7,70.0,2.0,70.0,1699
13600,1,55,56,1,0,70.0,2.0,70.0,1700
13601,-5,50,45,1,1,70.0,2.0,70.0,1700
13602,0,50,50,2,2,70.0,2.0,70.0,1700
13603,30,30,60,2,3,70.0,2.0,70.0,1700
13604,-1,76,75,3,4,70.0,2.0,70.0,1700
13605,14,40,54,3,5,70.0,2.0,70.0,1700
13606,0,20,20,3,6,70.0,2.0,70.0,1700
13607,26,20,46,3,7,70.0,2.0,70.0,1700
13608,21,73,94,1,0,70.0,2.0,70.0,1701
13609,55,14,69,1,1,70.0,2.0,70.0,1701
13610,1,70,71,2,2,70.0,2.0,70.0,1701
13611,-5,93,88,2,3,70.0,2.0,70.0,1701
13612,-55,89,34,3,4,70.0,2.0,70.0,1701
13613,24,51,75,3,5,70.0,2.0,70.0,1701
13614,-14,84,70,3,6,70.0,2.0,70.0,1701
13615,47,13,60,3,7,70.0,2.0,70.0,1701
13616,75,25,100,1,0,70.0,2.0,70.0,1702
13617,100,0,100,1,1,70.0,2.0,70.0,1702
13618,50,50,100,2,2,70.0,2.0,70.0,1702
13619,50,50,100,2,3,70.0,2.0,70.0,1702
13620,25,75,100,3,4,70.0,2.0,70.0,1702
13621,50,50,100,3,5,70.0,2.0,70.0,1702
13622,100,0,100,3,6,70.0,2.0,70.0,1702
13623,100,0,100,3,7,70.0,2.0,70.0,1702
13624,50,50,100,1,0,70.0,2.0,70.0,1703
13625,47,50,97,1,1,70.0,2.0,70.0,1703
13626,35,50,85,2,2,70.0,2.0,70.0,1703
13627,45,50,95,2,3,70.0,2.0,70.0,1703
13628,50,50,100,3,4,70.0,2.0,70.0,1703
13629,100,0,100,3,5,70.0,2.0,70.0,1703
13630,0,100,100,3,6,70.0,2.0,70.0,1703
13631,19,0,19,3,7,70.0,2.0,70.0,1703
13632,-9,32,23,1,0,70.0,2.0,70.0,1704
13633,33,67,100,1,1,70.0,2.0,70.0,1704
13634,37,50,87,2,2,70.0,2.0,70.0,1704
13635,1,79,80,2,3,70.0,2.0,70.0,1704
13636,3,81,84,3,4,70.0,2.0,70.0,1704
13637,29,50,79,3,5,70.0,2.0,70.0,1704
13638,84,16,100,3,6,70.0,2.0,70.0,1704
13639,63,17,80,3,7,70.0,2.0,70.0,1704
13640,-7,14,7,1,0,70.0,2.0,70.0,1705
13641,3,32,35,1,1,70.0,2.0,70.0,1705
13642,57,19,76,2,2,70.0,2.0,70.0,1705
13643,28,50,78,2,3,70.0,2.0,70.0,1705
13644,20,55,75,3,4,70.0,2.0,70.0,1705
13645,20,69,89,3,5,70.0,2.0,70.0,1705
13646,83,17,100,3,6,70.0,2.0,70.0,1705
13647,71,20,91,3,7,70.0,2.0,70.0,1705
13648,25,25,50,1,0,70.0,2.0,70.0,1706
13649,0,33,33,1,1,70.0,2.0,70.0,1706
13650,100,0,100,2,2,70.0,2.0,70.0,1706
13651,42,25,67,2,3,70.0,2.0,70.0,1706
13652,0,85,85,3,4,70.0,2.0,70.0,1706
13653,50,50,100,3,5,70.0,2.0,70.0,1706
13654,0,33,33,3,6,70.0,2.0,70.0,1706
13655,75,0,75,3,7,70.0,2.0,70.0,1706
13656,32,41,73,1,0,70.0,2.0,70.0,1707
13657,22,56,78,1,1,70.0,2.0,70.0,1707
13658,10,90,100,2,2,70.0,2.0,70.0,1707
13659,52,48,100,2,3,70.0,2.0,70.0,1707
13660,59,41,100,3,4,70.0,2.0,70.0,1707
13661,49,30,79,3,5,70.0,2.0,70.0,1707
13662,24,76,100,3,6,70.0,2.0,70.0,1707
13663,57,36,93,3,7,70.0,2.0,70.0,1707
13664,82,0,82,1,0,70.0,2.0,70.0,1708
13665,21,72,93,1,1,70.0,2.0,70.0,1708
13666,53,20,73,2,2,70.0,2.0,70.0,1708
13667,83,15,98,2,3,70.0,2.0,70.0,1708
13668,0,100,100,3,4,70.0,2.0,70.0,1708
13669,42,48,90,3,5,70.0,2.0,70.0,1708
13670,70,29,99,3,6,70.0,2.0,70.0,1708
13671,85,0,85,3,7,70.0,2.0,70.0,1708
13672,100,0,100,1,0,70.0,2.0,70.0,1709
13673,100,0,100,1,1,70.0,2.0,70.0,1709
13674,75,25,100,2,2,70.0,2.0,70.0,1709
13675,60,40,100,2,3,70.0,2.0,70.0,1709
13676,40,60,100,3,4,70.0,2.0,70.0,1709
13677,50,50,100,3,5,70.0,2.0,70.0,1709
13678,0,100,100,3,6,70.0,2.0,70.0,1709
13679,100,0,100,3,7,70.0,2.0,70.0,1709
13680,100,0,100,1,0,70.0,2.0,70.0,1710
13681,25,75,100,1,1,70.0,2.0,70.0,1710
13682,5,95,100,2,2,70.0,2.0,70.0,1710
13683,0,100,100,2,3,70.0,2.0,70.0,1710
13684,20,80,100,3,4,70.0,2.0,70.0,1710
13685,50,50,100,3,5,70.0,2.0,70.0,1710
13686,5,95,100,3,6,70.0,2.0,70.0,1710
13687,100,0,100,3,7,70.0,2.0,70.0,1710
13688,38,0,38,1,0,70.0,2.0,70.0,1711
13689,0,100,100,1,1,70.0,2.0,70.0,1711
13690,22,78,100,2,2,70.0,2.0,70.0,1711
13691,0,100,100,2,3,70.0,2.0,70.0,1711
13692,25,50,75,3,4,70.0,2.0,70.0,1711
13693,50,50,100,3,5,70.0,2.0,70.0,1711
13694,39,38,77,3,6,70.0,2.0,70.0,1711
13695,50,0,50,3,7,70.0,2.0,70.0,1711
13696,56,32,88,1,0,70.0,2.0,70.0,1712
13697,0,70,70,1,1,70.0,2.0,70.0,1712
13698,56,32,88,2,2,70.0,2.0,70.0,1712
13699,-9,89,80,2,3,70.0,2.0,70.0,1712
13700,29,36,65,3,4,70.0,2.0,70.0,1712
13701,45,35,80,3,5,70.0,2.0,70.0,1712
13702,15,65,80,3,6,70.0,2.0,70.0,1712
13703,14,11,25,3,7,70.0,2.0,70.0,1712
13704,75,25,100,1,0,70.0,2.0,70.0,1713
13705,12,88,100,1,1,70.0,2.0,70.0,1713
13706,0,100,100,2,2,70.0,2.0,70.0,1713
13707,0,100,100,2,3,70.0,2.0,70.0,1713
13708,0,100,100,3,4,70.0,2.0,70.0,1713
13709,57,43,100,3,5,70.0,2.0,70.0,1713
13710,76,24,100,3,6,70.0,2.0,70.0,1713
13711,36,64,100,3,7,70.0,2.0,70.0,1713
13712,34,16,50,1,0,70.0,2.0,70.0,1714
13713,14,47,61,1,1,70.0,2.0,70.0,1714
13714,25,75,100,2,2,70.0,2.0,70.0,1714
13715,66,0,66,2,3,70.0,2.0,70.0,1714
13716,50,50,100,3,4,70.0,2.0,70.0,1714
13717,44,39,83,3,5,70.0,2.0,70.0,1714
13718,73,18,91,3,6,70.0,2.0,70.0,1714
13719,56,12,68,3,7,70.0,2.0,70.0,1714
13720,4,23,27,1,0,70.0,2.0,70.0,1715
13721,99,0,99,1,1,70.0,2.0,70.0,1715
13722,0,100,100,2,2,70.0,2.0,70.0,1715
13723,3,96,99,2,3,70.0,2.0,70.0,1715
13724,8,87,95,3,4,70.0,2.0,70.0,1715
13725,95,0,95,3,5,70.0,2.0,70.0,1715
13726,-43,45,2,3,6,70.0,2.0,70.0,1715
13727,79,12,91,3,7,70.0,2.0,70.0,1715
13728,-4,9,5,1,0,70.0,2.0,70.0,1716
13729,77,0,77,1,1,70.0,2.0,70.0,1716
13730,29,36,65,2,2,70.0,2.0,70.0,1716
13731,77,0,77,2,3,70.0,2.0,70.0,1716
13732,27,37,64,3,4,70.0,2.0,70.0,1716
13733,99,0,99,3,5,70.0,2.0,70.0,1716
13734,85,0,85,3,6,70.0,2.0,70.0,1716
13735,64,0,64,3,7,70.0,2.0,70.0,1716
13736,69,15,84,1,0,70.0,2.0,70.0,1717
13737,47,41,88,1,1,70.0,2.0,70.0,1717
13738,6,91,97,2,2,70.0,2.0,70.0,1717
13739,11,88,99,2,3,70.0,2.0,70.0,1717
13740,38,55,93,3,4,70.0,2.0,70.0,1717
13741,48,50,98,3,5,70.0,2.0,70.0,1717
13742,25,75,100,3,6,70.0,2.0,70.0,1717
13743,99,0,99,3,7,70.0,2.0,70.0,1717
13744,74,0,74,1,0,70.0,2.0,70.0,1718
13745,14,6,20,1,1,70.0,2.0,70.0,1718
13746,-61,78,17,2,2,70.0,2.0,70.0,1718
13747,0,100,100,2,3,70.0,2.0,70.0,1718
13748,49,51,100,3,4,70.0,2.0,70.0,1718
13749,54,23,77,3,5,70.0,2.0,70.0,1718
13750,70,22,92,3,6,70.0,2.0,70.0,1718
13751,92,0,92,3,7,70.0,2.0,70.0,1718
13752,0,0,0,1,0,70.0,2.0,70.0,1719
13753,99,0,99,1,1,70.0,2.0,70.0,1719
13754,98,2,100,2,2,70.0,2.0,70.0,1719
13755,89,11,100,2,3,70.0,2.0,70.0,1719
13756,25,75,100,3,4,70.0,2.0,70.0,1719
13757,55,45,100,3,5,70.0,2.0,70.0,1719
13758,5,95,100,3,6,70.0,2.0,70.0,1719
13759,87,13,100,3,7,70.0,2.0,70.0,1719
13760,41,36,77,1,0,70.0,2.0,70.0,1720
13761,6,24,30,1,1,70.0,2.0,70.0,1720
13762,8,75,83,2,2,70.0,2.0,70.0,1720
13763,5,77,82,2,3,70.0,2.0,70.0,1720
13764,15,64,79,3,4,70.0,2.0,70.0,1720
13765,44,38,82,3,5,70.0,2.0,70.0,1720
13766,27,54,81,3,6,70.0,2.0,70.0,1720
13767,-14,39,25,3,7,70.0,2.0,70.0,1720
13768,0,0,0,1,0,70.0,2.0,70.0,1721
13769,0,0,0,1,1,70.0,2.0,70.0,1721
13770,0,100,100,2,2,70.0,2.0,70.0,1721
13771,0,100,100,2,3,70.0,2.0,70.0,1721
13772,20,80,100,3,4,70.0,2.0,70.0,1721
13773,24,31,55,3,5,70.0,2.0,70.0,1721
13774,0,0,0,3,6,70.0,2.0,70.0,1721
13775,0,0,0,3,7,70.0,2.0,70.0,1721
13776,-23,23,0,1,0,70.0,2.0,70.0,1722
13777,-32,66,34,1,1,70.0,2.0,70.0,1722
13778,0,100,100,2,2,70.0,2.0,70.0,1722
13779,0,100,100,2,3,70.0,2.0,70.0,1722
13780,20,55,75,3,4,70.0,2.0,70.0,1722
13781,29,39,68,3,5,70.0,2.0,70.0,1722
13782,6,30,36,3,6,70.0,2.0,70.0,1722
13783,23,20,43,3,7,70.0,2.0,70.0,1722
13784,-52,76,24,1,0,70.0,2.0,70.0,1723
13785,-16,80,64,1,1,70.0,2.0,70.0,1723
13786,-40,64,24,2,2,70.0,2.0,70.0,1723
13787,-1,64,63,2,3,70.0,2.0,70.0,1723
13788,-1,77,76,3,4,70.0,2.0,70.0,1723
13789,-12,38,26,3,5,70.0,2.0,70.0,1723
13790,-37,64,27,3,6,70.0,2.0,70.0,1723
13791,36,2,38,3,7,70.0,2.0,70.0,1723
13792,-33,52,19,1,0,70.0,2.0,70.0,1724
13793,-1,77,76,1,1,70.0,2.0,70.0,1724
13794,9,77,86,2,2,70.0,2.0,70.0,1724
13795,53,39,92,2,3,70.0,2.0,70.0,1724
13796,-9,86,77,3,4,70.0,2.0,70.0,1724
13797,35,51,86,3,5,70.0,2.0,70.0,1724
13798,48,50,98,3,6,70.0,2.0,70.0,1724
13799,62,26,88,3,7,70.0,2.0,70.0,1724
13800,-12,50,38,1,0,70.0,2.0,70.0,1725
13801,45,20,65,1,1,70.0,2.0,70.0,1725
13802,30,50,80,2,2,70.0,2.0,70.0,1725
13803,25,30,55,2,3,70.0,2.0,70.0,1725
13804,27,50,77,3,4,70.0,2.0,70.0,1725
13805,40,50,90,3,5,70.0,2.0,70.0,1725
13806,17,48,65,3,6,70.0,2.0,70.0,1725
13807,52,33,85,3,7,70.0,2.0,70.0,1725
13808,13,52,65,1,0,70.0,2.0,70.0,1726
13809,-21,61,40,1,1,70.0,2.0,70.0,1726
13810,11,60,71,2,2,70.0,2.0,70.0,1726
13811,-13,55,42,2,3,70.0,2.0,70.0,1726
13812,-14,39,25,3,4,70.0,2.0,70.0,1726
13813,5,17,22,3,5,70.0,2.0,70.0,1726
13814,-23,64,41,3,6,70.0,2.0,70.0,1726
13815,5,30,35,3,7,70.0,2.0,70.0,1726
13816,0,75,75,1,0,70.0,2.0,70.0,1727
13817,5,70,75,1,1,70.0,2.0,70.0,1727
13818,-15,90,75,2,2,70.0,2.0,70.0,1727
13819,0,75,75,2,3,70.0,2.0,70.0,1727
13820,-15,90,75,3,4,70.0,2.0,70.0,1727
13821,0,90,90,3,5,70.0,2.0,70.0,1727
13822,0,88,88,3,6,70.0,2.0,70.0,1727
13823,-15,90,75,3,7,70.0,2.0,70.0,1727
13824,100,0,100,1,0,70.0,2.0,70.0,1728
13825,100,0,100,1,1,70.0,2.0,70.0,1728
13826,0,100,100,2,2,70.0,2.0,70.0,1728
13827,0,100,100,2,3,70.0,2.0,70.0,1728
13828,39,61,100,3,4,70.0,2.0,70.0,1728
13829,100,0,100,3,5,70.0,2.0,70.0,1728
13830,0,100,100,3,6,70.0,2.0,70.0,1728
13831,90,10,100,3,7,70.0,2.0,70.0,1728
13832,2,67,69,1,0,70.0,2.0,70.0,1729
13833,10,21,31,1,1,70.0,2.0,70.0,1729
13834,0,100,100,2,2,70.0,2.0,70.0,1729
13835,17,83,100,2,3,70.0,2.0,70.0,1729
13836,21,70,91,3,4,70.0,2.0,70.0,1729
13837,11,73,84,3,5,70.0,2.0,70.0,1729
13838,50,40,90,3,6,70.0,2.0,70.0,1729
13839,35,0,35,3,7,70.0,2.0,70.0,1729
13840,64,36,100,1,0,70.0,2.0,70.0,1730
13841,29,69,98,1,1,70.0,2.0,70.0,1730
13842,3,97,100,2,2,70.0,2.0,70.0,1730
13843,93,7,100,2,3,70.0,2.0,70.0,1730
13844,40,60,100,3,4,70.0,2.0,70.0,1730
13845,89,11,100,3,5,70.0,2.0,70.0,1730
13846,96,0,96,3,6,70.0,2.0,70.0,1730
13847,100,0,100,3,7,70.0,2.0,70.0,1730
13848,-15,18,3,1,0,70.0,2.0,70.0,1731
13849,-41,100,59,1,1,70.0,2.0,70.0,1731
13850,10,90,100,2,2,70.0,2.0,70.0,1731
13851,27,73,100,2,3,70.0,2.0,70.0,1731
13852,34,66,100,3,4,70.0,2.0,70.0,1731
13853,40,60,100,3,5,70.0,2.0,70.0,1731
13854,71,9,80,3,6,70.0,2.0,70.0,1731
13855,32,50,82,3,7,70.0,2.0,70.0,1731
13856,16,84,100,1,0,70.0,2.0,70.0,1732
13857,100,0,100,1,1,70.0,2.0,70.0,1732
13858,17,83,100,2,2,70.0,2.0,70.0,1732
13859,66,34,100,2,3,70.0,2.0,70.0,1732
13860,76,24,100,3,4,70.0,2.0,70.0,1732
13861,75,25,100,3,5,70.0,2.0,70.0,1732
13862,0,100,100,3,6,70.0,2.0,70.0,1732
13863,100,0,100,3,7,70.0,2.0,70.0,1732
13864,21,38,59,1,0,70.0,2.0,70.0,1733
13865,1,37,38,1,1,70.0,2.0,70.0,1733
13866,5,21,26,2,2,70.0,2.0,70.0,1733
13867,24,36,60,2,3,70.0,2.0,70.0,1733
13868,-1,41,40,3,4,70.0,2.0,70.0,1733
13869,-1,76,75,3,5,70.0,2.0,70.0,1733
13870,5,26,31,3,6,70.0,2.0,70.0,1733
13871,39,34,73,3,7,70.0,2.0,70.0,1733
13872,16,6,22,1,0,71.0,2.0,71.0,1734
13873,-3,88,85,1,1,71.0,2.0,71.0,1734
13874,-7,61,54,2,2,71.0,2.0,71.0,1734
13875,12,11,23,2,3,71.0,2.0,71.0,1734
13876,2,57,59,3,4,71.0,2.0,71.0,1734
13877,0,53,53,3,5,71.0,2.0,71.0,1734
13878,-1,37,36,3,6,71.0,2.0,71.0,1734
13879,20,19,39,3,7,71.0,2.0,71.0,1734
13880,8,69,77,1,0,71.0,2.0,71.0,1735
13881,5,71,76,1,1,71.0,2.0,71.0,1735
13882,-5,75,70,2,2,71.0,2.0,71.0,1735
13883,-5,81,76,2,3,71.0,2.0,71.0,1735
13884,-8,79,71,3,4,71.0,2.0,71.0,1735
13885,4,73,77,3,5,71.0,2.0,71.0,1735
13886,-2,78,76,3,6,71.0,2.0,71.0,1735
13887,-5,75,70,3,7,71.0,2.0,71.0,1735
13888,70,30,100,1,0,71.0,2.0,71.0,1736
13889,51,45,96,1,1,71.0,2.0,71.0,1736
13890,33,62,95,2,2,71.0,2.0,71.0,1736
13891,54,43,97,2,3,71.0,2.0,71.0,1736
13892,34,66,100,3,4,71.0,2.0,71.0,1736
13893,27,67,94,3,5,71.0,2.0,71.0,1736
13894,61,25,86,3,6,71.0,2.0,71.0,1736
13895,78,21,99,3,7,71.0,2.0,71.0,1736
13896,20,0,20,1,0,71.0,2.0,71.0,1737
13897,77,16,93,1,1,71.0,2.0,71.0,1737
13898,87,10,97,2,2,71.0,2.0,71.0,1737
13899,0,100,100,2,3,71.0,2.0,71.0,1737
13900,13,87,100,3,4,71.0,2.0,71.0,1737
13901,65,26,91,3,5,71.0,2.0,71.0,1737
13902,68,32,100,3,6,71.0,2.0,71.0,1737
13903,-6,27,21,3,7,71.0,2.0,71.0,1737
13904,60,40,100,1,0,71.0,2.0,71.0,1738
13905,60,40,100,1,1,71.0,2.0,71.0,1738
13906,90,10,100,2,2,71.0,2.0,71.0,1738
13907,25,75,100,2,3,71.0,2.0,71.0,1738
13908,25,75,100,3,4,71.0,2.0,71.0,1738
13909,25,75,100,3,5,71.0,2.0,71.0,1738
13910,60,40,100,3,6,71.0,2.0,71.0,1738
13911,90,10,100,3,7,71.0,2.0,71.0,1738
13912,66,25,91,1,0,71.0,2.0,71.0,1739
13913,61,34,95,1,1,71.0,2.0,71.0,1739
13914,75,12,87,2,2,71.0,2.0,71.0,1739
13915,0,95,95,2,3,71.0,2.0,71.0,1739
13916,48,38,86,3,4,71.0,2.0,71.0,1739
13917,45,50,95,3,5,71.0,2.0,71.0,1739
13918,48,50,98,3,6,71.0,2.0,71.0,1739
13919,-16,25,9,3,7,71.0,2.0,71.0,1739
13920,77,23,100,1,0,71.0,2.0,71.0,1740
13921,77,23,100,1,1,71.0,2.0,71.0,1740
13922,76,24,100,2,2,71.0,2.0,71.0,1740
13923,76,24,100,2,3,71.0,2.0,71.0,1740
13924,10,90,100,3,4,71.0,2.0,71.0,1740
13925,9,91,100,3,5,71.0,2.0,71.0,1740
13926,12,88,100,3,6,71.0,2.0,71.0,1740
13927,-23,23,0,3,7,71.0,2.0,71.0,1740
13928,60,0,60,1,0,71.0,2.0,71.0,1741
13929,-10,10,0,1,1,71.0,2.0,71.0,1741
13930,0,100,100,2,2,71.0,2.0,71.0,1741
13931,0,100,100,2,3,71.0,2.0,71.0,1741
13932,22,78,100,3,4,71.0,2.0,71.0,1741
13933,50,50,100,3,5,71.0,2.0,71.0,1741
13934,15,67,82,3,6,71.0,2.0,71.0,1741
13935,0,100,100,3,7,71.0,2.0,71.0,1741
13936,11,0,11,1,0,71.0,2.0,71.0,1742
13937,-4,4,0,1,1,71.0,2.0,71.0,1742
13938,17,68,85,2,2,71.0,2.0,71.0,1742
13939,-26,100,74,2,3,71.0,2.0,71.0,1742
13940,13,64,77,3,4,71.0,2.0,71.0,1742
13941,79,3,82,3,5,71.0,2.0,71.0,1742
13942,18,46,64,3,6,71.0,2.0,71.0,1742
13943,28,44,72,3,7,71.0,2.0,71.0,1742
13944,32,28,60,1,0,71.0,2.0,71.0,1743
13945,20,40,60,1,1,71.0,2.0,71.0,1743
13946,42,24,66,2,2,71.0,2.0,71.0,1743
13947,24,50,74,2,3,71.0,2.0,71.0,1743
13948,4,91,95,3,4,71.0,2.0,71.0,1743
13949,46,19,65,3,5,71.0,2.0,71.0,1743
13950,27,50,77,3,6,71.0,2.0,71.0,1743
13951,51,14,65,3,7,71.0,2.0,71.0,1743
13952,76,6,82,1,0,71.0,2.0,71.0,1744
13953,82,18,100,1,1,71.0,2.0,71.0,1744
13954,60,22,82,2,2,71.0,2.0,71.0,1744
13955,0,100,100,2,3,71.0,2.0,71.0,1744
13956,25,75,100,3,4,71.0,2.0,71.0,1744
13957,64,36,100,3,5,71.0,2.0,71.0,1744
13958,100,0,100,3,6,71.0,2.0,71.0,1744
13959,92,5,97,3,7,71.0,2.0,71.0,1744
13960,-62,85,23,1,0,71.0,2.0,71.0,1745
13961,-46,68,22,1,1,71.0,2.0,71.0,1745
13962,-78,100,22,2,2,71.0,2.0,71.0,1745
13963,-23,90,67,2,3,71.0,2.0,71.0,1745
13964,-50,80,30,3,4,71.0,2.0,71.0,1745
13965,-25,86,61,3,5,71.0,2.0,71.0,1745
13966,-64,90,26,3,6,71.0,2.0,71.0,1745
13967,-56,80,24,3,7,71.0,2.0,71.0,1745
13968,38,38,76,1,0,71.0,2.0,71.0,1746
13969,36,41,77,1,1,71.0,2.0,71.0,1746
13970,-8,76,68,2,2,71.0,2.0,71.0,1746
13971,17,68,85,2,3,71.0,2.0,71.0,1746
13972,17,64,81,3,4,71.0,2.0,71.0,1746
13973,22,61,83,3,5,71.0,2.0,71.0,1746
13974,64,34,98,3,6,71.0,2.0,71.0,1746
13975,52,25,77,3,7,71.0,2.0,71.0,1746
13976,9,42,51,1,0,71.0,2.0,71.0,1747
13977,8,33,41,1,1,71.0,2.0,71.0,1747
13978,5,55,60,2,2,71.0,2.0,71.0,1747
13979,15,63,78,2,3,71.0,2.0,71.0,1747
13980,13,40,53,3,4,71.0,2.0,71.0,1747
13981,16,60,76,3,5,71.0,2.0,71.0,1747
13982,19,45,64,3,6,71.0,2.0,71.0,1747
13983,22,24,46,3,7,71.0,2.0,71.0,1747
13984,98,2,100,1,0,71.0,2.0,71.0,1748
13985,50,50,100,1,1,71.0,2.0,71.0,1748
13986,35,65,100,2,2,71.0,2.0,71.0,1748
13987,50,50,100,2,3,71.0,2.0,71.0,1748
13988,20,80,100,3,4,71.0,2.0,71.0,1748
13989,50,50,100,3,5,71.0,2.0,71.0,1748
13990,68,32,100,3,6,71.0,2.0,71.0,1748
13991,65,35,100,3,7,71.0,2.0,71.0,1748
13992,66,0,66,1,0,71.0,2.0,71.0,1749
13993,-1,14,13,1,1,71.0,2.0,71.0,1749
13994,-1,88,87,2,2,71.0,2.0,71.0,1749
13995,13,75,88,2,3,71.0,2.0,71.0,1749
13996,-4,92,88,3,4,71.0,2.0,71.0,1749
13997,85,0,85,3,5,71.0,2.0,71.0,1749
13998,-10,100,90,3,6,71.0,2.0,71.0,1749
13999,11,0,11,3,7,71.0,2.0,71.0,1749
14000,100,0,100,1,0,71.0,2.0,71.0,1750
14001,100,0,100,1,1,71.0,2.0,71.0,1750
14002,97,0,97,2,2,71.0,2.0,71.0,1750
14003,98,0,98,2,3,71.0,2.0,71.0,1750
14004,86,14,100,3,4,71.0,2.0,71.0,1750
14005,30,67,97,3,5,71.0,2.0,71.0,1750
14006,-85,95,10,3,6,71.0,2.0,71.0,1750
14007,16,0,16,3,7,71.0,2.0,71.0,1750
14008,0,0,0,1,0,71.0,2.0,71.0,1751
14009,47,42,89,1,1,71.0,2.0,71.0,1751
14010,5,89,94,2,2,71.0,2.0,71.0,1751
14011,38,38,76,2,3,71.0,2.0,71.0,1751
14012,17,76,93,3,4,71.0,2.0,71.0,1751
14013,52,24,76,3,5,71.0,2.0,71.0,1751
14014,32,63,95,3,6,71.0,2.0,71.0,1751
14015,50,0,50,3,7,71.0,2.0,71.0,1751
14016,11,19,30,1,0,71.0,2.0,71.0,1752
14017,-19,40,21,1,1,71.0,2.0,71.0,1752
14018,-1,66,65,2,2,71.0,2.0,71.0,1752
14019,0,29,29,2,3,71.0,2.0,71.0,1752
14020,15,45,60,3,4,71.0,2.0,71.0,1752
14021,39,23,62,3,5,71.0,2.0,71.0,1752
14022,-4,36,32,3,6,71.0,2.0,71.0,1752
14023,18,13,31,3,7,71.0,2.0,71.0,1752
14024,-40,90,50,1,0,71.0,2.0,71.0,1753
14025,0,50,50,1,1,71.0,2.0,71.0,1753
14026,0,50,50,2,2,71.0,2.0,71.0,1753
14027,-7,100,93,2,3,71.0,2.0,71.0,1753
14028,-10,100,90,3,4,71.0,2.0,71.0,1753
14029,49,50,99,3,5,71.0,2.0,71.0,1753
14030,-50,100,50,3,6,71.0,2.0,71.0,1753
14031,13,5,18,3,7,71.0,2.0,71.0,1753
14032,14,50,64,1,0,71.0,2.0,71.0,1754
14033,66,14,80,1,1,71.0,2.0,71.0,1754
14034,29,48,77,2,2,71.0,2.0,71.0,1754
14035,-16,26,10,2,3,71.0,2.0,71.0,1754
14036,7,65,72,3,4,71.0,2.0,71.0,1754
14037,66,11,77,3,5,71.0,2.0,71.0,1754
14038,11,88,99,3,6,71.0,2.0,71.0,1754
14039,65,10,75,3,7,71.0,2.0,71.0,1754
14040,26,29,55,1,0,71.0,2.0,71.0,1755
14041,39,3,42,1,1,71.0,2.0,71.0,1755
14042,-28,61,33,2,2,71.0,2.0,71.0,1755
14043,14,16,30,2,3,71.0,2.0,71.0,1755
14044,-2,75,73,3,4,71.0,2.0,71.0,1755
14045,16,38,54,3,5,71.0,2.0,71.0,1755
14046,9,20,29,3,6,71.0,2.0,71.0,1755
14047,38,0,38,3,7,71.0,2.0,71.0,1755
14048,-20,56,36,1,0,71.0,2.0,71.0,1756
14049,-24,77,53,1,1,71.0,2.0,71.0,1756
14050,-24,92,68,2,2,71.0,2.0,71.0,1756
14051,-99,99,0,2,3,71.0,2.0,71.0,1756
14052,12,41,53,3,4,71.0,2.0,71.0,1756
14053,21,59,80,3,5,71.0,2.0,71.0,1756
14054,-8,50,42,3,6,71.0,2.0,71.0,1756
14055,20,12,32,3,7,71.0,2.0,71.0,1756
14056,-37,81,44,1,0,71.0,2.0,71.0,1757
14057,-61,100,39,1,1,71.0,2.0,71.0,1757
14058,-1,73,72,2,2,71.0,2.0,71.0,1757
14059,-11,100,89,2,3,71.0,2.0,71.0,1757
14060,-8,76,68,3,4,71.0,2.0,71.0,1757
14061,-3,73,70,3,5,71.0,2.0,71.0,1757
14062,13,63,76,3,6,71.0,2.0,71.0,1757
14063,-4,78,74,3,7,71.0,2.0,71.0,1757
14064,18,0,18,1,0,71.0,2.0,71.0,1758
14065,-4,18,14,1,1,71.0,2.0,71.0,1758
14066,29,71,100,2,2,71.0,2.0,71.0,1758
14067,0,100,100,2,3,71.0,2.0,71.0,1758
14068,-3,41,38,3,4,71.0,2.0,71.0,1758
14069,0,50,50,3,5,71.0,2.0,71.0,1758
14070,2,37,39,3,6,71.0,2.0,71.0,1758
14071,15,10,25,3,7,71.0,2.0,71.0,1758
14072,-7,38,31,1,0,71.0,2.0,71.0,1759
14073,18,22,40,1,1,71.0,2.0,71.0,1759
14074,-2,43,41,2,2,71.0,2.0,71.0,1759
14075,-33,67,34,2,3,71.0,2.0,71.0,1759
14076,6,39,45,3,4,71.0,2.0,71.0,1759
14077,4,28,32,3,5,71.0,2.0,71.0,1759
14078,-7,68,61,3,6,71.0,2.0,71.0,1759
14079,8,26,34,3,7,71.0,2.0,71.0,1759
14080,-13,84,71,1,0,71.0,2.0,71.0,1760
14081,-36,84,48,1,1,71.0,2.0,71.0,1760
14082,-4,85,81,2,2,71.0,2.0,71.0,1760
14083,-25,88,63,2,3,71.0,2.0,71.0,1760
14084,-24,86,62,3,4,71.0,2.0,71.0,1760
14085,-4,84,80,3,5,71.0,2.0,71.0,1760
14086,4,81,85,3,6,71.0,2.0,71.0,1760
14087,3,79,82,3,7,71.0,2.0,71.0,1760
14088,65,4,69,1,0,71.0,2.0,71.0,1761
14089,24,0,24,1,1,71.0,2.0,71.0,1761
14090,-6,77,71,2,2,71.0,2.0,71.0,1761
14091,19,62,81,2,3,71.0,2.0,71.0,1761
14092,36,61,97,3,4,71.0,2.0,71.0,1761
14093,24,51,75,3,5,71.0,2.0,71.0,1761
14094,26,64,90,3,6,71.0,2.0,71.0,1761
14095,12,17,29,3,7,71.0,2.0,71.0,1761
14096,24,0,24,1,0,71.0,2.0,71.0,1762
14097,-26,50,24,1,1,71.0,2.0,71.0,1762
14098,10,50,60,2,2,71.0,2.0,71.0,1762
14099,0,100,100,2,3,71.0,2.0,71.0,1762
14100,11,76,87,3,4,71.0,2.0,71.0,1762
14101,0,50,50,3,5,71.0,2.0,71.0,1762
14102,5,95,100,3,6,71.0,2.0,71.0,1762
14103,13,24,37,3,7,71.0,2.0,71.0,1762
14104,-2,2,0,1,0,71.0,2.0,71.0,1763
14105,-24,79,55,1,1,71.0,2.0,71.0,1763
14106,-25,35,10,2,2,71.0,2.0,71.0,1763
14107,-3,40,37,2,3,71.0,2.0,71.0,1763
14108,1,60,61,3,4,71.0,2.0,71.0,1763
14109,13,0,13,3,5,71.0,2.0,71.0,1763
14110,11,1,12,3,6,71.0,2.0,71.0,1763
14111,-5,10,5,3,7,71.0,2.0,71.0,1763
14112,10,50,60,1,0,72.0,2.0,72.0,1764
14113,7,82,89,1,1,72.0,2.0,72.0,1764
14114,-9,65,56,2,2,72.0,2.0,72.0,1764
14115,-11,69,58,2,3,72.0,2.0,72.0,1764
14116,17,40,57,3,4,72.0,2.0,72.0,1764
14117,-1,65,64,3,5,72.0,2.0,72.0,1764
14118,-1,60,59,3,6,72.0,2.0,72.0,1764
14119,-15,59,44,3,7,72.0,2.0,72.0,1764
14120,72,0,72,1,0,72.0,2.0,72.0,1765
14121,36,64,100,1,1,72.0,2.0,72.0,1765
14122,18,55,73,2,2,72.0,2.0,72.0,1765
14123,-23,100,77,2,3,72.0,2.0,72.0,1765
14124,11,72,83,3,4,72.0,2.0,72.0,1765
14125,-9,77,68,3,5,72.0,2.0,72.0,1765
14126,69,0,69,3,6,72.0,2.0,72.0,1765
14127,-2,70,68,3,7,72.0,2.0,72.0,1765
14128,0,0,0,1,0,72.0,2.0,72.0,1766
14129,64,13,77,1,1,72.0,2.0,72.0,1766
14130,36,64,100,2,2,72.0,2.0,72.0,1766
14131,0,0,0,2,3,72.0,2.0,72.0,1766
14132,2,75,77,3,4,72.0,2.0,72.0,1766
14133,26,50,76,3,5,72.0,2.0,72.0,1766
14134,1,99,100,3,6,72.0,2.0,72.0,1766
14135,50,0,50,3,7,72.0,2.0,72.0,1766
14136,83,0,83,1,0,72.0,2.0,72.0,1767
14137,78,0,78,1,1,72.0,2.0,72.0,1767
14138,15,69,84,2,2,72.0,2.0,72.0,1767
14139,15,72,87,2,3,72.0,2.0,72.0,1767
14140,41,50,91,3,4,72.0,2.0,72.0,1767
14141,11,74,85,3,5,72.0,2.0,72.0,1767
14142,65,26,91,3,6,72.0,2.0,72.0,1767
14143,78,0,78,3,7,72.0,2.0,72.0,1767
14144,100,0,100,1,0,72.0,2.0,72.0,1768
14145,50,50,100,1,1,72.0,2.0,72.0,1768
14146,50,50,100,2,2,72.0,2.0,72.0,1768
14147,100,0,100,2,3,72.0,2.0,72.0,1768
14148,40,60,100,3,4,72.0,2.0,72.0,1768
14149,85,15,100,3,5,72.0,2.0,72.0,1768
14150,50,50,100,3,6,72.0,2.0,72.0,1768
14151,100,0,100,3,7,72.0,2.0,72.0,1768
14152,41,50,91,1,0,72.0,2.0,72.0,1769
14153,1,99,100,1,1,72.0,2.0,72.0,1769
14154,35,50,85,2,2,72.0,2.0,72.0,1769
14155,68,17,85,2,3,72.0,2.0,72.0,1769
14156,58,30,88,3,4,72.0,2.0,72.0,1769
14157,14,79,93,3,5,72.0,2.0,72.0,1769
14158,9,79,88,3,6,72.0,2.0,72.0,1769
14159,16,22,38,3,7,72.0,2.0,72.0,1769
14160,-2,40,38,1,0,72.0,2.0,72.0,1770
14161,30,42,72,1,1,72.0,2.0,72.0,1770
14162,25,47,72,2,2,72.0,2.0,72.0,1770
14163,3,78,81,2,3,72.0,2.0,72.0,1770
14164,-3,70,67,3,4,72.0,2.0,72.0,1770
14165,17,47,64,3,5,72.0,2.0,72.0,1770
14166,36,38,74,3,6,72.0,2.0,72.0,1770
14167,22,42,64,3,7,72.0,2.0,72.0,1770
14168,82,18,100,1,0,72.0,2.0,72.0,1771
14169,4,83,87,1,1,72.0,2.0,72.0,1771
14170,-79,79,0,2,2,72.0,2.0,72.0,1771
14171,-70,70,0,2,3,72.0,2.0,72.0,1771
14172,-6,32,26,3,4,72.0,2.0,72.0,1771
14173,28,67,95,3,5,72.0,2.0,72.0,1771
14174,-11,90,79,3,6,72.0,2.0,72.0,1771
14175,-12,33,21,3,7,72.0,2.0,72.0,1771
14176,76,0,76,1,0,72.0,2.0,72.0,1772
14177,5,95,100,1,1,72.0,2.0,72.0,1772
14178,6,94,100,2,2,72.0,2.0,72.0,1772
14179,0,100,100,2,3,72.0,2.0,72.0,1772
14180,44,56,100,3,4,72.0,2.0,72.0,1772
14181,93,7,100,3,5,72.0,2.0,72.0,1772
14182,37,63,100,3,6,72.0,2.0,72.0,1772
14183,75,12,87,3,7,72.0,2.0,72.0,1772
14184,-10,81,71,1,0,72.0,2.0,72.0,1773
14185,-15,79,64,1,1,72.0,2.0,72.0,1773
14186,-13,79,66,2,2,72.0,2.0,72.0,1773
14187,-9,79,70,2,3,72.0,2.0,72.0,1773
14188,3,83,86,3,4,72.0,2.0,72.0,1773
14189,2,72,74,3,5,72.0,2.0,72.0,1773
14190,-13,78,65,3,6,72.0,2.0,72.0,1773
14191,-2,82,80,3,7,72.0,2.0,72.0,1773
14192,-25,63,38,1,0,72.0,2.0,72.0,1774
14193,0,63,63,1,1,72.0,2.0,72.0,1774
14194,1,67,68,2,2,72.0,2.0,72.0,1774
14195,2,65,67,2,3,72.0,2.0,72.0,1774
14196,20,61,81,3,4,72.0,2.0,72.0,1774
14197,-28,63,35,3,5,72.0,2.0,72.0,1774
14198,5,62,67,3,6,72.0,2.0,72.0,1774
14199,0,61,61,3,7,72.0,2.0,72.0,1774
14200,-63,63,0,1,0,72.0,2.0,72.0,1775
14201,-15,65,50,1,1,72.0,2.0,72.0,1775
14202,-44,100,56,2,2,72.0,2.0,72.0,1775
14203,34,66,100,2,3,72.0,2.0,72.0,1775
14204,-7,70,63,3,4,72.0,2.0,72.0,1775
14205,5,50,55,3,5,72.0,2.0,72.0,1775
14206,-22,65,43,3,6,72.0,2.0,72.0,1775
14207,-10,66,56,3,7,72.0,2.0,72.0,1775
14208,22,49,71,1,0,72.0,2.0,72.0,1776
14209,36,43,79,1,1,72.0,2.0,72.0,1776
14210,24,50,74,2,2,72.0,2.0,72.0,1776
14211,-28,49,21,2,3,72.0,2.0,72.0,1776
14212,29,41,70,3,4,72.0,2.0,72.0,1776
14213,16,57,73,3,5,72.0,2.0,72.0,1776
14214,26,45,71,3,6,72.0,2.0,72.0,1776
14215,37,36,73,3,7,72.0,2.0,72.0,1776
14216,5,5,10,1,0,72.0,2.0,72.0,1777
14217,4,2,6,1,1,72.0,2.0,72.0,1777
14218,20,77,97,2,2,72.0,2.0,72.0,1777
14219,53,7,60,2,3,72.0,2.0,72.0,1777
14220,18,77,95,3,4,72.0,2.0,72.0,1777
14221,44,50,94,3,5,72.0,2.0,72.0,1777
14222,3,93,96,3,6,72.0,2.0,72.0,1777
14223,-3,12,9,3,7,72.0,2.0,72.0,1777
14224,-2,9,7,1,0,72.0,2.0,72.0,1778
14225,87,0,87,1,1,72.0,2.0,72.0,1778
14226,0,100,100,2,2,72.0,2.0,72.0,1778
14227,65,25,90,2,3,72.0,2.0,72.0,1778
14228,9,81,90,3,4,72.0,2.0,72.0,1778
14229,71,20,91,3,5,72.0,2.0,72.0,1778
14230,100,0,100,3,6,72.0,2.0,72.0,1778
14231,9,0,9,3,7,72.0,2.0,72.0,1778
14232,38,0,38,1,0,72.0,2.0,72.0,1779
14233,26,0,26,1,1,72.0,2.0,72.0,1779
14234,0,100,100,2,2,72.0,2.0,72.0,1779
14235,0,100,100,2,3,72.0,2.0,72.0,1779
14236,16,50,66,3,4,72.0,2.0,72.0,1779
14237,20,50,70,3,5,72.0,2.0,72.0,1779
14238,67,15,82,3,6,72.0,2.0,72.0,1779
14239,33,24,57,3,7,72.0,2.0,72.0,1779
14240,-5,79,74,1,0,72.0,2.0,72.0,1780
14241,17,75,92,1,1,72.0,2.0,72.0,1780
14242,-8,84,76,2,2,72.0,2.0,72.0,1780
14243,12,81,93,2,3,72.0,2.0,72.0,1780
14244,18,82,100,3,4,72.0,2.0,72.0,1780
14245,-2,84,82,3,5,72.0,2.0,72.0,1780
14246,1,85,86,3,6,72.0,2.0,72.0,1780
14247,3,83,86,3,7,72.0,2.0,72.0,1780
14248,35,0,35,1,0,72.0,2.0,72.0,1781
14249,49,0,49,1,1,72.0,2.0,72.0,1781
14250,21,54,75,2,2,72.0,2.0,72.0,1781
14251,2,88,90,2,3,72.0,2.0,72.0,1781
14252,38,38,76,3,4,72.0,2.0,72.0,1781
14253,75,0,75,3,5,72.0,2.0,72.0,1781
14254,-1,51,50,3,6,72.0,2.0,72.0,1781
14255,62,0,62,3,7,72.0,2.0,72.0,1781
14256,0,0,0,1,0,72.0,2.0,72.0,1782
14257,-6,94,88,1,1,72.0,2.0,72.0,1782
14258,0,100,100,2,2,72.0,2.0,72.0,1782
14259,0,100,100,2,3,72.0,2.0,72.0,1782
14260,7,77,84,3,4,72.0,2.0,72.0,1782
14261,15,75,90,3,5,72.0,2.0,72.0,1782
14262,15,85,100,3,6,72.0,2.0,72.0,1782
14263,76,5,81,3,7,72.0,2.0,72.0,1782
14264,100,0,100,1,0,72.0,2.0,72.0,1783
14265,100,0,100,1,1,72.0,2.0,72.0,1783
14266,50,50,100,2,2,72.0,2.0,72.0,1783
14267,24,76,100,2,3,72.0,2.0,72.0,1783
14268,24,76,100,3,4,72.0,2.0,72.0,1783
14269,50,50,100,3,5,72.0,2.0,72.0,1783
14270,76,24,100,3,6,72.0,2.0,72.0,1783
14271,-24,25,1,3,7,72.0,2.0,72.0,1783
14272,2,41,43,1,0,72.0,2.0,72.0,1784
14273,38,39,77,1,1,72.0,2.0,72.0,1784
14274,3,97,100,2,2,72.0,2.0,72.0,1784
14275,-27,100,73,2,3,72.0,2.0,72.0,1784
14276,37,63,100,3,4,72.0,2.0,72.0,1784
14277,100,0,100,3,5,72.0,2.0,72.0,1784
14278,23,43,66,3,6,72.0,2.0,72.0,1784
14279,100,0,100,3,7,72.0,2.0,72.0,1784
14280,-1,1,0,1,0,72.0,2.0,72.0,1785
14281,-100,100,0,1,1,72.0,2.0,72.0,1785
14282,12,78,90,2,2,72.0,2.0,72.0,1785
14283,0,100,100,2,3,72.0,2.0,72.0,1785
14284,8,90,98,3,4,72.0,2.0,72.0,1785
14285,1,49,50,3,5,72.0,2.0,72.0,1785
14286,-17,49,32,3,6,72.0,2.0,72.0,1785
14287,0,99,99,3,7,72.0,2.0,72.0,1785
14288,77,23,100,1,0,72.0,2.0,72.0,1786
14289,100,0,100,1,1,72.0,2.0,72.0,1786
14290,0,100,100,2,2,72.0,2.0,72.0,1786
14291,0,100,100,2,3,72.0,2.0,72.0,1786
14292,18,82,100,3,4,72.0,2.0,72.0,1786
14293,100,0,100,3,5,72.0,2.0,72.0,1786
14294,18,82,100,3,6,72.0,2.0,72.0,1786
14295,0,0,0,3,7,72.0,2.0,72.0,1786
14296,12,77,89,1,0,72.0,2.0,72.0,1787
14297,12,0,12,1,1,72.0,2.0,72.0,1787
14298,-76,76,0,2,2,72.0,2.0,72.0,1787
14299,-2,65,63,2,3,72.0,2.0,72.0,1787
14300,54,35,89,3,4,72.0,2.0,72.0,1787
14301,9,67,76,3,5,72.0,2.0,72.0,1787
14302,77,23,100,3,6,72.0,2.0,72.0,1787
14303,9,1,10,3,7,72.0,2.0,72.0,1787
14304,6,57,63,1,0,72.0,2.0,72.0,1788
14305,8,56,64,1,1,72.0,2.0,72.0,1788
14306,-6,29,23,2,2,72.0,2.0,72.0,1788
14307,0,10,10,2,3,72.0,2.0,72.0,1788
14308,-27,37,10,3,4,72.0,2.0,72.0,1788
14309,3,85,88,3,5,72.0,2.0,72.0,1788
14310,2,54,56,3,6,72.0,2.0,72.0,1788
14311,4,58,62,3,7,72.0,2.0,72.0,1788
14312,6,0,6,1,0,72.0,2.0,72.0,1789
14313,6,2,8,1,1,72.0,2.0,72.0,1789
14314,1,99,100,2,2,72.0,2.0,72.0,1789
14315,23,77,100,2,3,72.0,2.0,72.0,1789
14316,12,88,100,3,4,72.0,2.0,72.0,1789
14317,39,48,87,3,5,72.0,2.0,72.0,1789
14318,30,24,54,3,6,72.0,2.0,72.0,1789
14319,42,16,58,3,7,72.0,2.0,72.0,1789
14320,-9,9,0,1,0,73.0,2.0,73.0,1790
14321,12,8,20,1,1,73.0,2.0,73.0,1790
14322,-10,14,4,2,2,73.0,2.0,73.0,1790
14323,-8,8,0,2,3,73.0,2.0,73.0,1790
14324,-19,19,0,3,4,73.0,2.0,73.0,1790
14325,-9,14,5,3,5,73.0,2.0,73.0,1790
14326,-1,1,0,3,6,73.0,2.0,73.0,1790
14327,-34,34,0,3,7,73.0,2.0,73.0,1790
14328,-2,77,75,1,0,73.0,2.0,73.0,1791
14329,8,75,83,1,1,73.0,2.0,73.0,1791
14330,9,67,76,2,2,73.0,2.0,73.0,1791
14331,-2,72,70,2,3,73.0,2.0,73.0,1791
14332,3,66,69,3,4,73.0,2.0,73.0,1791
14333,-1,71,70,3,5,73.0,2.0,73.0,1791
14334,0,70,70,3,6,73.0,2.0,73.0,1791
14335,2,68,70,3,7,73.0,2.0,73.0,1791
14336,-1,28,27,1,0,73.0,2.0,73.0,1792
14337,16,78,94,1,1,73.0,2.0,73.0,1792
14338,-42,76,34,2,2,73.0,2.0,73.0,1792
14339,45,27,72,2,3,73.0,2.0,73.0,1792
14340,11,77,88,3,4,73.0,2.0,73.0,1792
14341,-1,80,79,3,5,73.0,2.0,73.0,1792
14342,2,97,99,3,6,73.0,2.0,73.0,1792
14343,-3,79,76,3,7,73.0,2.0,73.0,1792
14344,-1,32,31,1,0,73.0,2.0,73.0,1793
14345,1,26,27,1,1,73.0,2.0,73.0,1793
14346,-10,76,66,2,2,73.0,2.0,73.0,1793
14347,-1,29,28,2,3,73.0,2.0,73.0,1793
14348,-8,75,67,3,4,73.0,2.0,73.0,1793
14349,-3,67,64,3,5,73.0,2.0,73.0,1793
14350,3,32,35,3,6,73.0,2.0,73.0,1793
14351,9,26,35,3,7,73.0,2.0,73.0,1793
14352,1,2,3,1,0,73.0,2.0,73.0,1794
14353,4,1,5,1,1,73.0,2.0,73.0,1794
14354,34,59,93,2,2,73.0,2.0,73.0,1794
14355,-2,99,97,2,3,73.0,2.0,73.0,1794
14356,3,58,61,3,4,73.0,2.0,73.0,1794
14357,79,8,87,3,5,73.0,2.0,73.0,1794
14358,0,100,100,3,6,73.0,2.0,73.0,1794
14359,5,0,5,3,7,73.0,2.0,73.0,1794
14360,0,0,0,1,0,73.0,2.0,73.0,1795
14361,0,0,0,1,1,73.0,2.0,73.0,1795
14362,100,0,100,2,2,73.0,2.0,73.0,1795
14363,0,100,100,2,3,73.0,2.0,73.0,1795
14364,60,40,100,3,4,73.0,2.0,73.0,1795
14365,-15,15,0,3,5,73.0,2.0,73.0,1795
14366,2,0,2,3,6,73.0,2.0,73.0,1795
14367,0,0,0,3,7,73.0,2.0,73.0,1795
14368,20,64,84,1,0,73.0,2.0,73.0,1796
14369,-9,97,88,1,1,73.0,2.0,73.0,1796
14370,63,25,88,2,2,73.0,2.0,73.0,1796
14371,66,22,88,2,3,73.0,2.0,73.0,1796
14372,36,64,100,3,4,73.0,2.0,73.0,1796
14373,38,50,88,3,5,73.0,2.0,73.0,1796
14374,54,42,96,3,6,73.0,2.0,73.0,1796
14375,11,38,49,3,7,73.0,2.0,73.0,1796
14376,-9,100,91,1,0,73.0,2.0,73.0,1797
14377,11,39,50,1,1,73.0,2.0,73.0,1797
14378,-13,80,67,2,2,73.0,2.0,73.0,1797
14379,29,50,79,2,3,73.0,2.0,73.0,1797
14380,1,87,88,3,4,73.0,2.0,73.0,1797
14381,0,50,50,3,5,73.0,2.0,73.0,1797
14382,0,100,100,3,6,73.0,2.0,73.0,1797
14383,-17,40,23,3,7,73.0,2.0,73.0,1797
14384,38,46,84,1,0,73.0,2.0,73.0,1798
14385,-6,61,55,1,1,73.0,2.0,73.0,1798
14386,47,40,87,2,2,73.0,2.0,73.0,1798
14387,-18,60,42,2,3,73.0,2.0,73.0,1798
14388,61,22,83,3,4,73.0,2.0,73.0,1798
14389,11,51,62,3,5,73.0,2.0,73.0,1798
14390,-19,56,37,3,6,73.0,2.0,73.0,1798
14391,28,17,45,3,7,73.0,2.0,73.0,1798
14392,23,0,23,1,0,73.0,2.0,73.0,1799
14393,0,0,0,1,1,73.0,2.0,73.0,1799
14394,-2,65,63,2,2,73.0,2.0,73.0,1799
14395,0,100,100,2,3,73.0,2.0,73.0,1799
14396,10,87,97,3,4,73.0,2.0,73.0,1799
14397,24,0,24,3,5,73.0,2.0,73.0,1799
14398,0,0,0,3,6,73.0,2.0,73.0,1799
14399,0,0,0,3,7,73.0,2.0,73.0,1799
14400,-97,97,0,1,0,73.0,2.0,73.0,1800
14401,0,100,100,1,1,73.0,2.0,73.0,1800
14402,0,100,100,2,2,73.0,2.0,73.0,1800
14403,0,100,100,2,3,73.0,2.0,73.0,1800
14404,-22,22,0,3,4,73.0,2.0,73.0,1800
14405,41,59,100,3,5,73.0,2.0,73.0,1800
14406,-2,2,0,3,6,73.0,2.0,73.0,1800
14407,-1,1,0,3,7,73.0,2.0,73.0,1800
14408,54,29,83,1,0,73.0,2.0,73.0,1801
14409,-36,57,21,1,1,73.0,2.0,73.0,1801
14410,20,63,83,2,2,73.0,2.0,73.0,1801
14411,4,82,86,2,3,73.0,2.0,73.0,1801
14412,15,71,86,3,4,73.0,2.0,73.0,1801
14413,47,37,84,3,5,73.0,2.0,73.0,1801
14414,21,63,84,3,6,73.0,2.0,73.0,1801
14415,51,30,81,3,7,73.0,2.0,73.0,1801
14416,11,0,11,1,0,73.0,2.0,73.0,1802
14417,17,34,51,1,1,73.0,2.0,73.0,1802
14418,-1,65,64,2,2,73.0,2.0,73.0,1802
14419,0,100,100,2,3,73.0,2.0,73.0,1802
14420,1,0,1,3,4,73.0,2.0,73.0,1802
14421,34,0,34,3,5,73.0,2.0,73.0,1802
14422,-31,67,36,3,6,73.0,2.0,73.0,1802
14423,12,0,12,3,7,73.0,2.0,73.0,1802
14424,18,37,55,1,0,73.0,2.0,73.0,1803
14425,0,38,38,1,1,73.0,2.0,73.0,1803
14426,-3,76,73,2,2,73.0,2.0,73.0,1803
14427,8,86,94,2,3,73.0,2.0,73.0,1803
14428,13,63,76,3,4,73.0,2.0,73.0,1803
14429,26,38,64,3,5,73.0,2.0,73.0,1803
14430,50,24,74,3,6,73.0,2.0,73.0,1803
14431,13,11,24,3,7,73.0,2.0,73.0,1803
14432,44,56,100,1,0,73.0,2.0,73.0,1804
14433,0,0,0,1,1,73.0,2.0,73.0,1804
14434,46,54,100,2,2,73.0,2.0,73.0,1804
14435,74,26,100,2,3,73.0,2.0,73.0,1804
14436,100,0,100,3,4,73.0,2.0,73.0,1804
14437,100,0,100,3,5,73.0,2.0,73.0,1804
14438,0,100,100,3,6,73.0,2.0,73.0,1804
14439,100,0,100,3,7,73.0,2.0,73.0,1804
14440,40,50,90,1,0,74.0,2.0,74.0,1805
14441,16,11,27,1,1,74.0,2.0,74.0,1805
14442,50,50,100,2,2,74.0,2.0,74.0,1805
14443,50,50,100,2,3,74.0,2.0,74.0,1805
14444,31,69,100,3,4,74.0,2.0,74.0,1805
14445,50,50,100,3,5,74.0,2.0,74.0,1805
14446,50,50,100,3,6,74.0,2.0,74.0,1805
14447,77,23,100,3,7,74.0,2.0,74.0,1805
14448,2,8,10,1,0,74.0,2.0,74.0,1806
14449,28,22,50,1,1,74.0,2.0,74.0,1806
14450,31,49,80,2,2,74.0,2.0,74.0,1806
14451,10,72,82,2,3,74.0,2.0,74.0,1806
14452,14,67,81,3,4,74.0,2.0,74.0,1806
14453,-4,22,18,3,5,74.0,2.0,74.0,1806
14454,2,75,77,3,6,74.0,2.0,74.0,1806
14455,-4,15,11,3,7,74.0,2.0,74.0,1806
14456,0,0,0,1,0,74.0,2.0,74.0,1807
14457,0,0,0,1,1,74.0,2.0,74.0,1807
14458,0,50,50,2,2,74.0,2.0,74.0,1807
14459,24,76,100,2,3,74.0,2.0,74.0,1807
14460,5,95,100,3,4,74.0,2.0,74.0,1807
14461,25,25,50,3,5,74.0,2.0,74.0,1807
14462,0,100,100,3,6,74.0,2.0,74.0,1807
14463,23,0,23,3,7,74.0,2.0,74.0,1807
14464,43,35,78,1,0,74.0,2.0,74.0,1808
14465,6,80,86,1,1,74.0,2.0,74.0,1808
14466,-8,34,26,2,2,74.0,2.0,74.0,1808
14467,-41,77,36,2,3,74.0,2.0,74.0,1808
14468,0,100,100,3,4,74.0,2.0,74.0,1808
14469,-3,31,28,3,5,74.0,2.0,74.0,1808
14470,38,39,77,3,6,74.0,2.0,74.0,1808
14471,15,80,95,3,7,74.0,2.0,74.0,1808
14472,-12,70,58,1,0,74.0,2.0,74.0,1809
14473,7,50,57,1,1,74.0,2.0,74.0,1809
14474,5,50,55,2,2,74.0,2.0,74.0,1809
14475,8,50,58,2,3,74.0,2.0,74.0,1809
14476,25,25,50,3,4,74.0,2.0,74.0,1809
14477,6,50,56,3,5,74.0,2.0,74.0,1809
14478,-17,75,58,3,6,74.0,2.0,74.0,1809
14479,7,50,57,3,7,74.0,2.0,74.0,1809
14480,50,0,50,1,0,74.0,2.0,74.0,1810
14481,16,72,88,1,1,74.0,2.0,74.0,1810
14482,59,41,100,2,2,74.0,2.0,74.0,1810
14483,23,64,87,2,3,74.0,2.0,74.0,1810
14484,-15,65,50,3,4,74.0,2.0,74.0,1810
14485,75,25,100,3,5,74.0,2.0,74.0,1810
14486,0,50,50,3,6,74.0,2.0,74.0,1810
14487,2,18,20,3,7,74.0,2.0,74.0,1810
14488,68,13,81,1,0,74.0,2.0,74.0,1811
14489,1,15,16,1,1,74.0,2.0,74.0,1811
14490,0,88,88,2,2,74.0,2.0,74.0,1811
14491,11,89,100,2,3,74.0,2.0,74.0,1811
14492,65,25,90,3,4,74.0,2.0,74.0,1811
14493,39,50,89,3,5,74.0,2.0,74.0,1811
14494,74,12,86,3,6,74.0,2.0,74.0,1811
14495,60,20,80,3,7,74.0,2.0,74.0,1811
14496,46,25,71,1,0,74.0,2.0,74.0,1812
14497,-5,75,70,1,1,74.0,2.0,74.0,1812
14498,0,63,63,2,2,74.0,2.0,74.0,1812
14499,-11,77,66,2,3,74.0,2.0,74.0,1812
14500,-30,69,39,3,4,74.0,2.0,74.0,1812
14501,35,31,66,3,5,74.0,2.0,74.0,1812
14502,-6,77,71,3,6,74.0,2.0,74.0,1812
14503,12,24,36,3,7,74.0,2.0,74.0,1812
14504,5,45,50,1,0,74.0,2.0,74.0,1813
14505,-9,50,41,1,1,74.0,2.0,74.0,1813
14506,9,50,59,2,2,74.0,2.0,74.0,1813
14507,9,50,59,2,3,74.0,2.0,74.0,1813
14508,0,50,50,3,4,74.0,2.0,74.0,1813
14509,8,50,58,3,5,74.0,2.0,74.0,1813
14510,3,50,53,3,6,74.0,2.0,74.0,1813
14511,29,35,64,3,7,74.0,2.0,74.0,1813
14512,-18,50,32,1,0,74.0,2.0,74.0,1814
14513,10,54,64,1,1,74.0,2.0,74.0,1814
14514,47,52,99,2,2,74.0,2.0,74.0,1814
14515,22,77,99,2,3,74.0,2.0,74.0,1814
14516,23,53,76,3,4,74.0,2.0,74.0,1814
14517,22,43,65,3,5,74.0,2.0,74.0,1814
14518,8,80,88,3,6,74.0,2.0,74.0,1814
14519,18,10,28,3,7,74.0,2.0,74.0,1814
14520,72,0,72,1,0,74.0,2.0,74.0,1815
14521,29,6,35,1,1,74.0,2.0,74.0,1815
14522,-5,100,95,2,2,74.0,2.0,74.0,1815
14523,16,76,92,2,3,74.0,2.0,74.0,1815
14524,11,65,76,3,4,74.0,2.0,74.0,1815
14525,16,60,76,3,5,74.0,2.0,74.0,1815
14526,20,74,94,3,6,74.0,2.0,74.0,1815
14527,8,92,100,3,7,74.0,2.0,74.0,1815
14528,70,2,72,1,0,74.0,2.0,74.0,1816
14529,48,24,72,1,1,74.0,2.0,74.0,1816
14530,8,68,76,2,2,74.0,2.0,74.0,1816
14531,27,73,100,2,3,74.0,2.0,74.0,1816
14532,24,63,87,3,4,74.0,2.0,74.0,1816
14533,41,53,94,3,5,74.0,2.0,74.0,1816
14534,30,65,95,3,6,74.0,2.0,74.0,1816
14535,68,5,73,3,7,74.0,2.0,74.0,1816
14536,14,74,88,1,0,74.0,2.0,74.0,1817
14537,-41,67,26,1,1,74.0,2.0,74.0,1817
14538,-16,83,67,2,2,74.0,2.0,74.0,1817
14539,-2,66,64,2,3,74.0,2.0,74.0,1817
14540,24,50,74,3,4,74.0,2.0,74.0,1817
14541,-80,80,0,3,5,74.0,2.0,74.0,1817
14542,4,0,4,3,6,74.0,2.0,74.0,1817
14543,0,0,0,3,7,74.0,2.0,74.0,1817
14544,72,28,100,1,0,75.0,2.0,75.0,1818
14545,70,30,100,1,1,75.0,2.0,75.0,1818
14546,46,54,100,2,2,75.0,2.0,75.0,1818
14547,0,100,100,2,3,75.0,2.0,75.0,1818
14548,29,71,100,3,4,75.0,2.0,75.0,1818
14549,62,38,100,3,5,75.0,2.0,75.0,1818
14550,64,36,100,3,6,75.0,2.0,75.0,1818
14551,100,0,100,3,7,75.0,2.0,75.0,1818
14552,100,0,100,1,0,75.0,2.0,75.0,1819
14553,0,0,0,1,1,75.0,2.0,75.0,1819
14554,0,50,50,2,2,75.0,2.0,75.0,1819
14555,-21,100,79,2,3,75.0,2.0,75.0,1819
14556,50,50,100,3,4,75.0,2.0,75.0,1819
14557,0,50,50,3,5,75.0,2.0,75.0,1819
14558,100,0,100,3,6,75.0,2.0,75.0,1819
14559,0,0,0,3,7,75.0,2.0,75.0,1819
14560,-9,36,27,1,0,75.0,2.0,75.0,1820
14561,2,18,20,1,1,75.0,2.0,75.0,1820
14562,3,68,71,2,2,75.0,2.0,75.0,1820
14563,68,9,77,2,3,75.0,2.0,75.0,1820
14564,3,75,78,3,4,75.0,2.0,75.0,1820
14565,15,50,65,3,5,75.0,2.0,75.0,1820
14566,4,20,24,3,6,75.0,2.0,75.0,1820
14567,15,50,65,3,7,75.0,2.0,75.0,1820
14568,100,0,100,1,0,75.0,2.0,75.0,1821
14569,100,0,100,1,1,75.0,2.0,75.0,1821
14570,19,81,100,2,2,75.0,2.0,75.0,1821
14571,0,100,100,2,3,75.0,2.0,75.0,1821
14572,50,50,100,3,4,75.0,2.0,75.0,1821
14573,50,50,100,3,5,75.0,2.0,75.0,1821
14574,100,0,100,3,6,75.0,2.0,75.0,1821
14575,66,34,100,3,7,75.0,2.0,75.0,1821
14576,0,100,100,1,0,75.0,2.0,75.0,1822
14577,0,100,100,1,1,75.0,2.0,75.0,1822
14578,0,100,100,2,2,75.0,2.0,75.0,1822
14579,50,50,100,2,3,75.0,2.0,75.0,1822
14580,100,0,100,3,4,75.0,2.0,75.0,1822
14581,100,0,100,3,5,75.0,2.0,75.0,1822
14582,0,100,100,3,6,75.0,2.0,75.0,1822
14583,77,23,100,3,7,75.0,2.0,75.0,1822
14584,56,44,100,1,0,75.0,2.0,75.0,1823
14585,22,78,100,1,1,75.0,2.0,75.0,1823
14586,100,0,100,2,2,75.0,2.0,75.0,1823
14587,30,70,100,2,3,75.0,2.0,75.0,1823
14588,0,100,100,3,4,75.0,2.0,75.0,1823
14589,87,13,100,3,5,75.0,2.0,75.0,1823
14590,70,30,100,3,6,75.0,2.0,75.0,1823
14591,100,0,100,3,7,75.0,2.0,75.0,1823
14592,55,5,60,1,0,75.0,2.0,75.0,1824
14593,50,0,50,1,1,75.0,2.0,75.0,1824
14594,10,90,100,2,2,75.0,2.0,75.0,1824
14595,0,100,100,2,3,75.0,2.0,75.0,1824
14596,20,55,75,3,4,75.0,2.0,75.0,1824
14597,50,50,100,3,5,75.0,2.0,75.0,1824
14598,10,90,100,3,6,75.0,2.0,75.0,1824
14599,92,8,100,3,7,75.0,2.0,75.0,1824
14600,57,0,57,1,0,75.0,2.0,75.0,1825
14601,29,37,66,1,1,75.0,2.0,75.0,1825
14602,17,50,67,2,2,75.0,2.0,75.0,1825
14603,-29,100,71,2,3,75.0,2.0,75.0,1825
14604,-12,77,65,3,4,75.0,2.0,75.0,1825
14605,37,0,37,3,5,75.0,2.0,75.0,1825
14606,9,25,34,3,6,75.0,2.0,75.0,1825
14607,20,24,44,3,7,75.0,2.0,75.0,1825
14608,13,37,50,1,0,75.0,2.0,75.0,1826
14609,23,0,23,1,1,75.0,2.0,75.0,1826
14610,38,62,100,2,2,75.0,2.0,75.0,1826
14611,0,100,100,2,3,75.0,2.0,75.0,1826
14612,50,50,100,3,4,75.0,2.0,75.0,1826
14613,50,50,100,3,5,75.0,2.0,75.0,1826
14614,50,50,100,3,6,75.0,2.0,75.0,1826
14615,76,0,76,3,7,75.0,2.0,75.0,1826
14616,100,0,100,1,0,75.0,2.0,75.0,1827
14617,79,21,100,1,1,75.0,2.0,75.0,1827
14618,100,0,100,2,2,75.0,2.0,75.0,1827
14619,-82,82,0,2,3,75.0,2.0,75.0,1827
14620,0,100,100,3,4,75.0,2.0,75.0,1827
14621,-31,31,0,3,5,75.0,2.0,75.0,1827
14622,0,100,100,3,6,75.0,2.0,75.0,1827
14623,100,0,100,3,7,75.0,2.0,75.0,1827
14624,64,21,85,1,0,75.0,2.0,75.0,1828
14625,100,0,100,1,1,75.0,2.0,75.0,1828
14626,89,1,90,2,2,75.0,2.0,75.0,1828
14627,93,0,93,2,3,75.0,2.0,75.0,1828
14628,21,66,87,3,4,75.0,2.0,75.0,1828
14629,50,43,93,3,5,75.0,2.0,75.0,1828
14630,-22,33,11,3,6,75.0,2.0,75.0,1828
14631,89,0,89,3,7,75.0,2.0,75.0,1828
14632,41,41,82,1,0,75.0,2.0,75.0,1829
14633,13,49,62,1,1,75.0,2.0,75.0,1829
14634,32,44,76,2,2,75.0,2.0,75.0,1829
14635,17,58,75,2,3,75.0,2.0,75.0,1829
14636,15,46,61,3,4,75.0,2.0,75.0,1829
14637,19,40,59,3,5,75.0,2.0,75.0,1829
14638,-1,62,61,3,6,75.0,2.0,75.0,1829
14639,21,38,59,3,7,75.0,2.0,75.0,1829
14640,5,70,75,1,0,75.0,2.0,75.0,1830
14641,0,100,100,1,1,75.0,2.0,75.0,1830
14642,15,60,75,2,2,75.0,2.0,75.0,1830
14643,5,70,75,2,3,75.0,2.0,75.0,1830
14644,15,40,55,3,4,75.0,2.0,75.0,1830
14645,25,50,75,3,5,75.0,2.0,75.0,1830
14646,25,50,75,3,6,75.0,2.0,75.0,1830
14647,-20,55,35,3,7,75.0,2.0,75.0,1830
14648,36,20,56,1,0,75.0,2.0,75.0,1831
14649,15,25,40,1,1,75.0,2.0,75.0,1831
14650,36,50,86,2,2,75.0,2.0,75.0,1831
14651,12,81,93,2,3,75.0,2.0,75.0,1831
14652,3,50,53,3,4,75.0,2.0,75.0,1831
14653,41,20,61,3,5,75.0,2.0,75.0,1831
14654,16,34,50,3,6,75.0,2.0,75.0,1831
14655,31,29,60,3,7,75.0,2.0,75.0,1831
14656,50,50,100,1,0,75.0,2.0,75.0,1832
14657,85,15,100,1,1,75.0,2.0,75.0,1832
14658,50,50,100,2,2,75.0,2.0,75.0,1832
14659,59,41,100,2,3,75.0,2.0,75.0,1832
14660,37,63,100,3,4,75.0,2.0,75.0,1832
14661,50,50,100,3,5,75.0,2.0,75.0,1832
14662,87,13,100,3,6,75.0,2.0,75.0,1832
14663,72,28,100,3,7,75.0,2.0,75.0,1832
14664,-25,50,25,1,0,75.0,2.0,75.0,1833
14665,0,50,50,1,1,75.0,2.0,75.0,1833
14666,0,75,75,2,2,75.0,2.0,75.0,1833
14667,0,25,25,2,3,75.0,2.0,75.0,1833
14668,-25,50,25,3,4,75.0,2.0,75.0,1833
14669,0,50,50,3,5,75.0,2.0,75.0,1833
14670,26,49,75,3,6,75.0,2.0,75.0,1833
14671,50,0,50,3,7,75.0,2.0,75.0,1833
14672,13,11,24,1,0,75.0,2.0,75.0,1834
14673,4,96,100,1,1,75.0,2.0,75.0,1834
14674,42,39,81,2,2,75.0,2.0,75.0,1834
14675,-23,100,77,2,3,75.0,2.0,75.0,1834
14676,-7,81,74,3,4,75.0,2.0,75.0,1834
14677,-6,100,94,3,5,75.0,2.0,75.0,1834
14678,-6,36,30,3,6,75.0,2.0,75.0,1834
14679,-9,38,29,3,7,75.0,2.0,75.0,1834
14680,25,25,50,1,0,75.0,2.0,75.0,1835
14681,70,5,75,1,1,75.0,2.0,75.0,1835
14682,35,60,95,2,2,75.0,2.0,75.0,1835
14683,0,100,100,2,3,75.0,2.0,75.0,1835
14684,25,50,75,3,4,75.0,2.0,75.0,1835
14685,40,50,90,3,5,75.0,2.0,75.0,1835
14686,50,50,100,3,6,75.0,2.0,75.0,1835
14687,45,10,55,3,7,75.0,2.0,75.0,1835
14688,1,77,78,1,0,75.0,2.0,75.0,1836
14689,9,66,75,1,1,75.0,2.0,75.0,1836
14690,-22,100,78,2,2,75.0,2.0,75.0,1836
14691,-15,100,85,2,3,75.0,2.0,75.0,1836
14692,20,0,20,3,4,75.0,2.0,75.0,1836
14693,0,0,0,3,5,75.0,2.0,75.0,1836
14694,-33,98,65,3,6,75.0,2.0,75.0,1836
14695,36,34,70,3,7,75.0,2.0,75.0,1836
14696,-2,64,62,1,0,75.0,2.0,75.0,1837
14697,-5,45,40,1,1,75.0,2.0,75.0,1837
14698,5,81,86,2,2,75.0,2.0,75.0,1837
14699,13,38,51,2,3,75.0,2.0,75.0,1837
14700,0,50,50,3,4,75.0,2.0,75.0,1837
14701,0,50,50,3,5,75.0,2.0,75.0,1837
14702,7,55,62,3,6,75.0,2.0,75.0,1837
14703,-11,11,0,3,7,75.0,2.0,75.0,1837
14704,100,0,100,1,0,75.0,2.0,75.0,1838
14705,-75,75,0,1,1,75.0,2.0,75.0,1838
14706,75,25,100,2,2,75.0,2.0,75.0,1838
14707,0,100,100,2,3,75.0,2.0,75.0,1838
14708,15,85,100,3,4,75.0,2.0,75.0,1838
14709,90,10,100,3,5,75.0,2.0,75.0,1838
14710,50,50,100,3,6,75.0,2.0,75.0,1838
14711,0,0,0,3,7,75.0,2.0,75.0,1838
14712,75,10,85,1,0,75.0,2.0,75.0,1839
14713,37,53,90,1,1,75.0,2.0,75.0,1839
14714,7,79,86,2,2,75.0,2.0,75.0,1839
14715,4,85,89,2,3,75.0,2.0,75.0,1839
14716,48,36,84,3,4,75.0,2.0,75.0,1839
14717,57,27,84,3,5,75.0,2.0,75.0,1839
14718,8,79,87,3,6,75.0,2.0,75.0,1839
14719,76,20,96,3,7,75.0,2.0,75.0,1839
14720,53,0,53,1,0,75.0,2.0,75.0,1840
14721,50,0,50,1,1,75.0,2.0,75.0,1840
14722,7,77,84,2,2,75.0,2.0,75.0,1840
14723,13,75,88,2,3,75.0,2.0,75.0,1840
14724,4,90,94,3,4,75.0,2.0,75.0,1840
14725,66,0,66,3,5,75.0,2.0,75.0,1840
14726,50,50,100,3,6,75.0,2.0,75.0,1840
14727,62,0,62,3,7,75.0,2.0,75.0,1840
14728,90,5,95,1,0,75.0,2.0,75.0,1841
14729,50,35,85,1,1,75.0,2.0,75.0,1841
14730,70,30,100,2,2,75.0,2.0,75.0,1841
14731,95,5,100,2,3,75.0,2.0,75.0,1841
14732,45,50,95,3,4,75.0,2.0,75.0,1841
14733,50,50,100,3,5,75.0,2.0,75.0,1841
14734,50,45,95,3,6,75.0,2.0,75.0,1841
14735,90,5,95,3,7,75.0,2.0,75.0,1841
14736,4,46,50,1,0,75.0,2.0,75.0,1842
14737,9,75,84,1,1,75.0,2.0,75.0,1842
14738,-3,100,97,2,2,75.0,2.0,75.0,1842
14739,-15,95,80,2,3,75.0,2.0,75.0,1842
14740,9,75,84,3,4,75.0,2.0,75.0,1842
14741,10,70,80,3,5,75.0,2.0,75.0,1842
14742,37,40,77,3,6,75.0,2.0,75.0,1842
14743,15,25,40,3,7,75.0,2.0,75.0,1842
14744,27,3,30,1,0,75.0,2.0,75.0,1843
14745,0,90,90,1,1,75.0,2.0,75.0,1843
14746,10,90,100,2,2,75.0,2.0,75.0,1843
14747,0,100,100,2,3,75.0,2.0,75.0,1843
14748,0,75,75,3,4,75.0,2.0,75.0,1843
14749,0,0,0,3,5,75.0,2.0,75.0,1843
14750,0,100,100,3,6,75.0,2.0,75.0,1843
14751,5,5,10,3,7,75.0,2.0,75.0,1843
14752,31,10,41,1,0,75.0,2.0,75.0,1844
14753,2,95,97,1,1,75.0,2.0,75.0,1844
14754,17,77,94,2,2,75.0,2.0,75.0,1844
14755,11,89,100,2,3,75.0,2.0,75.0,1844
14756,20,69,89,3,4,75.0,2.0,75.0,1844
14757,46,50,96,3,5,75.0,2.0,75.0,1844
14758,28,72,100,3,6,75.0,2.0,75.0,1844
14759,32,59,91,3,7,75.0,2.0,75.0,1844
14760,98,0,98,1,0,75.0,2.0,75.0,1845
14761,87,11,98,1,1,75.0,2.0,75.0,1845
14762,96,4,100,2,2,75.0,2.0,75.0,1845
14763,73,23,96,2,3,75.0,2.0,75.0,1845
14764,61,37,98,3,4,75.0,2.0,75.0,1845
14765,100,0,100,3,5,75.0,2.0,75.0,1845
14766,-14,16,2,3,6,75.0,2.0,75.0,1845
14767,96,0,96,3,7,75.0,2.0,75.0,1845
14768,100,0,100,1,0,75.0,2.0,75.0,1846
14769,100,0,100,1,1,75.0,2.0,75.0,1846
14770,0,100,100,2,2,75.0,2.0,75.0,1846
14771,0,100,100,2,3,75.0,2.0,75.0,1846
14772,0,100,100,3,4,75.0,2.0,75.0,1846
14773,50,0,50,3,5,75.0,2.0,75.0,1846
14774,100,0,100,3,6,75.0,2.0,75.0,1846
14775,0,100,100,3,7,75.0,2.0,75.0,1846
14776,25,0,25,1,0,75.0,2.0,75.0,1847
14777,0,0,0,1,1,75.0,2.0,75.0,1847
14778,0,100,100,2,2,75.0,2.0,75.0,1847
14779,0,100,100,2,3,75.0,2.0,75.0,1847
14780,25,50,75,3,4,75.0,2.0,75.0,1847
14781,50,25,75,3,5,75.0,2.0,75.0,1847
14782,0,50,50,3,6,75.0,2.0,75.0,1847
14783,5,70,75,3,7,75.0,2.0,75.0,1847
14784,52,0,52,1,0,75.0,2.0,75.0,1848
14785,49,0,49,1,1,75.0,2.0,75.0,1848
14786,0,100,100,2,2,75.0,2.0,75.0,1848
14787,1,99,100,2,3,75.0,2.0,75.0,1848
14788,79,2,81,3,4,75.0,2.0,75.0,1848
14789,59,40,99,3,5,75.0,2.0,75.0,1848
14790,50,50,100,3,6,75.0,2.0,75.0,1848
14791,39,3,42,3,7,75.0,2.0,75.0,1848
14792,-6,50,44,1,0,75.0,2.0,75.0,1849
14793,6,44,50,1,1,75.0,2.0,75.0,1849
14794,-9,61,52,2,2,75.0,2.0,75.0,1849
14795,16,44,60,2,3,75.0,2.0,75.0,1849
14796,1,41,42,3,4,75.0,2.0,75.0,1849
14797,7,59,66,3,5,75.0,2.0,75.0,1849
14798,-15,46,31,3,6,75.0,2.0,75.0,1849
14799,-12,50,38,3,7,75.0,2.0,75.0,1849
14800,51,31,82,1,0,75.0,2.0,75.0,1850
14801,46,37,83,1,1,75.0,2.0,75.0,1850
14802,31,50,81,2,2,75.0,2.0,75.0,1850
14803,8,76,84,2,3,75.0,2.0,75.0,1850
14804,8,76,84,3,4,75.0,2.0,75.0,1850
14805,31,50,81,3,5,75.0,2.0,75.0,1850
14806,79,5,84,3,6,75.0,2.0,75.0,1850
14807,67,12,79,3,7,75.0,2.0,75.0,1850
14808,13,53,66,1,0,76.0,2.0,76.0,1851
14809,29,5,34,1,1,76.0,2.0,76.0,1851
14810,4,70,74,2,2,76.0,2.0,76.0,1851
14811,15,50,65,2,3,76.0,2.0,76.0,1851
14812,25,36,61,3,4,76.0,2.0,76.0,1851
14813,41,25,66,3,5,76.0,2.0,76.0,1851
14814,10,0,10,3,6,76.0,2.0,76.0,1851
14815,21,3,24,3,7,76.0,2.0,76.0,1851
14816,4,78,82,1,0,76.0,2.0,76.0,1852
14817,31,69,100,1,1,76.0,2.0,76.0,1852
14818,0,82,82,2,2,76.0,2.0,76.0,1852
14819,6,90,96,2,3,76.0,2.0,76.0,1852
14820,-7,100,93,3,4,76.0,2.0,76.0,1852
14821,11,76,87,3,5,76.0,2.0,76.0,1852
14822,-4,80,76,3,6,76.0,2.0,76.0,1852
14823,6,75,81,3,7,76.0,2.0,76.0,1852
14824,5,63,68,1,0,76.0,2.0,76.0,1853
14825,-10,36,26,1,1,76.0,2.0,76.0,1853
14826,3,73,76,2,2,76.0,2.0,76.0,1853
14827,4,70,74,2,3,76.0,2.0,76.0,1853
14828,-7,71,64,3,4,76.0,2.0,76.0,1853
14829,-5,78,73,3,5,76.0,2.0,76.0,1853
14830,1,35,36,3,6,76.0,2.0,76.0,1853
14831,-15,26,11,3,7,76.0,2.0,76.0,1853
14832,0,100,100,1,0,76.0,2.0,76.0,1854
14833,0,100,100,1,1,76.0,2.0,76.0,1854
14834,0,100,100,2,2,76.0,2.0,76.0,1854
14835,0,100,100,2,3,76.0,2.0,76.0,1854
14836,0,100,100,3,4,76.0,2.0,76.0,1854
14837,0,100,100,3,5,76.0,2.0,76.0,1854
14838,0,100,100,3,6,76.0,2.0,76.0,1854
14839,0,100,100,3,7,76.0,2.0,76.0,1854
14840,0,0,0,1,0,76.0,2.0,76.0,1855
14841,3,10,13,1,1,76.0,2.0,76.0,1855
14842,33,52,85,2,2,76.0,2.0,76.0,1855
14843,8,0,8,2,3,76.0,2.0,76.0,1855
14844,1,89,90,3,4,76.0,2.0,76.0,1855
14845,19,64,83,3,5,76.0,2.0,76.0,1855
14846,34,51,85,3,6,76.0,2.0,76.0,1855
14847,28,22,50,3,7,76.0,2.0,76.0,1855
14848,0,60,60,1,0,76.0,2.0,76.0,1856
14849,28,60,88,1,1,76.0,2.0,76.0,1856
14850,5,59,64,2,2,76.0,2.0,76.0,1856
14851,2,58,60,2,3,76.0,2.0,76.0,1856
14852,9,58,67,3,4,76.0,2.0,76.0,1856
14853,48,44,92,3,5,76.0,2.0,76.0,1856
14854,-27,63,36,3,6,76.0,2.0,76.0,1856
14855,8,56,64,3,7,76.0,2.0,76.0,1856
14856,15,10,25,1,0,76.0,2.0,76.0,1857
14857,38,0,38,1,1,76.0,2.0,76.0,1857
14858,6,70,76,2,2,76.0,2.0,76.0,1857
14859,-21,100,79,2,3,76.0,2.0,76.0,1857
14860,9,89,98,3,4,76.0,2.0,76.0,1857
14861,83,6,89,3,5,76.0,2.0,76.0,1857
14862,-64,100,36,3,6,76.0,2.0,76.0,1857
14863,74,1,75,3,7,76.0,2.0,76.0,1857
14864,3,12,15,1,0,76.0,2.0,76.0,1858
14865,30,22,52,1,1,76.0,2.0,76.0,1858
14866,-8,70,62,2,2,76.0,2.0,76.0,1858
14867,-20,99,79,2,3,76.0,2.0,76.0,1858
14868,-4,64,60,3,4,76.0,2.0,76.0,1858
14869,-3,51,48,3,5,76.0,2.0,76.0,1858
14870,8,44,52,3,6,76.0,2.0,76.0,1858
14871,1,37,38,3,7,76.0,2.0,76.0,1858
14872,-18,41,23,1,0,76.0,2.0,76.0,1859
14873,33,63,96,1,1,76.0,2.0,76.0,1859
14874,61,36,97,2,2,76.0,2.0,76.0,1859
14875,65,28,93,2,3,76.0,2.0,76.0,1859
14876,59,41,100,3,4,76.0,2.0,76.0,1859
14877,25,70,95,3,5,76.0,2.0,76.0,1859
14878,69,31,100,3,6,76.0,2.0,76.0,1859
14879,77,23,100,3,7,76.0,2.0,76.0,1859
14880,-18,26,8,1,0,76.0,2.0,76.0,1860
14881,-14,29,15,1,1,76.0,2.0,76.0,1860
14882,48,23,71,2,2,76.0,2.0,76.0,1860
14883,57,33,90,2,3,76.0,2.0,76.0,1860
14884,28,72,100,3,4,76.0,2.0,76.0,1860
14885,82,16,98,3,5,76.0,2.0,76.0,1860
14886,68,20,88,3,6,76.0,2.0,76.0,1860
14887,79,4,83,3,7,76.0,2.0,76.0,1860
14888,-16,79,63,1,0,76.0,2.0,76.0,1861
14889,-23,83,60,1,1,76.0,2.0,76.0,1861
14890,-11,75,64,2,2,76.0,2.0,76.0,1861
14891,26,50,76,2,3,76.0,2.0,76.0,1861
14892,-5,85,80,3,4,76.0,2.0,76.0,1861
14893,-29,79,50,3,5,76.0,2.0,76.0,1861
14894,2,66,68,3,6,76.0,2.0,76.0,1861
14895,-16,88,72,3,7,76.0,2.0,76.0,1861
14896,0,0,0,1,0,76.0,2.0,76.0,1862
14897,0,0,0,1,1,76.0,2.0,76.0,1862
14898,3,83,86,2,2,76.0,2.0,76.0,1862
14899,1,78,79,2,3,76.0,2.0,76.0,1862
14900,0,0,0,3,4,76.0,2.0,76.0,1862
14901,0,0,0,3,5,76.0,2.0,76.0,1862
14902,-12,38,26,3,6,76.0,2.0,76.0,1862
14903,13,57,70,3,7,76.0,2.0,76.0,1862
14904,28,72,100,1,0,76.0,2.0,76.0,1863
14905,-10,16,6,1,1,76.0,2.0,76.0,1863
14906,-33,46,13,2,2,76.0,2.0,76.0,1863
14907,43,38,81,2,3,76.0,2.0,76.0,1863
14908,6,58,64,3,4,76.0,2.0,76.0,1863
14909,64,29,93,3,5,76.0,2.0,76.0,1863
14910,74,26,100,3,6,76.0,2.0,76.0,1863
14911,4,79,83,3,7,76.0,2.0,76.0,1863
14912,-39,39,0,1,0,76.0,2.0,76.0,1864
14913,22,50,72,1,1,76.0,2.0,76.0,1864
14914,21,79,100,2,2,76.0,2.0,76.0,1864
14915,-3,36,33,2,3,76.0,2.0,76.0,1864
14916,44,39,83,3,4,76.0,2.0,76.0,1864
14917,0,50,50,3,5,76.0,2.0,76.0,1864
14918,0,100,100,3,6,76.0,2.0,76.0,1864
14919,-39,50,11,3,7,76.0,2.0,76.0,1864
14920,87,4,91,1,0,76.0,2.0,76.0,1865
14921,80,16,96,1,1,76.0,2.0,76.0,1865
14922,41,59,100,2,2,76.0,2.0,76.0,1865
14923,34,66,100,2,3,76.0,2.0,76.0,1865
14924,99,0,99,3,4,76.0,2.0,76.0,1865
14925,56,33,89,3,5,76.0,2.0,76.0,1865
14926,25,75,100,3,6,76.0,2.0,76.0,1865
14927,87,0,87,3,7,76.0,2.0,76.0,1865
14928,53,47,100,1,0,76.0,2.0,76.0,1866
14929,1,50,51,1,1,76.0,2.0,76.0,1866
14930,21,79,100,2,2,76.0,2.0,76.0,1866
14931,53,47,100,2,3,76.0,2.0,76.0,1866
14932,33,49,82,3,4,76.0,2.0,76.0,1866
14933,51,49,100,3,5,76.0,2.0,76.0,1866
14934,48,52,100,3,6,76.0,2.0,76.0,1866
14935,11,48,59,3,7,76.0,2.0,76.0,1866
14936,70,30,100,1,0,76.0,2.0,76.0,1867
14937,41,59,100,1,1,76.0,2.0,76.0,1867
14938,7,93,100,2,2,76.0,2.0,76.0,1867
14939,45,55,100,2,3,76.0,2.0,76.0,1867
14940,45,55,100,3,4,76.0,2.0,76.0,1867
14941,52,48,100,3,5,76.0,2.0,76.0,1867
14942,86,14,100,3,6,76.0,2.0,76.0,1867
14943,69,31,100,3,7,76.0,2.0,76.0,1867
14944,79,21,100,1,0,77.0,2.0,77.0,1868
14945,81,0,81,1,1,77.0,2.0,77.0,1868
14946,100,0,100,2,2,77.0,2.0,77.0,1868
14947,11,61,72,2,3,77.0,2.0,77.0,1868
14948,28,65,93,3,4,77.0,2.0,77.0,1868
14949,68,32,100,3,5,77.0,2.0,77.0,1868
14950,52,40,92,3,6,77.0,2.0,77.0,1868
14951,85,0,85,3,7,77.0,2.0,77.0,1868
14952,100,0,100,1,0,77.0,2.0,77.0,1869
14953,27,73,100,1,1,77.0,2.0,77.0,1869
14954,40,60,100,2,2,77.0,2.0,77.0,1869
14955,20,80,100,2,3,77.0,2.0,77.0,1869
14956,53,47,100,3,4,77.0,2.0,77.0,1869
14957,21,79,100,3,5,77.0,2.0,77.0,1869
14958,73,27,100,3,6,77.0,2.0,77.0,1869
14959,51,49,100,3,7,77.0,2.0,77.0,1869
14960,0,0,0,1,0,77.0,2.0,77.0,1870
14961,70,30,100,1,1,77.0,2.0,77.0,1870
14962,0,0,0,2,2,77.0,2.0,77.0,1870
14963,25,75,100,2,3,77.0,2.0,77.0,1870
14964,100,0,100,3,4,77.0,2.0,77.0,1870
14965,77,23,100,3,5,77.0,2.0,77.0,1870
14966,-30,30,0,3,6,77.0,2.0,77.0,1870
14967,0,0,0,3,7,77.0,2.0,77.0,1870
14968,-7,25,18,1,0,77.0,2.0,77.0,1871
14969,16,72,88,1,1,77.0,2.0,77.0,1871
14970,70,18,88,2,2,77.0,2.0,77.0,1871
14971,9,74,83,2,3,77.0,2.0,77.0,1871
14972,70,19,89,3,4,77.0,2.0,77.0,1871
14973,65,29,94,3,5,77.0,2.0,77.0,1871
14974,13,87,100,3,6,77.0,2.0,77.0,1871
14975,67,22,89,3,7,77.0,2.0,77.0,1871
14976,8,70,78,1,0,77.0,2.0,77.0,1872
14977,-11,81,70,1,1,77.0,2.0,77.0,1872
14978,-8,87,79,2,2,77.0,2.0,77.0,1872
14979,-5,81,76,2,3,77.0,2.0,77.0,1872
14980,4,77,81,3,4,77.0,2.0,77.0,1872
14981,27,50,77,3,5,77.0,2.0,77.0,1872
14982,1,74,75,3,6,77.0,2.0,77.0,1872
14983,1,80,81,3,7,77.0,2.0,77.0,1872
14984,100,0,100,1,0,77.0,2.0,77.0,1873
14985,96,4,100,1,1,77.0,2.0,77.0,1873
14986,10,67,77,2,2,77.0,2.0,77.0,1873
14987,-1,93,92,2,3,77.0,2.0,77.0,1873
14988,0,100,100,3,4,77.0,2.0,77.0,1873
14989,63,0,63,3,5,77.0,2.0,77.0,1873
14990,85,15,100,3,6,77.0,2.0,77.0,1873
14991,100,0,100,3,7,77.0,2.0,77.0,1873
14992,3,70,73,1,0,77.0,2.0,77.0,1874
14993,40,38,78,1,1,77.0,2.0,77.0,1874
14994,4,73,77,2,2,77.0,2.0,77.0,1874
14995,5,65,70,2,3,77.0,2.0,77.0,1874
14996,-42,63,21,3,4,77.0,2.0,77.0,1874
14997,46,30,76,3,5,77.0,2.0,77.0,1874
14998,-6,28,22,3,6,77.0,2.0,77.0,1874
14999,3,72,75,3,7,77.0,2.0,77.0,1874
15000,100,0,100,1,0,77.0,2.0,77.0,1875
15001,96,4,100,1,1,77.0,2.0,77.0,1875
15002,84,16,100,2,2,77.0,2.0,77.0,1875
15003,-5,5,0,2,3,77.0,2.0,77.0,1875
15004,24,76,100,3,4,77.0,2.0,77.0,1875
15005,81,19,100,3,5,77.0,2.0,77.0,1875
15006,88,0,88,3,6,77.0,2.0,77.0,1875
15007,96,4,100,3,7,77.0,2.0,77.0,1875
15008,1,74,75,1,0,77.0,2.0,77.0,1876
15009,7,71,78,1,1,77.0,2.0,77.0,1876
15010,26,66,92,2,2,77.0,2.0,77.0,1876
15011,-6,82,76,2,3,77.0,2.0,77.0,1876
15012,17,65,82,3,4,77.0,2.0,77.0,1876
15013,9,76,85,3,5,77.0,2.0,77.0,1876
15014,8,72,80,3,6,77.0,2.0,77.0,1876
15015,12,64,76,3,7,77.0,2.0,77.0,1876
15016,-4,44,40,1,0,77.0,2.0,77.0,1877
15017,-1,37,36,1,1,77.0,2.0,77.0,1877
15018,0,64,64,2,2,77.0,2.0,77.0,1877
15019,-2,36,34,2,3,77.0,2.0,77.0,1877
15020,-3,41,38,3,4,77.0,2.0,77.0,1877
15021,11,59,70,3,5,77.0,2.0,77.0,1877
15022,-28,59,31,3,6,77.0,2.0,77.0,1877
15023,5,31,36,3,7,77.0,2.0,77.0,1877
15024,38,0,38,1,0,77.0,2.0,77.0,1878
15025,17,20,37,1,1,77.0,2.0,77.0,1878
15026,64,0,64,2,2,77.0,2.0,77.0,1878
15027,50,42,92,2,3,77.0,2.0,77.0,1878
15028,32,56,88,3,4,77.0,2.0,77.0,1878
15029,71,29,100,3,5,77.0,2.0,77.0,1878
15030,92,8,100,3,6,77.0,2.0,77.0,1878
15031,62,4,66,3,7,77.0,2.0,77.0,1878
15032,50,0,50,1,0,77.0,2.0,77.0,1879
15033,50,0,50,1,1,77.0,2.0,77.0,1879
15034,0,100,100,2,2,77.0,2.0,77.0,1879
15035,0,100,100,2,3,77.0,2.0,77.0,1879
15036,32,36,68,3,4,77.0,2.0,77.0,1879
15037,78,0,78,3,5,77.0,2.0,77.0,1879
15038,5,95,100,3,6,77.0,2.0,77.0,1879
15039,26,49,75,3,7,77.0,2.0,77.0,1879
15040,1,35,36,1,0,77.0,2.0,77.0,1880
15041,7,35,42,1,1,77.0,2.0,77.0,1880
15042,-7,67,60,2,2,77.0,2.0,77.0,1880
15043,-14,96,82,2,3,77.0,2.0,77.0,1880
15044,11,50,61,3,4,77.0,2.0,77.0,1880
15045,21,37,58,3,5,77.0,2.0,77.0,1880
15046,-10,81,71,3,6,77.0,2.0,77.0,1880
15047,46,32,78,3,7,77.0,2.0,77.0,1880
15048,-24,97,73,1,0,77.0,2.0,77.0,1881
15049,56,29,85,1,1,77.0,2.0,77.0,1881
15050,2,98,100,2,2,77.0,2.0,77.0,1881
15051,15,85,100,2,3,77.0,2.0,77.0,1881
15052,0,100,100,3,4,77.0,2.0,77.0,1881
15053,22,78,100,3,5,77.0,2.0,77.0,1881
15054,74,26,100,3,6,77.0,2.0,77.0,1881
15055,95,5,100,3,7,77.0,2.0,77.0,1881
15056,-42,68,26,1,0,77.0,2.0,77.0,1882
15057,-38,72,34,1,1,77.0,2.0,77.0,1882
15058,4,32,36,2,2,77.0,2.0,77.0,1882
15059,-3,78,75,2,3,77.0,2.0,77.0,1882
15060,-4,73,69,3,4,77.0,2.0,77.0,1882
15061,-2,36,34,3,5,77.0,2.0,77.0,1882
15062,11,64,75,3,6,77.0,2.0,77.0,1882
15063,12,10,22,3,7,77.0,2.0,77.0,1882
15064,39,50,89,1,0,77.0,2.0,77.0,1883
15065,3,6,9,1,1,77.0,2.0,77.0,1883
15066,26,70,96,2,2,77.0,2.0,77.0,1883
15067,54,40,94,2,3,77.0,2.0,77.0,1883
15068,37,50,87,3,4,77.0,2.0,77.0,1883
15069,42,50,92,3,5,77.0,2.0,77.0,1883
15070,40,50,90,3,6,77.0,2.0,77.0,1883
15071,70,25,95,3,7,77.0,2.0,77.0,1883
15072,99,1,100,1,0,77.0,2.0,77.0,1884
15073,14,86,100,1,1,77.0,2.0,77.0,1884
15074,0,100,100,2,2,77.0,2.0,77.0,1884
15075,0,100,100,2,3,77.0,2.0,77.0,1884
15076,19,81,100,3,4,77.0,2.0,77.0,1884
15077,69,31,100,3,5,77.0,2.0,77.0,1884
15078,67,33,100,3,6,77.0,2.0,77.0,1884
15079,-19,20,1,3,7,77.0,2.0,77.0,1884
15080,28,39,67,1,0,77.0,2.0,77.0,1885
15081,29,32,61,1,1,77.0,2.0,77.0,1885
15082,-15,60,45,2,2,77.0,2.0,77.0,1885
15083,24,26,50,2,3,77.0,2.0,77.0,1885
15084,12,63,75,3,4,77.0,2.0,77.0,1885
15085,4,40,44,3,5,77.0,2.0,77.0,1885
15086,11,31,42,3,6,77.0,2.0,77.0,1885
15087,31,31,62,3,7,77.0,2.0,77.0,1885
15088,15,8,23,1,0,77.0,2.0,77.0,1886
15089,39,58,97,1,1,77.0,2.0,77.0,1886
15090,4,96,100,2,2,77.0,2.0,77.0,1886
15091,-3,3,0,2,3,77.0,2.0,77.0,1886
15092,0,100,100,3,4,77.0,2.0,77.0,1886
15093,-5,30,25,3,5,77.0,2.0,77.0,1886
15094,-1,85,84,3,6,77.0,2.0,77.0,1886
15095,2,40,42,3,7,77.0,2.0,77.0,1886
15096,24,0,24,1,0,77.0,2.0,77.0,1887
15097,-24,29,5,1,1,77.0,2.0,77.0,1887
15098,-16,100,84,2,2,77.0,2.0,77.0,1887
15099,18,82,100,2,3,77.0,2.0,77.0,1887
15100,1,82,83,3,4,77.0,2.0,77.0,1887
15101,-6,23,17,3,5,77.0,2.0,77.0,1887
15102,28,2,30,3,6,77.0,2.0,77.0,1887
15103,-8,22,14,3,7,77.0,2.0,77.0,1887
15104,-53,86,33,1,0,77.0,2.0,77.0,1888
15105,23,77,100,1,1,77.0,2.0,77.0,1888
15106,-4,85,81,2,2,77.0,2.0,77.0,1888
15107,39,35,74,2,3,77.0,2.0,77.0,1888
15108,25,75,100,3,4,77.0,2.0,77.0,1888
15109,11,89,100,3,5,77.0,2.0,77.0,1888
15110,2,80,82,3,6,77.0,2.0,77.0,1888
15111,72,0,72,3,7,77.0,2.0,77.0,1888
15112,14,0,14,1,0,77.0,2.0,77.0,1889
15113,-90,90,0,1,1,77.0,2.0,77.0,1889
15114,0,100,100,2,2,77.0,2.0,77.0,1889
15115,0,100,100,2,3,77.0,2.0,77.0,1889
15116,-6,20,14,3,4,77.0,2.0,77.0,1889
15117,-16,32,16,3,5,77.0,2.0,77.0,1889
15118,-39,39,0,3,6,77.0,2.0,77.0,1889
15119,-19,19,0,3,7,77.0,2.0,77.0,1889
15120,23,37,60,1,0,77.0,2.0,77.0,1890
15121,-10,99,89,1,1,77.0,2.0,77.0,1890
15122,65,23,88,2,2,77.0,2.0,77.0,1890
15123,68,21,89,2,3,77.0,2.0,77.0,1890
15124,24,37,61,3,4,77.0,2.0,77.0,1890
15125,36,23,59,3,5,77.0,2.0,77.0,1890
15126,36,29,65,3,6,77.0,2.0,77.0,1890
15127,66,12,78,3,7,77.0,2.0,77.0,1890
15128,27,73,100,1,0,77.0,2.0,77.0,1891
15129,0,0,0,1,1,77.0,2.0,77.0,1891
15130,23,77,100,2,2,77.0,2.0,77.0,1891
15131,0,100,100,2,3,77.0,2.0,77.0,1891
15132,-5,29,24,3,4,77.0,2.0,77.0,1891
15133,-65,65,0,3,5,77.0,2.0,77.0,1891
15134,23,77,100,3,6,77.0,2.0,77.0,1891
15135,0,0,0,3,7,77.0,2.0,77.0,1891
15136,-12,99,87,1,0,78.0,2.0,78.0,1892
15137,0,100,100,1,1,78.0,2.0,78.0,1892
15138,2,11,13,2,2,78.0,2.0,78.0,1892
15139,6,76,82,2,3,78.0,2.0,78.0,1892
15140,13,87,100,3,4,78.0,2.0,78.0,1892
15141,-7,52,45,3,5,78.0,2.0,78.0,1892
15142,16,17,33,3,6,78.0,2.0,78.0,1892
15143,39,28,67,3,7,78.0,2.0,78.0,1892
15144,13,22,35,1,0,78.0,2.0,78.0,1893
15145,-55,55,0,1,1,78.0,2.0,78.0,1893
15146,-13,50,37,2,2,78.0,2.0,78.0,1893
15147,0,50,50,2,3,78.0,2.0,78.0,1893
15148,16,59,75,3,4,78.0,2.0,78.0,1893
15149,0,50,50,3,5,78.0,2.0,78.0,1893
15150,-5,36,31,3,6,78.0,2.0,78.0,1893
15151,5,14,19,3,7,78.0,2.0,78.0,1893
15152,-11,49,38,1,0,78.0,2.0,78.0,1894
15153,-15,37,22,1,1,78.0,2.0,78.0,1894
15154,15,38,53,2,2,78.0,2.0,78.0,1894
15155,-5,48,43,2,3,78.0,2.0,78.0,1894
15156,-5,46,41,3,4,78.0,2.0,78.0,1894
15157,26,43,69,3,5,78.0,2.0,78.0,1894
15158,1,43,44,3,6,78.0,2.0,78.0,1894
15159,10,32,42,3,7,78.0,2.0,78.0,1894
15160,100,0,100,1,0,78.0,2.0,78.0,1895
15161,34,66,100,1,1,78.0,2.0,78.0,1895
15162,10,90,100,2,2,78.0,2.0,78.0,1895
15163,50,50,100,2,3,78.0,2.0,78.0,1895
15164,23,77,100,3,4,78.0,2.0,78.0,1895
15165,50,50,100,3,5,78.0,2.0,78.0,1895
15166,76,24,100,3,6,78.0,2.0,78.0,1895
15167,100,0,100,3,7,78.0,2.0,78.0,1895
15168,24,74,98,1,0,78.0,2.0,78.0,1896
15169,41,50,91,1,1,78.0,2.0,78.0,1896
15170,28,50,78,2,2,78.0,2.0,78.0,1896
15171,11,67,78,2,3,78.0,2.0,78.0,1896
15172,47,50,97,3,4,78.0,2.0,78.0,1896
15173,50,50,100,3,5,78.0,2.0,78.0,1896
15174,51,49,100,3,6,78.0,2.0,78.0,1896
15175,50,50,100,3,7,78.0,2.0,78.0,1896
15176,98,2,100,1,0,78.0,2.0,78.0,1897
15177,1,98,99,1,1,78.0,2.0,78.0,1897
15178,11,89,100,2,2,78.0,2.0,78.0,1897
15179,7,91,98,2,3,78.0,2.0,78.0,1897
15180,29,71,100,3,4,78.0,2.0,78.0,1897
15181,90,5,95,3,5,78.0,2.0,78.0,1897
15182,26,74,100,3,6,78.0,2.0,78.0,1897
15183,96,0,96,3,7,78.0,2.0,78.0,1897
15184,73,0,73,1,0,78.0,2.0,78.0,1898
15185,49,50,99,1,1,78.0,2.0,78.0,1898
15186,1,43,44,2,2,78.0,2.0,78.0,1898
15187,-2,76,74,2,3,78.0,2.0,78.0,1898
15188,-20,50,30,3,4,78.0,2.0,78.0,1898
15189,0,50,50,3,5,78.0,2.0,78.0,1898
15190,20,50,70,3,6,78.0,2.0,78.0,1898
15191,6,44,50,3,7,78.0,2.0,78.0,1898
15192,-25,50,25,1,0,78.0,2.0,78.0,1899
15193,12,45,57,1,1,78.0,2.0,78.0,1899
15194,7,75,82,2,2,78.0,2.0,78.0,1899
15195,61,5,66,2,3,78.0,2.0,78.0,1899
15196,13,75,88,3,4,78.0,2.0,78.0,1899
15197,8,10,18,3,5,78.0,2.0,78.0,1899
15198,7,80,87,3,6,78.0,2.0,78.0,1899
15199,1,11,12,3,7,78.0,2.0,78.0,1899
15200,56,44,100,1,0,78.0,2.0,78.0,1900
15201,20,80,100,1,1,78.0,2.0,78.0,1900
15202,50,50,100,2,2,78.0,2.0,78.0,1900
15203,24,76,100,2,3,78.0,2.0,78.0,1900
15204,13,87,100,3,4,78.0,2.0,78.0,1900
15205,33,67,100,3,5,78.0,2.0,78.0,1900
15206,0,100,100,3,6,78.0,2.0,78.0,1900
15207,81,19,100,3,7,78.0,2.0,78.0,1900
15208,-21,100,79,1,0,78.0,2.0,78.0,1901
15209,-7,100,93,1,1,78.0,2.0,78.0,1901
15210,-31,100,69,2,2,78.0,2.0,78.0,1901
15211,-39,100,61,2,3,78.0,2.0,78.0,1901
15212,-33,100,67,3,4,78.0,2.0,78.0,1901
15213,-1,61,60,3,5,78.0,2.0,78.0,1901
15214,-37,100,63,3,6,78.0,2.0,78.0,1901
15215,-27,100,73,3,7,78.0,2.0,78.0,1901
15216,60,33,93,1,0,78.0,2.0,78.0,1902
15217,25,57,82,1,1,78.0,2.0,78.0,1902
15218,28,62,90,2,2,78.0,2.0,78.0,1902
15219,49,36,85,2,3,78.0,2.0,78.0,1902
15220,41,36,77,3,4,78.0,2.0,78.0,1902
15221,81,13,94,3,5,78.0,2.0,78.0,1902
15222,1,92,93,3,6,78.0,2.0,78.0,1902
15223,63,27,90,3,7,78.0,2.0,78.0,1902
15224,41,25,66,1,0,78.0,2.0,78.0,1903
15225,14,25,39,1,1,78.0,2.0,78.0,1903
15226,8,76,84,2,2,78.0,2.0,78.0,1903
15227,24,60,84,2,3,78.0,2.0,78.0,1903
15228,30,50,80,3,4,78.0,2.0,78.0,1903
15229,38,50,88,3,5,78.0,2.0,78.0,1903
15230,28,62,90,3,6,78.0,2.0,78.0,1903
15231,64,13,77,3,7,78.0,2.0,78.0,1903
15232,43,36,79,1,0,78.0,2.0,78.0,1904
15233,51,22,73,1,1,78.0,2.0,78.0,1904
15234,0,77,77,2,2,78.0,2.0,78.0,1904
15235,3,77,80,2,3,78.0,2.0,78.0,1904
15236,19,69,88,3,4,78.0,2.0,78.0,1904
15237,20,70,90,3,5,78.0,2.0,78.0,1904
15238,7,15,22,3,6,78.0,2.0,78.0,1904
15239,13,7,20,3,7,78.0,2.0,78.0,1904
15240,0,100,100,1,0,78.0,2.0,78.0,1905
15241,0,100,100,1,1,78.0,2.0,78.0,1905
15242,58,0,58,2,2,78.0,2.0,78.0,1905
15243,57,0,57,2,3,78.0,2.0,78.0,1905
15244,0,100,100,3,4,78.0,2.0,78.0,1905
15245,19,57,76,3,5,78.0,2.0,78.0,1905
15246,69,0,69,3,6,78.0,2.0,78.0,1905
15247,65,0,65,3,7,78.0,2.0,78.0,1905
15248,8,65,73,1,0,78.0,2.0,78.0,1906
15249,-27,97,70,1,1,78.0,2.0,78.0,1906
15250,-2,29,27,2,2,78.0,2.0,78.0,1906
15251,-13,100,87,2,3,78.0,2.0,78.0,1906
15252,-38,100,62,3,4,78.0,2.0,78.0,1906
15253,-33,100,67,3,5,78.0,2.0,78.0,1906
15254,-12,79,67,3,6,78.0,2.0,78.0,1906
15255,-62,80,18,3,7,78.0,2.0,78.0,1906
15256,-6,50,44,1,0,78.0,2.0,78.0,1907
15257,0,50,50,1,1,78.0,2.0,78.0,1907
15258,-2,52,50,2,2,78.0,2.0,78.0,1907
15259,23,77,100,2,3,78.0,2.0,78.0,1907
15260,4,60,64,3,4,78.0,2.0,78.0,1907
15261,5,77,82,3,5,78.0,2.0,78.0,1907
15262,30,64,94,3,6,78.0,2.0,78.0,1907
15263,4,46,50,3,7,78.0,2.0,78.0,1907
15264,17,37,54,1,0,78.0,2.0,78.0,1908
15265,-6,53,47,1,1,78.0,2.0,78.0,1908
15266,-6,85,79,2,2,78.0,2.0,78.0,1908
15267,0,89,89,2,3,78.0,2.0,78.0,1908
15268,16,57,73,3,4,78.0,2.0,78.0,1908
15269,22,38,60,3,5,78.0,2.0,78.0,1908
15270,6,77,83,3,6,78.0,2.0,78.0,1908
15271,10,50,60,3,7,78.0,2.0,78.0,1908
15272,19,6,25,1,0,78.0,2.0,78.0,1909
15273,5,15,20,1,1,78.0,2.0,78.0,1909
15274,-6,100,94,2,2,78.0,2.0,78.0,1909
15275,-2,93,91,2,3,78.0,2.0,78.0,1909
15276,27,66,93,3,4,78.0,2.0,78.0,1909
15277,36,50,86,3,5,78.0,2.0,78.0,1909
15278,79,7,86,3,6,78.0,2.0,78.0,1909
15279,77,3,80,3,7,78.0,2.0,78.0,1909
15280,9,28,37,1,0,79.0,2.0,79.0,1910
15281,-1,75,74,1,1,79.0,2.0,79.0,1910
15282,-10,72,62,2,2,79.0,2.0,79.0,1910
15283,-28,80,52,2,3,79.0,2.0,79.0,1910
15284,0,73,73,3,4,79.0,2.0,79.0,1910
15285,1,33,34,3,5,79.0,2.0,79.0,1910
15286,-12,70,58,3,6,79.0,2.0,79.0,1910
15287,-36,74,38,3,7,79.0,2.0,79.0,1910
15288,25,67,92,1,0,79.0,2.0,79.0,1911
15289,22,78,100,1,1,79.0,2.0,79.0,1911
15290,46,54,100,2,2,79.0,2.0,79.0,1911
15291,38,62,100,2,3,79.0,2.0,79.0,1911
15292,36,46,82,3,4,79.0,2.0,79.0,1911
15293,22,75,97,3,5,79.0,2.0,79.0,1911
15294,19,81,100,3,6,79.0,2.0,79.0,1911
15295,-25,25,0,3,7,79.0,2.0,79.0,1911
15296,4,17,21,1,0,79.0,2.0,79.0,1912
15297,-41,64,23,1,1,79.0,2.0,79.0,1912
15298,-1,72,71,2,2,79.0,2.0,79.0,1912
15299,2,80,82,2,3,79.0,2.0,79.0,1912
15300,-3,41,38,3,4,79.0,2.0,79.0,1912
15301,-1,41,40,3,5,79.0,2.0,79.0,1912
15302,0,67,67,3,6,79.0,2.0,79.0,1912
15303,-41,83,42,3,7,79.0,2.0,79.0,1912
15304,61,26,87,1,0,79.0,2.0,79.0,1913
15305,-59,84,25,1,1,79.0,2.0,79.0,1913
15306,-10,93,83,2,2,79.0,2.0,79.0,1913
15307,42,27,69,2,3,79.0,2.0,79.0,1913
15308,-53,78,25,3,4,79.0,2.0,79.0,1913
15309,-12,87,75,3,5,79.0,2.0,79.0,1913
15310,54,27,81,3,6,79.0,2.0,79.0,1913
15311,8,23,31,3,7,79.0,2.0,79.0,1913
15312,19,50,69,1,0,79.0,2.0,79.0,1914
15313,12,23,35,1,1,79.0,2.0,79.0,1914
15314,-12,83,71,2,2,79.0,2.0,79.0,1914
15315,18,25,43,2,3,79.0,2.0,79.0,1914
15316,-33,63,30,3,4,79.0,2.0,79.0,1914
15317,-12,44,32,3,5,79.0,2.0,79.0,1914
15318,-17,26,9,3,6,79.0,2.0,79.0,1914
15319,3,19,22,3,7,79.0,2.0,79.0,1914
15320,100,0,100,1,0,79.0,2.0,79.0,1915
15321,10,90,100,1,1,79.0,2.0,79.0,1915
15322,2,13,15,2,2,79.0,2.0,79.0,1915
15323,-87,87,0,2,3,79.0,2.0,79.0,1915
15324,3,85,88,3,4,79.0,2.0,79.0,1915
15325,-3,24,21,3,5,79.0,2.0,79.0,1915
15326,80,4,84,3,6,79.0,2.0,79.0,1915
15327,7,0,7,3,7,79.0,2.0,79.0,1915
15328,98,2,100,1,0,79.0,2.0,79.0,1916
15329,74,26,100,1,1,79.0,2.0,79.0,1916
15330,38,50,88,2,2,79.0,2.0,79.0,1916
15331,14,77,91,2,3,79.0,2.0,79.0,1916
15332,50,50,100,3,4,79.0,2.0,79.0,1916
15333,81,11,92,3,5,79.0,2.0,79.0,1916
15334,24,76,100,3,6,79.0,2.0,79.0,1916
15335,92,3,95,3,7,79.0,2.0,79.0,1916
15336,30,40,70,1,0,79.0,2.0,79.0,1917
15337,0,0,0,1,1,79.0,2.0,79.0,1917
15338,26,36,62,2,2,79.0,2.0,79.0,1917
15339,33,0,33,2,3,79.0,2.0,79.0,1917
15340,-5,50,45,3,4,79.0,2.0,79.0,1917
15341,-5,65,60,3,5,79.0,2.0,79.0,1917
15342,-100,100,0,3,6,79.0,2.0,79.0,1917
15343,59,0,59,3,7,79.0,2.0,79.0,1917
15344,77,23,100,1,0,79.0,2.0,79.0,1918
15345,27,73,100,1,1,79.0,2.0,79.0,1918
15346,12,88,100,2,2,79.0,2.0,79.0,1918
15347,24,76,100,2,3,79.0,2.0,79.0,1918
15348,14,86,100,3,4,79.0,2.0,79.0,1918
15349,20,80,100,3,5,79.0,2.0,79.0,1918
15350,0,100,100,3,6,79.0,2.0,79.0,1918
15351,0,0,0,3,7,79.0,2.0,79.0,1918
15352,24,39,63,1,0,79.0,2.0,79.0,1919
15353,53,37,90,1,1,79.0,2.0,79.0,1919
15354,53,36,89,2,2,79.0,2.0,79.0,1919
15355,13,82,95,2,3,79.0,2.0,79.0,1919
15356,17,74,91,3,4,79.0,2.0,79.0,1919
15357,39,28,67,3,5,79.0,2.0,79.0,1919
15358,48,46,94,3,6,79.0,2.0,79.0,1919
15359,54,13,67,3,7,79.0,2.0,79.0,1919
15360,42,58,100,1,0,79.0,2.0,79.0,1920
15361,18,57,75,1,1,79.0,2.0,79.0,1920
15362,67,33,100,2,2,79.0,2.0,79.0,1920
15363,75,25,100,2,3,79.0,2.0,79.0,1920
15364,60,40,100,3,4,79.0,2.0,79.0,1920
15365,35,57,92,3,5,79.0,2.0,79.0,1920
15366,83,17,100,3,6,79.0,2.0,79.0,1920
15367,79,21,100,3,7,79.0,2.0,79.0,1920
15368,51,32,83,1,0,79.0,2.0,79.0,1921
15369,78,9,87,1,1,79.0,2.0,79.0,1921
15370,29,51,80,2,2,79.0,2.0,79.0,1921
15371,1,49,50,2,3,79.0,2.0,79.0,1921
15372,80,11,91,3,4,79.0,2.0,79.0,1921
15373,37,51,88,3,5,79.0,2.0,79.0,1921
15374,47,51,98,3,6,79.0,2.0,79.0,1921
15375,84,7,91,3,7,79.0,2.0,79.0,1921
15376,-45,76,31,1,0,79.0,2.0,79.0,1922
15377,-43,73,30,1,1,79.0,2.0,79.0,1922
15378,57,18,75,2,2,79.0,2.0,79.0,1922
15379,8,85,93,2,3,79.0,2.0,79.0,1922
15380,-39,73,34,3,4,79.0,2.0,79.0,1922
15381,11,22,33,3,5,79.0,2.0,79.0,1922
15382,-2,21,19,3,6,79.0,2.0,79.0,1922
15383,6,19,25,3,7,79.0,2.0,79.0,1922
15384,20,19,39,1,0,79.0,2.0,79.0,1923
15385,77,23,100,1,1,79.0,2.0,79.0,1923
15386,16,84,100,2,2,79.0,2.0,79.0,1923
15387,36,64,100,2,3,79.0,2.0,79.0,1923
15388,51,49,100,3,4,79.0,2.0,79.0,1923
15389,52,48,100,3,5,79.0,2.0,79.0,1923
15390,82,18,100,3,6,79.0,2.0,79.0,1923
15391,94,6,100,3,7,79.0,2.0,79.0,1923
15392,-13,13,0,1,0,79.0,2.0,79.0,1924
15393,0,100,100,1,1,79.0,2.0,79.0,1924
15394,5,95,100,2,2,79.0,2.0,79.0,1924
15395,-53,53,0,2,3,79.0,2.0,79.0,1924
15396,28,72,100,3,4,79.0,2.0,79.0,1924
15397,-9,71,62,3,5,79.0,2.0,79.0,1924
15398,0,0,0,3,6,79.0,2.0,79.0,1924
15399,-14,19,5,3,7,79.0,2.0,79.0,1924
15400,-7,81,74,1,0,79.0,2.0,79.0,1925
15401,-2,87,85,1,1,79.0,2.0,79.0,1925
15402,0,81,81,2,2,79.0,2.0,79.0,1925
15403,0,78,78,2,3,79.0,2.0,79.0,1925
15404,-9,87,78,3,4,79.0,2.0,79.0,1925
15405,-3,78,75,3,5,79.0,2.0,79.0,1925
15406,-5,85,80,3,6,79.0,2.0,79.0,1925
15407,-3,80,77,3,7,79.0,2.0,79.0,1925
15408,74,5,79,1,0,79.0,2.0,79.0,1926
15409,82,0,82,1,1,79.0,2.0,79.0,1926
15410,5,91,96,2,2,79.0,2.0,79.0,1926
15411,-10,100,90,2,3,79.0,2.0,79.0,1926
15412,-2,90,88,3,4,79.0,2.0,79.0,1926
15413,74,11,85,3,5,79.0,2.0,79.0,1926
15414,43,50,93,3,6,79.0,2.0,79.0,1926
15415,89,0,89,3,7,79.0,2.0,79.0,1926
15416,-1,16,15,1,0,79.0,2.0,79.0,1927
15417,71,22,93,1,1,79.0,2.0,79.0,1927
15418,0,100,100,2,2,79.0,2.0,79.0,1927
15419,14,86,100,2,3,79.0,2.0,79.0,1927
15420,41,59,100,3,4,79.0,2.0,79.0,1927
15421,45,30,75,3,5,79.0,2.0,79.0,1927
15422,24,76,100,3,6,79.0,2.0,79.0,1927
15423,18,0,18,3,7,79.0,2.0,79.0,1927
15424,30,50,80,1,0,79.0,2.0,79.0,1928
15425,-4,60,56,1,1,79.0,2.0,79.0,1928
15426,-45,71,26,2,2,79.0,2.0,79.0,1928
15427,41,28,69,2,3,79.0,2.0,79.0,1928
15428,76,24,100,3,4,79.0,2.0,79.0,1928
15429,17,72,89,3,5,79.0,2.0,79.0,1928
15430,71,11,82,3,6,79.0,2.0,79.0,1928
15431,-76,76,0,3,7,79.0,2.0,79.0,1928
15432,-14,80,66,1,0,79.0,2.0,79.0,1929
15433,19,75,94,1,1,79.0,2.0,79.0,1929
15434,8,75,83,2,2,79.0,2.0,79.0,1929
15435,28,72,100,2,3,79.0,2.0,79.0,1929
15436,-16,42,26,3,4,79.0,2.0,79.0,1929
15437,71,24,95,3,5,79.0,2.0,79.0,1929
15438,5,71,76,3,6,79.0,2.0,79.0,1929
15439,-58,68,10,3,7,79.0,2.0,79.0,1929
15440,27,73,100,1,0,79.0,2.0,79.0,1930
15441,13,87,100,1,1,79.0,2.0,79.0,1930
15442,100,0,100,2,2,79.0,2.0,79.0,1930
15443,85,15,100,2,3,79.0,2.0,79.0,1930
15444,88,12,100,3,4,79.0,2.0,79.0,1930
15445,43,57,100,3,5,79.0,2.0,79.0,1930
15446,50,50,100,3,6,79.0,2.0,79.0,1930
15447,58,22,80,3,7,79.0,2.0,79.0,1930
15448,58,16,74,1,0,80.0,2.0,80.0,1931
15449,0,82,82,1,1,80.0,2.0,80.0,1931
15450,30,50,80,2,2,80.0,2.0,80.0,1931
15451,33,50,83,2,3,80.0,2.0,80.0,1931
15452,11,71,82,3,4,80.0,2.0,80.0,1931
15453,54,31,85,3,5,80.0,2.0,80.0,1931
15454,52,30,82,3,6,80.0,2.0,80.0,1931
15455,59,23,82,3,7,80.0,2.0,80.0,1931
15456,0,0,0,1,0,80.0,2.0,80.0,1932
15457,0,50,50,1,1,80.0,2.0,80.0,1932
15458,0,50,50,2,2,80.0,2.0,80.0,1932
15459,0,100,100,2,3,80.0,2.0,80.0,1932
15460,0,50,50,3,4,80.0,2.0,80.0,1932
15461,0,50,50,3,5,80.0,2.0,80.0,1932
15462,0,50,50,3,6,80.0,2.0,80.0,1932
15463,0,0,0,3,7,80.0,2.0,80.0,1932
15464,0,0,0,1,0,80.0,2.0,80.0,1933
15465,-5,35,30,1,1,80.0,2.0,80.0,1933
15466,10,50,60,2,2,80.0,2.0,80.0,1933
15467,100,0,100,2,3,80.0,2.0,80.0,1933
15468,8,42,50,3,4,80.0,2.0,80.0,1933
15469,20,50,70,3,5,80.0,2.0,80.0,1933
15470,-10,60,50,3,6,80.0,2.0,80.0,1933
15471,9,51,60,3,7,80.0,2.0,80.0,1933
15472,17,50,67,1,0,80.0,2.0,80.0,1934
15473,1,50,51,1,1,80.0,2.0,80.0,1934
15474,25,50,75,2,2,80.0,2.0,80.0,1934
15475,15,61,76,2,3,80.0,2.0,80.0,1934
15476,0,100,100,3,4,80.0,2.0,80.0,1934
15477,25,50,75,3,5,80.0,2.0,80.0,1934
15478,20,30,50,3,6,80.0,2.0,80.0,1934
15479,34,25,59,3,7,80.0,2.0,80.0,1934
15480,-54,77,23,1,0,80.0,2.0,80.0,1935
15481,-46,76,30,1,1,80.0,2.0,80.0,1935
15482,-57,88,31,2,2,80.0,2.0,80.0,1935
15483,-38,72,34,2,3,80.0,2.0,80.0,1935
15484,-44,81,37,3,4,80.0,2.0,80.0,1935
15485,9,24,33,3,5,80.0,2.0,80.0,1935
15486,0,19,19,3,6,80.0,2.0,80.0,1935
15487,3,34,37,3,7,80.0,2.0,80.0,1935
15488,14,11,25,1,0,80.0,2.0,80.0,1936
15489,49,0,49,1,1,80.0,2.0,80.0,1936
15490,100,0,100,2,2,80.0,2.0,80.0,1936
15491,24,76,100,2,3,80.0,2.0,80.0,1936
15492,2,78,80,3,4,80.0,2.0,80.0,1936
15493,53,0,53,3,5,80.0,2.0,80.0,1936
15494,47,50,97,3,6,80.0,2.0,80.0,1936
15495,90,0,90,3,7,80.0,2.0,80.0,1936
15496,69,21,90,1,0,80.0,2.0,80.0,1937
15497,63,25,88,1,1,80.0,2.0,80.0,1937
15498,66,19,85,2,2,80.0,2.0,80.0,1937
15499,66,24,90,2,3,80.0,2.0,80.0,1937
15500,6,79,85,3,4,80.0,2.0,80.0,1937
15501,51,38,89,3,5,80.0,2.0,80.0,1937
15502,59,32,91,3,6,80.0,2.0,80.0,1937
15503,73,22,95,3,7,80.0,2.0,80.0,1937
15504,83,1,84,1,0,80.0,2.0,80.0,1938
15505,11,39,50,1,1,80.0,2.0,80.0,1938
15506,-33,84,51,2,2,80.0,2.0,80.0,1938
15507,-7,100,93,2,3,80.0,2.0,80.0,1938
15508,26,74,100,3,4,80.0,2.0,80.0,1938
15509,19,50,69,3,5,80.0,2.0,80.0,1938
15510,-26,76,50,3,6,80.0,2.0,80.0,1938
15511,49,50,99,3,7,80.0,2.0,80.0,1938
15512,43,28,71,1,0,80.0,2.0,80.0,1939
15513,-14,88,74,1,1,80.0,2.0,80.0,1939
15514,-11,74,63,2,2,80.0,2.0,80.0,1939
15515,-24,85,61,2,3,80.0,2.0,80.0,1939
15516,-5,76,71,3,4,80.0,2.0,80.0,1939
15517,43,24,67,3,5,80.0,2.0,80.0,1939
15518,0,64,64,3,6,80.0,2.0,80.0,1939
15519,42,29,71,3,7,80.0,2.0,80.0,1939
15520,10,40,50,1,0,80.0,2.0,80.0,1940
15521,10,20,30,1,1,80.0,2.0,80.0,1940
15522,0,80,80,2,2,80.0,2.0,80.0,1940
15523,-5,80,75,2,3,80.0,2.0,80.0,1940
15524,5,75,80,3,4,80.0,2.0,80.0,1940
15525,40,50,90,3,5,80.0,2.0,80.0,1940
15526,5,75,80,3,6,80.0,2.0,80.0,1940
15527,5,70,75,3,7,80.0,2.0,80.0,1940
15528,0,0,0,1,0,80.0,2.0,80.0,1941
15529,3,50,53,1,1,80.0,2.0,80.0,1941
15530,39,61,100,2,2,80.0,2.0,80.0,1941
15531,-100,100,0,2,3,80.0,2.0,80.0,1941
15532,6,38,44,3,4,80.0,2.0,80.0,1941
15533,25,22,47,3,5,80.0,2.0,80.0,1941
15534,0,0,0,3,6,80.0,2.0,80.0,1941
15535,39,37,76,3,7,80.0,2.0,80.0,1941
15536,100,0,100,1,0,80.0,2.0,80.0,1942
15537,45,55,100,1,1,80.0,2.0,80.0,1942
15538,100,0,100,2,2,80.0,2.0,80.0,1942
15539,100,0,100,2,3,80.0,2.0,80.0,1942
15540,-40,90,50,3,4,80.0,2.0,80.0,1942
15541,100,0,100,3,5,80.0,2.0,80.0,1942
15542,100,0,100,3,6,80.0,2.0,80.0,1942
15543,100,0,100,3,7,80.0,2.0,80.0,1942
15544,0,0,0,1,0,80.0,2.0,80.0,1943
15545,0,0,0,1,1,80.0,2.0,80.0,1943
15546,0,100,100,2,2,80.0,2.0,80.0,1943
15547,0,100,100,2,3,80.0,2.0,80.0,1943
15548,0,51,51,3,4,80.0,2.0,80.0,1943
15549,2,49,51,3,5,80.0,2.0,80.0,1943
15550,0,100,100,3,6,80.0,2.0,80.0,1943
15551,-1,52,51,3,7,80.0,2.0,80.0,1943
15552,100,0,100,1,0,80.0,2.0,80.0,1944
15553,0,100,100,1,1,80.0,2.0,80.0,1944
15554,100,0,100,2,2,80.0,2.0,80.0,1944
15555,0,0,0,2,3,80.0,2.0,80.0,1944
15556,75,25,100,3,4,80.0,2.0,80.0,1944
15557,100,0,100,3,5,80.0,2.0,80.0,1944
15558,0,100,100,3,6,80.0,2.0,80.0,1944
15559,100,0,100,3,7,80.0,2.0,80.0,1944
15560,0,0,0,1,0,80.0,2.0,80.0,1945
15561,0,0,0,1,1,80.0,2.0,80.0,1945
15562,0,100,100,2,2,80.0,2.0,80.0,1945
15563,0,0,0,2,3,80.0,2.0,80.0,1945
15564,-8,58,50,3,4,80.0,2.0,80.0,1945
15565,0,50,50,3,5,80.0,2.0,80.0,1945
15566,12,38,50,3,6,80.0,2.0,80.0,1945
15567,-5,55,50,3,7,80.0,2.0,80.0,1945
15568,25,75,100,1,0,80.0,2.0,80.0,1946
15569,-11,11,0,1,1,80.0,2.0,80.0,1946
15570,-13,63,50,2,2,80.0,2.0,80.0,1946
15571,-12,12,0,2,3,80.0,2.0,80.0,1946
15572,25,0,25,3,4,80.0,2.0,80.0,1946
15573,0,38,38,3,5,80.0,2.0,80.0,1946
15574,38,50,88,3,6,80.0,2.0,80.0,1946
15575,-12,75,63,3,7,80.0,2.0,80.0,1946
15576,86,0,86,1,0,80.0,2.0,80.0,1947
15577,74,0,74,1,1,80.0,2.0,80.0,1947
15578,12,80,92,2,2,80.0,2.0,80.0,1947
15579,17,73,90,2,3,80.0,2.0,80.0,1947
15580,27,55,82,3,4,80.0,2.0,80.0,1947
15581,46,50,96,3,5,80.0,2.0,80.0,1947
15582,0,95,95,3,6,80.0,2.0,80.0,1947
15583,37,0,37,3,7,80.0,2.0,80.0,1947
15584,59,41,100,1,0,80.0,2.0,80.0,1948
15585,71,29,100,1,1,80.0,2.0,80.0,1948
15586,83,17,100,2,2,80.0,2.0,80.0,1948
15587,6,94,100,2,3,80.0,2.0,80.0,1948
15588,66,34,100,3,4,80.0,2.0,80.0,1948
15589,94,6,100,3,5,80.0,2.0,80.0,1948
15590,25,75,100,3,6,80.0,2.0,80.0,1948
15591,86,14,100,3,7,80.0,2.0,80.0,1948
15592,0,0,0,1,0,80.0,2.0,80.0,1949
15593,8,13,21,1,1,80.0,2.0,80.0,1949
15594,0,50,50,2,2,80.0,2.0,80.0,1949
15595,-79,79,0,2,3,80.0,2.0,80.0,1949
15596,4,37,41,3,4,80.0,2.0,80.0,1949
15597,29,0,29,3,5,80.0,2.0,80.0,1949
15598,28,22,50,3,6,80.0,2.0,80.0,1949
15599,1,50,51,3,7,80.0,2.0,80.0,1949
15600,88,2,90,1,0,80.0,2.0,80.0,1950
15601,65,0,65,1,1,80.0,2.0,80.0,1950
15602,2,75,77,2,2,80.0,2.0,80.0,1950
15603,22,78,100,2,3,80.0,2.0,80.0,1950
15604,24,66,90,3,4,80.0,2.0,80.0,1950
15605,51,38,89,3,5,80.0,2.0,80.0,1950
15606,70,8,78,3,6,80.0,2.0,80.0,1950
15607,60,0,60,3,7,80.0,2.0,80.0,1950
15608,-6,91,85,1,0,80.0,2.0,80.0,1951
15609,-15,100,85,1,1,80.0,2.0,80.0,1951
15610,4,82,86,2,2,80.0,2.0,80.0,1951
15611,2,78,80,2,3,80.0,2.0,80.0,1951
15612,-17,100,83,3,4,80.0,2.0,80.0,1951
15613,0,91,91,3,5,80.0,2.0,80.0,1951
15614,-6,95,89,3,6,80.0,2.0,80.0,1951
15615,-25,100,75,3,7,80.0,2.0,80.0,1951
15616,20,50,70,1,0,80.0,2.0,80.0,1952
15617,100,0,100,1,1,80.0,2.0,80.0,1952
15618,0,100,100,2,2,80.0,2.0,80.0,1952
15619,0,100,100,2,3,80.0,2.0,80.0,1952
15620,10,90,100,3,4,80.0,2.0,80.0,1952
15621,100,0,100,3,5,80.0,2.0,80.0,1952
15622,90,10,100,3,6,80.0,2.0,80.0,1952
15623,0,0,0,3,7,80.0,2.0,80.0,1952
15624,50,50,100,1,0,80.0,2.0,80.0,1953
15625,99,0,99,1,1,80.0,2.0,80.0,1953
15626,50,50,100,2,2,80.0,2.0,80.0,1953
15627,0,100,100,2,3,80.0,2.0,80.0,1953
15628,36,64,100,3,4,80.0,2.0,80.0,1953
15629,50,50,100,3,5,80.0,2.0,80.0,1953
15630,84,16,100,3,6,80.0,2.0,80.0,1953
15631,89,0,89,3,7,80.0,2.0,80.0,1953
15632,100,0,100,1,0,80.0,2.0,80.0,1954
15633,23,77,100,1,1,80.0,2.0,80.0,1954
15634,0,100,100,2,2,80.0,2.0,80.0,1954
15635,2,98,100,2,3,80.0,2.0,80.0,1954
15636,37,50,87,3,4,80.0,2.0,80.0,1954
15637,50,50,100,3,5,80.0,2.0,80.0,1954
15638,50,50,100,3,6,80.0,2.0,80.0,1954
15639,37,50,87,3,7,80.0,2.0,80.0,1954
15640,75,0,75,1,0,80.0,2.0,80.0,1955
15641,35,45,80,1,1,80.0,2.0,80.0,1955
15642,15,80,95,2,2,80.0,2.0,80.0,1955
15643,23,77,100,2,3,80.0,2.0,80.0,1955
15644,25,60,85,3,4,80.0,2.0,80.0,1955
15645,65,30,95,3,5,80.0,2.0,80.0,1955
15646,40,50,90,3,6,80.0,2.0,80.0,1955
15647,80,0,80,3,7,80.0,2.0,80.0,1955
15648,-27,50,23,1,0,80.0,2.0,80.0,1956
15649,0,50,50,1,1,80.0,2.0,80.0,1956
15650,1,95,96,2,2,80.0,2.0,80.0,1956
15651,9,79,88,2,3,80.0,2.0,80.0,1956
15652,8,80,88,3,4,80.0,2.0,80.0,1956
15653,-14,50,36,3,5,80.0,2.0,80.0,1956
15654,-7,32,25,3,6,80.0,2.0,80.0,1956
15655,54,10,64,3,7,80.0,2.0,80.0,1956
15656,100,0,100,1,0,80.0,2.0,80.0,1957
15657,-25,25,0,1,1,80.0,2.0,80.0,1957
15658,0,100,100,2,2,80.0,2.0,80.0,1957
15659,0,100,100,2,3,80.0,2.0,80.0,1957
15660,100,0,100,3,4,80.0,2.0,80.0,1957
15661,20,80,100,3,5,80.0,2.0,80.0,1957
15662,100,0,100,3,6,80.0,2.0,80.0,1957
15663,100,0,100,3,7,80.0,2.0,80.0,1957
15664,-30,30,0,1,0,80.0,2.0,80.0,1958
15665,0,0,0,1,1,80.0,2.0,80.0,1958
15666,-50,100,50,2,2,80.0,2.0,80.0,1958
15667,0,100,100,2,3,80.0,2.0,80.0,1958
15668,50,50,100,3,4,80.0,2.0,80.0,1958
15669,20,30,50,3,5,80.0,2.0,80.0,1958
15670,0,100,100,3,6,80.0,2.0,80.0,1958
15671,50,50,100,3,7,80.0,2.0,80.0,1958
15672,0,50,50,1,0,80.0,2.0,80.0,1959
15673,0,20,20,1,1,80.0,2.0,80.0,1959
15674,0,95,95,2,2,80.0,2.0,80.0,1959
15675,0,50,50,2,3,80.0,2.0,80.0,1959
15676,0,80,80,3,4,80.0,2.0,80.0,1959
15677,0,20,20,3,5,80.0,2.0,80.0,1959
15678,0,40,40,3,6,80.0,2.0,80.0,1959
15679,0,50,50,3,7,80.0,2.0,80.0,1959
15680,30,50,80,1,0,80.0,2.0,80.0,1960
15681,25,50,75,1,1,80.0,2.0,80.0,1960
15682,25,50,75,2,2,80.0,2.0,80.0,1960
15683,10,85,95,2,3,80.0,2.0,80.0,1960
15684,35,35,70,3,4,80.0,2.0,80.0,1960
15685,35,50,85,3,5,80.0,2.0,80.0,1960
15686,55,35,90,3,6,80.0,2.0,80.0,1960
15687,60,15,75,3,7,80.0,2.0,80.0,1960
15688,70,0,70,1,0,80.0,2.0,80.0,1961
15689,10,90,100,1,1,80.0,2.0,80.0,1961
15690,80,20,100,2,2,80.0,2.0,80.0,1961
15691,65,25,90,2,3,80.0,2.0,80.0,1961
15692,55,45,100,3,4,80.0,2.0,80.0,1961
15693,25,75,100,3,5,80.0,2.0,80.0,1961
15694,10,90,100,3,6,80.0,2.0,80.0,1961
15695,99,0,99,3,7,80.0,2.0,80.0,1961
15696,50,10,60,1,0,80.0,2.0,80.0,1962
15697,60,0,60,1,1,80.0,2.0,80.0,1962
15698,0,90,90,2,2,80.0,2.0,80.0,1962
15699,10,70,80,2,3,80.0,2.0,80.0,1962
15700,35,25,60,3,4,80.0,2.0,80.0,1962
15701,0,60,60,3,5,80.0,2.0,80.0,1962
15702,-10,25,15,3,6,80.0,2.0,80.0,1962
15703,30,5,35,3,7,80.0,2.0,80.0,1962
15704,41,59,100,1,0,80.0,2.0,80.0,1963
15705,22,78,100,1,1,80.0,2.0,80.0,1963
15706,0,100,100,2,2,80.0,2.0,80.0,1963
15707,40,60,100,2,3,80.0,2.0,80.0,1963
15708,25,75,100,3,4,80.0,2.0,80.0,1963
15709,21,79,100,3,5,80.0,2.0,80.0,1963
15710,49,51,100,3,6,80.0,2.0,80.0,1963
15711,32,68,100,3,7,80.0,2.0,80.0,1963
15712,72,0,72,1,0,80.0,2.0,80.0,1964
15713,84,10,94,1,1,80.0,2.0,80.0,1964
15714,16,80,96,2,2,80.0,2.0,80.0,1964
15715,0,100,100,2,3,80.0,2.0,80.0,1964
15716,20,67,87,3,4,80.0,2.0,80.0,1964
15717,52,30,82,3,5,80.0,2.0,80.0,1964
15718,50,29,79,3,6,80.0,2.0,80.0,1964
15719,67,9,76,3,7,80.0,2.0,80.0,1964
15720,25,10,35,1,0,80.0,2.0,80.0,1965
15721,66,25,91,1,1,80.0,2.0,80.0,1965
15722,15,85,100,2,2,80.0,2.0,80.0,1965
15723,2,98,100,2,3,80.0,2.0,80.0,1965
15724,12,76,88,3,4,80.0,2.0,80.0,1965
15725,-9,84,75,3,5,80.0,2.0,80.0,1965
15726,36,14,50,3,6,80.0,2.0,80.0,1965
15727,2,32,34,3,7,80.0,2.0,80.0,1965
15728,-42,50,8,1,0,80.0,2.0,80.0,1966
15729,50,50,100,1,1,80.0,2.0,80.0,1966
15730,3,96,99,2,2,80.0,2.0,80.0,1966
15731,0,100,100,2,3,80.0,2.0,80.0,1966
15732,82,18,100,3,4,80.0,2.0,80.0,1966
15733,50,50,100,3,5,80.0,2.0,80.0,1966
15734,50,50,100,3,6,80.0,2.0,80.0,1966
15735,-78,100,22,3,7,80.0,2.0,80.0,1966
15736,100,0,100,1,0,80.0,2.0,80.0,1967
15737,100,0,100,1,1,80.0,2.0,80.0,1967
15738,-100,100,0,2,2,80.0,2.0,80.0,1967
15739,0,100,100,2,3,80.0,2.0,80.0,1967
15740,0,100,100,3,4,80.0,2.0,80.0,1967
15741,72,28,100,3,5,80.0,2.0,80.0,1967
15742,100,0,100,3,6,80.0,2.0,80.0,1967
15743,100,0,100,3,7,80.0,2.0,80.0,1967
15744,-12,12,0,1,0,81.0,2.0,81.0,1968
15745,-2,2,0,1,1,81.0,2.0,81.0,1968
15746,-11,87,76,2,2,81.0,2.0,81.0,1968
15747,-8,8,0,2,3,81.0,2.0,81.0,1968
15748,-6,90,84,3,4,81.0,2.0,81.0,1968
15749,62,5,67,3,5,81.0,2.0,81.0,1968
15750,-12,75,63,3,6,81.0,2.0,81.0,1968
15751,82,0,82,3,7,81.0,2.0,81.0,1968
15752,3,9,12,1,0,81.0,2.0,81.0,1969
15753,16,22,38,1,1,81.0,2.0,81.0,1969
15754,0,89,89,2,2,81.0,2.0,81.0,1969
15755,0,95,95,2,3,81.0,2.0,81.0,1969
15756,4,91,95,3,4,81.0,2.0,81.0,1969
15757,65,25,90,3,5,81.0,2.0,81.0,1969
15758,4,9,13,3,6,81.0,2.0,81.0,1969
15759,58,5,63,3,7,81.0,2.0,81.0,1969
15760,-15,15,0,1,0,81.0,2.0,81.0,1970
15761,70,4,74,1,1,81.0,2.0,81.0,1970
15762,41,50,91,2,2,81.0,2.0,81.0,1970
15763,-4,100,96,2,3,81.0,2.0,81.0,1970
15764,22,73,95,3,4,81.0,2.0,81.0,1970
15765,45,50,95,3,5,81.0,2.0,81.0,1970
15766,-19,25,6,3,6,81.0,2.0,81.0,1970
15767,78,13,91,3,7,81.0,2.0,81.0,1970
15768,32,25,57,1,0,81.0,2.0,81.0,1971
15769,46,6,52,1,1,81.0,2.0,81.0,1971
15770,5,95,100,2,2,81.0,2.0,81.0,1971
15771,0,100,100,2,3,81.0,2.0,81.0,1971
15772,0,100,100,3,4,81.0,2.0,81.0,1971
15773,39,61,100,3,5,81.0,2.0,81.0,1971
15774,97,3,100,3,6,81.0,2.0,81.0,1971
15775,39,47,86,3,7,81.0,2.0,81.0,1971
15776,100,0,100,1,0,81.0,2.0,81.0,1972
15777,15,85,100,1,1,81.0,2.0,81.0,1972
15778,49,51,100,2,2,81.0,2.0,81.0,1972
15779,67,33,100,2,3,81.0,2.0,81.0,1972
15780,53,18,71,3,4,81.0,2.0,81.0,1972
15781,44,56,100,3,5,81.0,2.0,81.0,1972
15782,51,49,100,3,6,81.0,2.0,81.0,1972
15783,98,2,100,3,7,81.0,2.0,81.0,1972
15784,8,92,100,1,0,81.0,2.0,81.0,1973
15785,89,11,100,1,1,81.0,2.0,81.0,1973
15786,92,8,100,2,2,81.0,2.0,81.0,1973
15787,77,23,100,2,3,81.0,2.0,81.0,1973
15788,0,100,100,3,4,81.0,2.0,81.0,1973
15789,2,98,100,3,5,81.0,2.0,81.0,1973
15790,19,81,100,3,6,81.0,2.0,81.0,1973
15791,-1,1,0,3,7,81.0,2.0,81.0,1973
15792,62,9,71,1,0,81.0,2.0,81.0,1974
15793,-2,77,75,1,1,81.0,2.0,81.0,1974
15794,47,24,71,2,2,81.0,2.0,81.0,1974
15795,39,36,75,2,3,81.0,2.0,81.0,1974
15796,0,71,71,3,4,81.0,2.0,81.0,1974
15797,22,50,72,3,5,81.0,2.0,81.0,1974
15798,22,49,71,3,6,81.0,2.0,81.0,1974
15799,39,32,71,3,7,81.0,2.0,81.0,1974
15800,-1,25,24,1,0,81.0,2.0,81.0,1975
15801,10,75,85,1,1,81.0,2.0,81.0,1975
15802,-12,75,63,2,2,81.0,2.0,81.0,1975
15803,8,70,78,2,3,81.0,2.0,81.0,1975
15804,12,78,90,3,4,81.0,2.0,81.0,1975
15805,8,72,80,3,5,81.0,2.0,81.0,1975
15806,14,77,91,3,6,81.0,2.0,81.0,1975
15807,14,76,90,3,7,81.0,2.0,81.0,1975
15808,63,0,63,1,0,81.0,2.0,81.0,1976
15809,25,11,36,1,1,81.0,2.0,81.0,1976
15810,0,100,100,2,2,81.0,2.0,81.0,1976
15811,0,100,100,2,3,81.0,2.0,81.0,1976
15812,13,75,88,3,4,81.0,2.0,81.0,1976
15813,52,38,90,3,5,81.0,2.0,81.0,1976
15814,7,81,88,3,6,81.0,2.0,81.0,1976
15815,18,13,31,3,7,81.0,2.0,81.0,1976
15816,-63,79,16,1,0,81.0,2.0,81.0,1977
15817,0,0,0,1,1,81.0,2.0,81.0,1977
15818,0,100,100,2,2,81.0,2.0,81.0,1977
15819,0,100,100,2,3,81.0,2.0,81.0,1977
15820,0,100,100,3,4,81.0,2.0,81.0,1977
15821,-12,12,0,3,5,81.0,2.0,81.0,1977
15822,0,100,100,3,6,81.0,2.0,81.0,1977
15823,4,12,16,3,7,81.0,2.0,81.0,1977
15824,0,0,0,1,0,81.0,2.0,81.0,1978
15825,50,50,100,1,1,81.0,2.0,81.0,1978
15826,50,50,100,2,2,81.0,2.0,81.0,1978
15827,0,100,100,2,3,81.0,2.0,81.0,1978
15828,50,50,100,3,4,81.0,2.0,81.0,1978
15829,50,50,100,3,5,81.0,2.0,81.0,1978
15830,50,50,100,3,6,81.0,2.0,81.0,1978
15831,0,0,0,3,7,81.0,2.0,81.0,1978
15832,22,21,43,1,0,81.0,2.0,81.0,1979
15833,63,0,63,1,1,81.0,2.0,81.0,1979
15834,-15,100,85,2,2,81.0,2.0,81.0,1979
15835,0,100,100,2,3,81.0,2.0,81.0,1979
15836,-19,100,81,3,4,81.0,2.0,81.0,1979
15837,-55,92,37,3,5,81.0,2.0,81.0,1979
15838,0,100,100,3,6,81.0,2.0,81.0,1979
15839,61,0,61,3,7,81.0,2.0,81.0,1979
15840,2,3,5,1,0,81.0,2.0,81.0,1980
15841,13,62,75,1,1,81.0,2.0,81.0,1980
15842,-1,86,85,2,2,81.0,2.0,81.0,1980
15843,13,79,92,2,3,81.0,2.0,81.0,1980
15844,0,50,50,3,4,81.0,2.0,81.0,1980
15845,6,15,21,3,5,81.0,2.0,81.0,1980
15846,3,16,19,3,6,81.0,2.0,81.0,1980
15847,-86,92,6,3,7,81.0,2.0,81.0,1980
15848,59,38,97,1,0,81.0,2.0,81.0,1981
15849,8,59,67,1,1,81.0,2.0,81.0,1981
15850,46,54,100,2,2,81.0,2.0,81.0,1981
15851,56,33,89,2,3,81.0,2.0,81.0,1981
15852,20,60,80,3,4,81.0,2.0,81.0,1981
15853,75,21,96,3,5,81.0,2.0,81.0,1981
15854,57,41,98,3,6,81.0,2.0,81.0,1981
15855,54,36,90,3,7,81.0,2.0,81.0,1981
15856,3,8,11,1,0,81.0,2.0,81.0,1982
15857,3,64,67,1,1,81.0,2.0,81.0,1982
15858,-1,78,77,2,2,81.0,2.0,81.0,1982
15859,2,16,18,2,3,81.0,2.0,81.0,1982
15860,-11,84,73,3,4,81.0,2.0,81.0,1982
15861,0,67,67,3,5,81.0,2.0,81.0,1982
15862,-1,60,59,3,6,81.0,2.0,81.0,1982
15863,1,9,10,3,7,81.0,2.0,81.0,1982
15864,17,0,17,1,0,81.0,2.0,81.0,1983
15865,8,42,50,1,1,81.0,2.0,81.0,1983
15866,8,92,100,2,2,81.0,2.0,81.0,1983
15867,5,95,100,2,3,81.0,2.0,81.0,1983
15868,21,79,100,3,4,81.0,2.0,81.0,1983
15869,48,39,87,3,5,81.0,2.0,81.0,1983
15870,37,40,77,3,6,81.0,2.0,81.0,1983
15871,25,0,25,3,7,81.0,2.0,81.0,1983
15872,-5,42,37,1,0,81.0,2.0,81.0,1984
15873,0,38,38,1,1,81.0,2.0,81.0,1984
15874,-22,62,40,2,2,81.0,2.0,81.0,1984
15875,-3,66,63,2,3,81.0,2.0,81.0,1984
15876,-4,44,40,3,4,81.0,2.0,81.0,1984
15877,-1,37,36,3,5,81.0,2.0,81.0,1984
15878,-1,73,72,3,6,81.0,2.0,81.0,1984
15879,0,39,39,3,7,81.0,2.0,81.0,1984
15880,0,50,50,1,0,81.0,2.0,81.0,1985
15881,-24,100,76,1,1,81.0,2.0,81.0,1985
15882,-24,100,76,2,2,81.0,2.0,81.0,1985
15883,65,11,76,2,3,81.0,2.0,81.0,1985
15884,12,0,12,3,4,81.0,2.0,81.0,1985
15885,63,37,100,3,5,81.0,2.0,81.0,1985
15886,50,50,100,3,6,81.0,2.0,81.0,1985
15887,50,0,50,3,7,81.0,2.0,81.0,1985
15888,91,9,100,1,0,81.0,2.0,81.0,1986
15889,41,59,100,1,1,81.0,2.0,81.0,1986
15890,91,9,100,2,2,81.0,2.0,81.0,1986
15891,86,14,100,2,3,81.0,2.0,81.0,1986
15892,0,100,100,3,4,81.0,2.0,81.0,1986
15893,88,12,100,3,5,81.0,2.0,81.0,1986
15894,95,5,100,3,6,81.0,2.0,81.0,1986
15895,26,1,27,3,7,81.0,2.0,81.0,1986
15896,-66,84,18,1,0,81.0,2.0,81.0,1987
15897,-17,92,75,1,1,81.0,2.0,81.0,1987
15898,-14,100,86,2,2,81.0,2.0,81.0,1987
15899,-10,100,90,2,3,81.0,2.0,81.0,1987
15900,63,25,88,3,4,81.0,2.0,81.0,1987
15901,-17,84,67,3,5,81.0,2.0,81.0,1987
15902,-38,38,0,3,6,81.0,2.0,81.0,1987
15903,58,22,80,3,7,81.0,2.0,81.0,1987
15904,13,3,16,1,0,81.0,2.0,81.0,1988
15905,63,4,67,1,1,81.0,2.0,81.0,1988
15906,0,91,91,2,2,81.0,2.0,81.0,1988
15907,4,89,93,2,3,81.0,2.0,81.0,1988
15908,9,55,64,3,4,81.0,2.0,81.0,1988
15909,8,50,58,3,5,81.0,2.0,81.0,1988
15910,-5,38,33,3,6,81.0,2.0,81.0,1988
15911,14,1,15,3,7,81.0,2.0,81.0,1988
15912,17,41,58,1,0,81.0,2.0,81.0,1989
15913,29,26,55,1,1,81.0,2.0,81.0,1989
15914,13,82,95,2,2,81.0,2.0,81.0,1989
15915,5,95,100,2,3,81.0,2.0,81.0,1989
15916,26,52,78,3,4,81.0,2.0,81.0,1989
15917,25,50,75,3,5,81.0,2.0,81.0,1989
15918,48,42,90,3,6,81.0,2.0,81.0,1989
15919,38,25,63,3,7,81.0,2.0,81.0,1989
15920,8,87,95,1,0,81.0,2.0,81.0,1990
15921,-3,93,90,1,1,81.0,2.0,81.0,1990
15922,13,84,97,2,2,81.0,2.0,81.0,1990
15923,23,73,96,2,3,81.0,2.0,81.0,1990
15924,-50,86,36,3,4,81.0,2.0,81.0,1990
15925,47,44,91,3,5,81.0,2.0,81.0,1990
15926,25,69,94,3,6,81.0,2.0,81.0,1990
15927,52,35,87,3,7,81.0,2.0,81.0,1990
15928,-5,35,30,1,0,81.0,2.0,81.0,1991
15929,-41,51,10,1,1,81.0,2.0,81.0,1991
15930,5,75,80,2,2,81.0,2.0,81.0,1991
15931,15,65,80,2,3,81.0,2.0,81.0,1991
15932,19,24,43,3,4,81.0,2.0,81.0,1991
15933,9,45,54,3,5,81.0,2.0,81.0,1991
15934,6,87,93,3,6,81.0,2.0,81.0,1991
15935,36,12,48,3,7,81.0,2.0,81.0,1991
15936,16,23,39,1,0,81.0,2.0,81.0,1992
15937,-22,90,68,1,1,81.0,2.0,81.0,1992
15938,4,88,92,2,2,81.0,2.0,81.0,1992
15939,0,100,100,2,3,81.0,2.0,81.0,1992
15940,0,76,76,3,4,81.0,2.0,81.0,1992
15941,-49,75,26,3,5,81.0,2.0,81.0,1992
15942,45,18,63,3,6,81.0,2.0,81.0,1992
15943,2,58,60,3,7,81.0,2.0,81.0,1992
15944,-1,51,50,1,0,81.0,2.0,81.0,1993
15945,0,50,50,1,1,81.0,2.0,81.0,1993
15946,-1,51,50,2,2,81.0,2.0,81.0,1993
15947,-1,51,50,2,3,81.0,2.0,81.0,1993
15948,-2,52,50,3,4,81.0,2.0,81.0,1993
15949,0,50,50,3,5,81.0,2.0,81.0,1993
15950,-1,51,50,3,6,81.0,2.0,81.0,1993
15951,0,50,50,3,7,81.0,2.0,81.0,1993
15952,24,2,26,1,0,81.0,2.0,81.0,1994
15953,20,3,23,1,1,81.0,2.0,81.0,1994
15954,8,78,86,2,2,81.0,2.0,81.0,1994
15955,77,3,80,2,3,81.0,2.0,81.0,1994
15956,22,69,91,3,4,81.0,2.0,81.0,1994
15957,60,19,79,3,5,81.0,2.0,81.0,1994
15958,-39,42,3,3,6,81.0,2.0,81.0,1994
15959,83,1,84,3,7,81.0,2.0,81.0,1994
15960,0,0,0,1,0,82.0,2.0,82.0,1995
15961,0,0,0,1,1,82.0,2.0,82.0,1995
15962,50,0,50,2,2,82.0,2.0,82.0,1995
15963,100,0,100,2,3,82.0,2.0,82.0,1995
15964,0,50,50,3,4,82.0,2.0,82.0,1995
15965,50,0,50,3,5,82.0,2.0,82.0,1995
15966,0,55,55,3,6,82.0,2.0,82.0,1995
15967,0,0,0,3,7,82.0,2.0,82.0,1995
15968,12,31,43,1,0,82.0,2.0,82.0,1996
15969,-9,39,30,1,1,82.0,2.0,82.0,1996
15970,-27,60,33,2,2,82.0,2.0,82.0,1996
15971,-35,61,26,2,3,82.0,2.0,82.0,1996
15972,5,66,71,3,4,82.0,2.0,82.0,1996
15973,-6,37,31,3,5,82.0,2.0,82.0,1996
15974,-11,45,34,3,6,82.0,2.0,82.0,1996
15975,-6,37,31,3,7,82.0,2.0,82.0,1996
15976,17,79,96,1,0,82.0,2.0,82.0,1997
15977,-12,92,80,1,1,82.0,2.0,82.0,1997
15978,14,85,99,2,2,82.0,2.0,82.0,1997
15979,11,87,98,2,3,82.0,2.0,82.0,1997
15980,20,6,26,3,4,82.0,2.0,82.0,1997
15981,1,90,91,3,5,82.0,2.0,82.0,1997
15982,67,28,95,3,6,82.0,2.0,82.0,1997
15983,5,4,9,3,7,82.0,2.0,82.0,1997
15984,41,43,84,1,0,82.0,2.0,82.0,1998
15985,19,55,74,1,1,82.0,2.0,82.0,1998
15986,26,57,83,2,2,82.0,2.0,82.0,1998
15987,23,57,80,2,3,82.0,2.0,82.0,1998
15988,33,47,80,3,4,82.0,2.0,82.0,1998
15989,28,41,69,3,5,82.0,2.0,82.0,1998
15990,87,0,87,3,6,82.0,2.0,82.0,1998
15991,22,61,83,3,7,82.0,2.0,82.0,1998
15992,2,0,2,1,0,82.0,2.0,82.0,1999
15993,2,89,91,1,1,82.0,2.0,82.0,1999
15994,42,50,92,2,2,82.0,2.0,82.0,1999
15995,-100,100,0,2,3,82.0,2.0,82.0,1999
15996,2,64,66,3,4,82.0,2.0,82.0,1999
15997,30,50,80,3,5,82.0,2.0,82.0,1999
15998,14,86,100,3,6,82.0,2.0,82.0,1999
15999,61,27,88,3,7,82.0,2.0,82.0,1999
16000,62,26,88,1,0,82.0,2.0,82.0,2000
16001,64,19,83,1,1,82.0,2.0,82.0,2000
16002,52,26,78,2,2,82.0,2.0,82.0,2000
16003,49,37,86,2,3,82.0,2.0,82.0,2000
16004,20,68,88,3,4,82.0,2.0,82.0,2000
16005,55,27,82,3,5,82.0,2.0,82.0,2000
16006,20,61,81,3,6,82.0,2.0,82.0,2000
16007,78,7,85,3,7,82.0,2.0,82.0,2000
16008,100,0,100,1,0,82.0,2.0,82.0,2001
16009,82,18,100,1,1,82.0,2.0,82.0,2001
16010,37,63,100,2,2,82.0,2.0,82.0,2001
16011,-87,87,0,2,3,82.0,2.0,82.0,2001
16012,71,29,100,3,4,82.0,2.0,82.0,2001
16013,54,46,100,3,5,82.0,2.0,82.0,2001
16014,63,37,100,3,6,82.0,2.0,82.0,2001
16015,100,0,100,3,7,82.0,2.0,82.0,2001
16016,68,13,81,1,0,82.0,2.0,82.0,2002
16017,61,25,86,1,1,82.0,2.0,82.0,2002
16018,40,52,92,2,2,82.0,2.0,82.0,2002
16019,33,47,80,2,3,82.0,2.0,82.0,2002
16020,15,79,94,3,4,82.0,2.0,82.0,2002
16021,3,53,56,3,5,82.0,2.0,82.0,2002
16022,68,24,92,3,6,82.0,2.0,82.0,2002
16023,-25,34,9,3,7,82.0,2.0,82.0,2002
16024,78,0,78,1,0,82.0,2.0,82.0,2003
16025,-20,38,18,1,1,82.0,2.0,82.0,2003
16026,-15,64,49,2,2,82.0,2.0,82.0,2003
16027,-81,93,12,2,3,82.0,2.0,82.0,2003
16028,32,63,95,3,4,82.0,2.0,82.0,2003
16029,52,23,75,3,5,82.0,2.0,82.0,2003
16030,24,73,97,3,6,82.0,2.0,82.0,2003
16031,75,11,86,3,7,82.0,2.0,82.0,2003
16032,10,1,11,1,0,82.0,2.0,82.0,2004
16033,75,10,85,1,1,82.0,2.0,82.0,2004
16034,2,93,95,2,2,82.0,2.0,82.0,2004
16035,-7,98,91,2,3,82.0,2.0,82.0,2004
16036,43,50,93,3,4,82.0,2.0,82.0,2004
16037,43,50,93,3,5,82.0,2.0,82.0,2004
16038,37,45,82,3,6,82.0,2.0,82.0,2004
16039,42,21,63,3,7,82.0,2.0,82.0,2004
16040,70,21,91,1,0,82.0,2.0,82.0,2005
16041,-12,12,0,1,1,82.0,2.0,82.0,2005
16042,77,20,97,2,2,82.0,2.0,82.0,2005
16043,-4,10,6,2,3,82.0,2.0,82.0,2005
16044,46,50,96,3,4,82.0,2.0,82.0,2005
16045,83,15,98,3,5,82.0,2.0,82.0,2005
16046,19,81,100,3,6,82.0,2.0,82.0,2005
16047,78,17,95,3,7,82.0,2.0,82.0,2005
16048,100,0,100,1,0,82.0,2.0,82.0,2006
16049,50,50,100,1,1,82.0,2.0,82.0,2006
16050,50,50,100,2,2,82.0,2.0,82.0,2006
16051,4,96,100,2,3,82.0,2.0,82.0,2006
16052,36,64,100,3,4,82.0,2.0,82.0,2006
16053,37,63,100,3,5,82.0,2.0,82.0,2006
16054,50,50,100,3,6,82.0,2.0,82.0,2006
16055,100,0,100,3,7,82.0,2.0,82.0,2006
16056,-5,100,95,1,0,82.0,2.0,82.0,2007
16057,0,99,99,1,1,82.0,2.0,82.0,2007
16058,-7,93,86,2,2,82.0,2.0,82.0,2007
16059,-8,92,84,2,3,82.0,2.0,82.0,2007
16060,0,100,100,3,4,82.0,2.0,82.0,2007
16061,2,93,95,3,5,82.0,2.0,82.0,2007
16062,-16,97,81,3,6,82.0,2.0,82.0,2007
16063,-9,92,83,3,7,82.0,2.0,82.0,2007
16064,78,5,83,1,0,82.0,2.0,82.0,2008
16065,100,0,100,1,1,82.0,2.0,82.0,2008
16066,54,30,84,2,2,82.0,2.0,82.0,2008
16067,27,73,100,2,3,82.0,2.0,82.0,2008
16068,23,77,100,3,4,82.0,2.0,82.0,2008
16069,64,36,100,3,5,82.0,2.0,82.0,2008
16070,79,21,100,3,6,82.0,2.0,82.0,2008
16071,78,22,100,3,7,82.0,2.0,82.0,2008
16072,83,17,100,1,0,82.0,2.0,82.0,2009
16073,0,100,100,1,1,82.0,2.0,82.0,2009
16074,4,77,81,2,2,82.0,2.0,82.0,2009
16075,62,26,88,2,3,82.0,2.0,82.0,2009
16076,23,72,95,3,4,82.0,2.0,82.0,2009
16077,54,28,82,3,5,82.0,2.0,82.0,2009
16078,61,34,95,3,6,82.0,2.0,82.0,2009
16079,37,50,87,3,7,82.0,2.0,82.0,2009
16080,4,15,19,1,0,82.0,2.0,82.0,2010
16081,54,28,82,1,1,82.0,2.0,82.0,2010
16082,10,75,85,2,2,82.0,2.0,82.0,2010
16083,56,38,94,2,3,82.0,2.0,82.0,2010
16084,64,30,94,3,4,82.0,2.0,82.0,2010
16085,-14,29,15,3,5,82.0,2.0,82.0,2010
16086,-5,27,22,3,6,82.0,2.0,82.0,2010
16087,78,22,100,3,7,82.0,2.0,82.0,2010
16088,50,0,50,1,0,82.0,2.0,82.0,2011
16089,76,22,98,1,1,82.0,2.0,82.0,2011
16090,-18,68,50,2,2,82.0,2.0,82.0,2011
16091,24,76,100,2,3,82.0,2.0,82.0,2011
16092,27,60,87,3,4,82.0,2.0,82.0,2011
16093,68,24,92,3,5,82.0,2.0,82.0,2011
16094,71,29,100,3,6,82.0,2.0,82.0,2011
16095,80,0,80,3,7,82.0,2.0,82.0,2011
16096,5,77,82,1,0,82.0,2.0,82.0,2012
16097,75,25,100,1,1,82.0,2.0,82.0,2012
16098,25,75,100,2,2,82.0,2.0,82.0,2012
16099,0,100,100,2,3,82.0,2.0,82.0,2012
16100,50,50,100,3,4,82.0,2.0,82.0,2012
16101,50,50,100,3,5,82.0,2.0,82.0,2012
16102,12,88,100,3,6,82.0,2.0,82.0,2012
16103,2,76,78,3,7,82.0,2.0,82.0,2012
16104,25,1,26,1,0,82.0,2.0,82.0,2013
16105,7,0,7,1,1,82.0,2.0,82.0,2013
16106,-18,100,82,2,2,82.0,2.0,82.0,2013
16107,0,100,100,2,3,82.0,2.0,82.0,2013
16108,-9,75,66,3,4,82.0,2.0,82.0,2013
16109,-12,12,0,3,5,82.0,2.0,82.0,2013
16110,13,76,89,3,6,82.0,2.0,82.0,2013
16111,63,24,87,3,7,82.0,2.0,82.0,2013
16112,45,0,45,1,0,82.0,2.0,82.0,2014
16113,13,39,52,1,1,82.0,2.0,82.0,2014
16114,-13,95,82,2,2,82.0,2.0,82.0,2014
16115,-6,82,76,2,3,82.0,2.0,82.0,2014
16116,1,76,77,3,4,82.0,2.0,82.0,2014
16117,25,32,57,3,5,82.0,2.0,82.0,2014
16118,-3,80,77,3,6,82.0,2.0,82.0,2014
16119,9,36,45,3,7,82.0,2.0,82.0,2014
16120,87,5,92,1,0,82.0,2.0,82.0,2015
16121,-7,57,50,1,1,82.0,2.0,82.0,2015
16122,9,91,100,2,2,82.0,2.0,82.0,2015
16123,0,100,100,2,3,82.0,2.0,82.0,2015
16124,-25,83,58,3,4,82.0,2.0,82.0,2015
16125,74,26,100,3,5,82.0,2.0,82.0,2015
16126,9,50,59,3,6,82.0,2.0,82.0,2015
16127,54,4,58,3,7,82.0,2.0,82.0,2015
16128,-1,76,75,1,0,82.0,2.0,82.0,2016
16129,-11,87,76,1,1,82.0,2.0,82.0,2016
16130,-4,83,79,2,2,82.0,2.0,82.0,2016
16131,-4,66,62,2,3,82.0,2.0,82.0,2016
16132,-12,84,72,3,4,82.0,2.0,82.0,2016
16133,-16,81,65,3,5,82.0,2.0,82.0,2016
16134,-4,81,77,3,6,82.0,2.0,82.0,2016
16135,-19,94,75,3,7,82.0,2.0,82.0,2016
16136,35,26,61,1,0,82.0,2.0,82.0,2017
16137,-1,70,69,1,1,82.0,2.0,82.0,2017
16138,-5,84,79,2,2,82.0,2.0,82.0,2017
16139,0,100,100,2,3,82.0,2.0,82.0,2017
16140,-14,84,70,3,4,82.0,2.0,82.0,2017
16141,37,34,71,3,5,82.0,2.0,82.0,2017
16142,68,16,84,3,6,82.0,2.0,82.0,2017
16143,32,32,64,3,7,82.0,2.0,82.0,2017
16144,0,0,0,1,0,82.0,2.0,82.0,2018
16145,-6,21,15,1,1,82.0,2.0,82.0,2018
16146,9,91,100,2,2,82.0,2.0,82.0,2018
16147,16,84,100,2,3,82.0,2.0,82.0,2018
16148,12,70,82,3,4,82.0,2.0,82.0,2018
16149,100,0,100,3,5,82.0,2.0,82.0,2018
16150,61,39,100,3,6,82.0,2.0,82.0,2018
16151,11,0,11,3,7,82.0,2.0,82.0,2018
16152,57,24,81,1,0,82.0,2.0,82.0,2019
16153,43,38,81,1,1,82.0,2.0,82.0,2019
16154,15,65,80,2,2,82.0,2.0,82.0,2019
16155,22,63,85,2,3,82.0,2.0,82.0,2019
16156,33,65,98,3,4,82.0,2.0,82.0,2019
16157,40,41,81,3,5,82.0,2.0,82.0,2019
16158,32,51,83,3,6,82.0,2.0,82.0,2019
16159,55,34,89,3,7,82.0,2.0,82.0,2019
16160,100,0,100,1,0,82.0,2.0,82.0,2020
16161,-50,50,0,1,1,82.0,2.0,82.0,2020
16162,-50,100,50,2,2,82.0,2.0,82.0,2020
16163,0,100,100,2,3,82.0,2.0,82.0,2020
16164,50,50,100,3,4,82.0,2.0,82.0,2020
16165,50,50,100,3,5,82.0,2.0,82.0,2020
16166,50,50,100,3,6,82.0,2.0,82.0,2020
16167,100,0,100,3,7,82.0,2.0,82.0,2020
16168,27,50,77,1,0,82.0,2.0,82.0,2021
16169,11,15,26,1,1,82.0,2.0,82.0,2021
16170,-90,93,3,2,2,82.0,2.0,82.0,2021
16171,21,0,21,2,3,82.0,2.0,82.0,2021
16172,15,59,74,3,4,82.0,2.0,82.0,2021
16173,0,50,50,3,5,82.0,2.0,82.0,2021
16174,46,31,77,3,6,82.0,2.0,82.0,2021
16175,18,5,23,3,7,82.0,2.0,82.0,2021
16176,0,50,50,1,0,82.0,2.0,82.0,2022
16177,14,50,64,1,1,82.0,2.0,82.0,2022
16178,1,64,65,2,2,82.0,2.0,82.0,2022
16179,47,12,59,2,3,82.0,2.0,82.0,2022
16180,4,64,68,3,4,82.0,2.0,82.0,2022
16181,51,7,58,3,5,82.0,2.0,82.0,2022
16182,2,62,64,3,6,82.0,2.0,82.0,2022
16183,60,5,65,3,7,82.0,2.0,82.0,2022
16184,0,0,0,1,0,82.0,2.0,82.0,2023
16185,-100,100,0,1,1,82.0,2.0,82.0,2023
16186,40,60,100,2,2,82.0,2.0,82.0,2023
16187,0,100,100,2,3,82.0,2.0,82.0,2023
16188,20,80,100,3,4,82.0,2.0,82.0,2023
16189,20,80,100,3,5,82.0,2.0,82.0,2023
16190,80,20,100,3,6,82.0,2.0,82.0,2023
16191,90,10,100,3,7,82.0,2.0,82.0,2023
16192,2,78,80,1,0,82.0,2.0,82.0,2024
16193,11,78,89,1,1,82.0,2.0,82.0,2024
16194,-11,76,65,2,2,82.0,2.0,82.0,2024
16195,1,89,90,2,3,82.0,2.0,82.0,2024
16196,0,90,90,3,4,82.0,2.0,82.0,2024
16197,6,68,74,3,5,82.0,2.0,82.0,2024
16198,12,65,77,3,6,82.0,2.0,82.0,2024
16199,11,64,75,3,7,82.0,2.0,82.0,2024
16200,0,0,0,1,0,83.0,2.0,83.0,2025
16201,3,67,70,1,1,83.0,2.0,83.0,2025
16202,-65,65,0,2,2,83.0,2.0,83.0,2025
16203,6,70,76,2,3,83.0,2.0,83.0,2025
16204,0,0,0,3,4,83.0,2.0,83.0,2025
16205,-2,29,27,3,5,83.0,2.0,83.0,2025
16206,-2,24,22,3,6,83.0,2.0,83.0,2025
16207,6,0,6,3,7,83.0,2.0,83.0,2025
16208,11,0,11,1,0,83.0,2.0,83.0,2026
16209,72,16,88,1,1,83.0,2.0,83.0,2026
16210,-18,80,62,2,2,83.0,2.0,83.0,2026
16211,72,10,82,2,3,83.0,2.0,83.0,2026
16212,26,50,76,3,4,83.0,2.0,83.0,2026
16213,26,70,96,3,5,83.0,2.0,83.0,2026
16214,6,89,95,3,6,83.0,2.0,83.0,2026
16215,51,34,85,3,7,83.0,2.0,83.0,2026
16216,0,9,9,1,0,83.0,2.0,83.0,2027
16217,-2,12,10,1,1,83.0,2.0,83.0,2027
16218,-1,25,24,2,2,83.0,2.0,83.0,2027
16219,-74,90,16,2,3,83.0,2.0,83.0,2027
16220,3,88,91,3,4,83.0,2.0,83.0,2027
16221,-7,13,6,3,5,83.0,2.0,83.0,2027
16222,-5,99,94,3,6,83.0,2.0,83.0,2027
16223,1,16,17,3,7,83.0,2.0,83.0,2027
16224,15,27,42,1,0,83.0,2.0,83.0,2028
16225,15,7,22,1,1,83.0,2.0,83.0,2028
16226,-22,71,49,2,2,83.0,2.0,83.0,2028
16227,16,84,100,2,3,83.0,2.0,83.0,2028
16228,26,50,76,3,4,83.0,2.0,83.0,2028
16229,33,50,83,3,5,83.0,2.0,83.0,2028
16230,19,74,93,3,6,83.0,2.0,83.0,2028
16231,-6,21,15,3,7,83.0,2.0,83.0,2028
16232,0,0,0,1,0,83.0,2.0,83.0,2029
16233,0,100,100,1,1,83.0,2.0,83.0,2029
16234,24,67,91,2,2,83.0,2.0,83.0,2029
16235,-14,89,75,2,3,83.0,2.0,83.0,2029
16236,70,30,100,3,4,83.0,2.0,83.0,2029
16237,55,36,91,3,5,83.0,2.0,83.0,2029
16238,21,79,100,3,6,83.0,2.0,83.0,2029
16239,-6,6,0,3,7,83.0,2.0,83.0,2029
16240,89,2,91,1,0,83.0,2.0,83.0,2030
16241,12,85,97,1,1,83.0,2.0,83.0,2030
16242,27,50,77,2,2,83.0,2.0,83.0,2030
16243,4,13,17,2,3,83.0,2.0,83.0,2030
16244,73,14,87,3,4,83.0,2.0,83.0,2030
16245,77,16,93,3,5,83.0,2.0,83.0,2030
16246,77,12,89,3,6,83.0,2.0,83.0,2030
16247,73,15,88,3,7,83.0,2.0,83.0,2030
16248,58,42,100,1,0,83.0,2.0,83.0,2031
16249,95,5,100,1,1,83.0,2.0,83.0,2031
16250,95,5,100,2,2,83.0,2.0,83.0,2031
16251,39,61,100,2,3,83.0,2.0,83.0,2031
16252,100,0,100,3,4,83.0,2.0,83.0,2031
16253,50,50,100,3,5,83.0,2.0,83.0,2031
16254,0,100,100,3,6,83.0,2.0,83.0,2031
16255,100,0,100,3,7,83.0,2.0,83.0,2031
16256,53,34,87,1,0,83.0,2.0,83.0,2032
16257,4,75,79,1,1,83.0,2.0,83.0,2032
16258,8,65,73,2,2,83.0,2.0,83.0,2032
16259,6,69,75,2,3,83.0,2.0,83.0,2032
16260,-9,92,83,3,4,83.0,2.0,83.0,2032
16261,35,38,73,3,5,83.0,2.0,83.0,2032
16262,48,37,85,3,6,83.0,2.0,83.0,2032
16263,56,21,77,3,7,83.0,2.0,83.0,2032
16264,0,0,0,1,0,83.0,2.0,83.0,2033
16265,0,0,0,1,1,83.0,2.0,83.0,2033
16266,0,50,50,2,2,83.0,2.0,83.0,2033
16267,0,0,0,2,3,83.0,2.0,83.0,2033
16268,20,80,100,3,4,83.0,2.0,83.0,2033
16269,0,50,50,3,5,83.0,2.0,83.0,2033
16270,-15,34,19,3,6,83.0,2.0,83.0,2033
16271,0,100,100,3,7,83.0,2.0,83.0,2033
16272,-12,81,69,1,0,83.0,2.0,83.0,2034
16273,-15,83,68,1,1,83.0,2.0,83.0,2034
16274,-8,92,84,2,2,83.0,2.0,83.0,2034
16275,-11,84,73,2,3,83.0,2.0,83.0,2034
16276,-3,79,76,3,4,83.0,2.0,83.0,2034
16277,8,79,87,3,5,83.0,2.0,83.0,2034
16278,7,79,86,3,6,83.0,2.0,83.0,2034
16279,-1,82,81,3,7,83.0,2.0,83.0,2034
16280,51,26,77,1,0,83.0,2.0,83.0,2035
16281,74,9,83,1,1,83.0,2.0,83.0,2035
16282,10,61,71,2,2,83.0,2.0,83.0,2035
16283,1,71,72,2,3,83.0,2.0,83.0,2035
16284,14,63,77,3,4,83.0,2.0,83.0,2035
16285,25,37,62,3,5,83.0,2.0,83.0,2035
16286,44,50,94,3,6,83.0,2.0,83.0,2035
16287,43,36,79,3,7,83.0,2.0,83.0,2035
16288,0,50,50,1,0,83.0,2.0,83.0,2036
16289,-2,100,98,1,1,83.0,2.0,83.0,2036
16290,45,50,95,2,2,83.0,2.0,83.0,2036
16291,1,49,50,2,3,83.0,2.0,83.0,2036
16292,21,78,99,3,4,83.0,2.0,83.0,2036
16293,29,35,64,3,5,83.0,2.0,83.0,2036
16294,-40,77,37,3,6,83.0,2.0,83.0,2036
16295,0,0,0,3,7,83.0,2.0,83.0,2036
16296,0,0,0,1,0,83.0,2.0,83.0,2037
16297,0,0,0,1,1,83.0,2.0,83.0,2037
16298,10,90,100,2,2,83.0,2.0,83.0,2037
16299,10,90,100,2,3,83.0,2.0,83.0,2037
16300,50,50,100,3,4,83.0,2.0,83.0,2037
16301,50,50,100,3,5,83.0,2.0,83.0,2037
16302,21,79,100,3,6,83.0,2.0,83.0,2037
16303,7,93,100,3,7,83.0,2.0,83.0,2037
16304,49,0,49,1,0,83.0,2.0,83.0,2038
16305,0,100,100,1,1,83.0,2.0,83.0,2038
16306,51,0,51,2,2,83.0,2.0,83.0,2038
16307,37,0,37,2,3,83.0,2.0,83.0,2038
16308,17,77,94,3,4,83.0,2.0,83.0,2038
16309,17,50,67,3,5,83.0,2.0,83.0,2038
16310,0,100,100,3,6,83.0,2.0,83.0,2038
16311,63,0,63,3,7,83.0,2.0,83.0,2038
16312,8,64,72,1,0,83.0,2.0,83.0,2039
16313,11,80,91,1,1,83.0,2.0,83.0,2039
16314,-16,30,14,2,2,83.0,2.0,83.0,2039
16315,16,71,87,2,3,83.0,2.0,83.0,2039
16316,-40,50,10,3,4,83.0,2.0,83.0,2039
16317,-5,13,8,3,5,83.0,2.0,83.0,2039
16318,-70,85,15,3,6,83.0,2.0,83.0,2039
16319,-35,35,0,3,7,83.0,2.0,83.0,2039
16320,-2,25,23,1,0,83.0,2.0,83.0,2040
16321,6,21,27,1,1,83.0,2.0,83.0,2040
16322,17,80,97,2,2,83.0,2.0,83.0,2040
16323,58,25,83,2,3,83.0,2.0,83.0,2040
16324,-1,90,89,3,4,83.0,2.0,83.0,2040
16325,23,50,73,3,5,83.0,2.0,83.0,2040
16326,2,31,33,3,6,83.0,2.0,83.0,2040
16327,0,50,50,3,7,83.0,2.0,83.0,2040
16328,38,0,38,1,0,83.0,2.0,83.0,2041
16329,43,9,52,1,1,83.0,2.0,83.0,2041
16330,13,84,97,2,2,83.0,2.0,83.0,2041
16331,0,100,100,2,3,83.0,2.0,83.0,2041
16332,26,62,88,3,4,83.0,2.0,83.0,2041
16333,43,50,93,3,5,83.0,2.0,83.0,2041
16334,7,70,77,3,6,83.0,2.0,83.0,2041
16335,48,2,50,3,7,83.0,2.0,83.0,2041
16336,10,7,17,1,0,83.0,2.0,83.0,2042
16337,-23,90,67,1,1,83.0,2.0,83.0,2042
16338,0,100,100,2,2,83.0,2.0,83.0,2042
16339,64,36,100,2,3,83.0,2.0,83.0,2042
16340,-29,38,9,3,4,83.0,2.0,83.0,2042
16341,24,55,79,3,5,83.0,2.0,83.0,2042
16342,0,100,100,3,6,83.0,2.0,83.0,2042
16343,-9,9,0,3,7,83.0,2.0,83.0,2042
16344,-7,77,70,1,0,83.0,2.0,83.0,2043
16345,-53,79,26,1,1,83.0,2.0,83.0,2043
16346,-44,72,28,2,2,83.0,2.0,83.0,2043
16347,-20,90,70,2,3,83.0,2.0,83.0,2043
16348,-3,86,83,3,4,83.0,2.0,83.0,2043
16349,-24,86,62,3,5,83.0,2.0,83.0,2043
16350,-12,91,79,3,6,83.0,2.0,83.0,2043
16351,59,31,90,3,7,83.0,2.0,83.0,2043
16352,5,0,5,1,0,83.0,2.0,83.0,2044
16353,-8,14,6,1,1,83.0,2.0,83.0,2044
16354,0,100,100,2,2,83.0,2.0,83.0,2044
16355,0,100,100,2,3,83.0,2.0,83.0,2044
16356,7,93,100,3,4,83.0,2.0,83.0,2044
16357,86,0,86,3,5,83.0,2.0,83.0,2044
16358,49,31,80,3,6,83.0,2.0,83.0,2044
16359,7,0,7,3,7,83.0,2.0,83.0,2044
16360,18,71,89,1,0,83.0,2.0,83.0,2045
16361,19,65,84,1,1,83.0,2.0,83.0,2045
16362,12,76,88,2,2,83.0,2.0,83.0,2045
16363,-43,72,29,2,3,83.0,2.0,83.0,2045
16364,-27,62,35,3,4,83.0,2.0,83.0,2045
16365,86,8,94,3,5,83.0,2.0,83.0,2045
16366,12,58,70,3,6,83.0,2.0,83.0,2045
16367,56,22,78,3,7,83.0,2.0,83.0,2045
16368,0,50,50,1,0,83.0,2.0,83.0,2046
16369,24,38,62,1,1,83.0,2.0,83.0,2046
16370,10,50,60,2,2,83.0,2.0,83.0,2046
16371,-4,43,39,2,3,83.0,2.0,83.0,2046
16372,13,79,92,3,4,83.0,2.0,83.0,2046
16373,0,50,50,3,5,83.0,2.0,83.0,2046
16374,13,87,100,3,6,83.0,2.0,83.0,2046
16375,0,50,50,3,7,83.0,2.0,83.0,2046
16376,78,0,78,1,0,83.0,2.0,83.0,2047
16377,10,23,33,1,1,83.0,2.0,83.0,2047
16378,0,100,100,2,2,83.0,2.0,83.0,2047
16379,-3,100,97,2,3,83.0,2.0,83.0,2047
16380,30,66,96,3,4,83.0,2.0,83.0,2047
16381,64,19,83,3,5,83.0,2.0,83.0,2047
16382,70,13,83,3,6,83.0,2.0,83.0,2047
16383,91,0,91,3,7,83.0,2.0,83.0,2047
16384,-30,34,4,1,0,83.0,2.0,83.0,2048
16385,-56,69,13,1,1,83.0,2.0,83.0,2048
16386,-58,84,26,2,2,83.0,2.0,83.0,2048
16387,-3,29,26,2,3,83.0,2.0,83.0,2048
16388,-9,37,28,3,4,83.0,2.0,83.0,2048
16389,-20,23,3,3,5,83.0,2.0,83.0,2048
16390,-49,83,34,3,6,83.0,2.0,83.0,2048
16391,-7,13,6,3,7,83.0,2.0,83.0,2048
16392,7,43,50,1,0,83.0,2.0,83.0,2049
16393,-12,50,38,1,1,83.0,2.0,83.0,2049
16394,-18,100,82,2,2,83.0,2.0,83.0,2049
16395,0,100,100,2,3,83.0,2.0,83.0,2049
16396,0,80,80,3,4,83.0,2.0,83.0,2049
16397,30,50,80,3,5,83.0,2.0,83.0,2049
16398,0,100,100,3,6,83.0,2.0,83.0,2049
16399,0,25,25,3,7,83.0,2.0,83.0,2049
16400,-5,90,85,1,0,83.0,2.0,83.0,2050
16401,7,84,91,1,1,83.0,2.0,83.0,2050
16402,-54,90,36,2,2,83.0,2.0,83.0,2050
16403,-89,100,11,2,3,83.0,2.0,83.0,2050
16404,-3,85,82,3,4,83.0,2.0,83.0,2050
16405,6,87,93,3,5,83.0,2.0,83.0,2050
16406,13,87,100,3,6,83.0,2.0,83.0,2050
16407,3,96,99,3,7,83.0,2.0,83.0,2050
16408,0,0,0,1,0,83.0,2.0,83.0,2051
16409,0,0,0,1,1,83.0,2.0,83.0,2051
16410,0,100,100,2,2,83.0,2.0,83.0,2051
16411,0,11,11,2,3,83.0,2.0,83.0,2051
16412,0,100,100,3,4,83.0,2.0,83.0,2051
16413,0,0,0,3,5,83.0,2.0,83.0,2051
16414,1,76,77,3,6,83.0,2.0,83.0,2051
16415,50,0,50,3,7,83.0,2.0,83.0,2051
16416,15,82,97,1,0,84.0,2.0,84.0,2052
16417,22,75,97,1,1,84.0,2.0,84.0,2052
16418,7,82,89,2,2,84.0,2.0,84.0,2052
16419,3,87,90,2,3,84.0,2.0,84.0,2052
16420,3,84,87,3,4,84.0,2.0,84.0,2052
16421,5,84,89,3,5,84.0,2.0,84.0,2052
16422,1,84,85,3,6,84.0,2.0,84.0,2052
16423,12,77,89,3,7,84.0,2.0,84.0,2052
16424,58,24,82,1,0,84.0,2.0,84.0,2053
16425,65,27,92,1,1,84.0,2.0,84.0,2053
16426,37,50,87,2,2,84.0,2.0,84.0,2053
16427,17,70,87,2,3,84.0,2.0,84.0,2053
16428,17,70,87,3,4,84.0,2.0,84.0,2053
16429,33,50,83,3,5,84.0,2.0,84.0,2053
16430,13,71,84,3,6,84.0,2.0,84.0,2053
16431,31,50,81,3,7,84.0,2.0,84.0,2053
16432,-24,75,51,1,0,84.0,2.0,84.0,2054
16433,-50,50,0,1,1,84.0,2.0,84.0,2054
16434,-30,80,50,2,2,84.0,2.0,84.0,2054
16435,11,50,61,2,3,84.0,2.0,84.0,2054
16436,-1,51,50,3,4,84.0,2.0,84.0,2054
16437,50,0,50,3,5,84.0,2.0,84.0,2054
16438,-25,75,50,3,6,84.0,2.0,84.0,2054
16439,-81,81,0,3,7,84.0,2.0,84.0,2054
16440,0,0,0,1,0,84.0,2.0,84.0,2055
16441,0,100,100,1,1,84.0,2.0,84.0,2055
16442,-1,47,46,2,2,84.0,2.0,84.0,2055
16443,-31,98,67,2,3,84.0,2.0,84.0,2055
16444,8,54,62,3,4,84.0,2.0,84.0,2055
16445,-2,57,55,3,5,84.0,2.0,84.0,2055
16446,-26,63,37,3,6,84.0,2.0,84.0,2055
16447,4,26,30,3,7,84.0,2.0,84.0,2055
16448,-66,87,21,1,0,84.0,2.0,84.0,2056
16449,-5,16,11,1,1,84.0,2.0,84.0,2056
16450,2,85,87,2,2,84.0,2.0,84.0,2056
16451,74,15,89,2,3,84.0,2.0,84.0,2056
16452,-66,84,18,3,4,84.0,2.0,84.0,2056
16453,74,11,85,3,5,84.0,2.0,84.0,2056
16454,80,5,85,3,6,84.0,2.0,84.0,2056
16455,10,10,20,3,7,84.0,2.0,84.0,2056
16456,50,0,50,1,0,84.0,2.0,84.0,2057
16457,27,50,77,1,1,84.0,2.0,84.0,2057
16458,32,50,82,2,2,84.0,2.0,84.0,2057
16459,-15,91,76,2,3,84.0,2.0,84.0,2057
16460,33,38,71,3,4,84.0,2.0,84.0,2057
16461,31,50,81,3,5,84.0,2.0,84.0,2057
16462,57,27,84,3,6,84.0,2.0,84.0,2057
16463,73,2,75,3,7,84.0,2.0,84.0,2057
16464,76,12,88,1,0,84.0,2.0,84.0,2058
16465,18,82,100,1,1,84.0,2.0,84.0,2058
16466,34,50,84,2,2,84.0,2.0,84.0,2058
16467,77,9,86,2,3,84.0,2.0,84.0,2058
16468,13,87,100,3,4,84.0,2.0,84.0,2058
16469,27,50,77,3,5,84.0,2.0,84.0,2058
16470,76,24,100,3,6,84.0,2.0,84.0,2058
16471,88,0,88,3,7,84.0,2.0,84.0,2058
16472,91,0,91,1,0,84.0,2.0,84.0,2059
16473,4,1,5,1,1,84.0,2.0,84.0,2059
16474,-77,80,3,2,2,84.0,2.0,84.0,2059
16475,92,3,95,2,3,84.0,2.0,84.0,2059
16476,5,88,93,3,4,84.0,2.0,84.0,2059
16477,47,43,90,3,5,84.0,2.0,84.0,2059
16478,26,65,91,3,6,84.0,2.0,84.0,2059
16479,89,5,94,3,7,84.0,2.0,84.0,2059
16480,24,5,29,1,0,84.0,2.0,84.0,2060
16481,24,72,96,1,1,84.0,2.0,84.0,2060
16482,-70,85,15,2,2,84.0,2.0,84.0,2060
16483,-67,78,11,2,3,84.0,2.0,84.0,2060
16484,-4,84,80,3,4,84.0,2.0,84.0,2060
16485,75,6,81,3,5,84.0,2.0,84.0,2060
16486,22,2,24,3,6,84.0,2.0,84.0,2060
16487,-13,89,76,3,7,84.0,2.0,84.0,2060
16488,10,88,98,1,0,84.0,2.0,84.0,2061
16489,2,84,86,1,1,84.0,2.0,84.0,2061
16490,8,84,92,2,2,84.0,2.0,84.0,2061
16491,-2,83,81,2,3,84.0,2.0,84.0,2061
16492,-3,87,84,3,4,84.0,2.0,84.0,2061
16493,-2,89,87,3,5,84.0,2.0,84.0,2061
16494,10,81,91,3,6,84.0,2.0,84.0,2061
16495,9,91,100,3,7,84.0,2.0,84.0,2061
16496,12,30,42,1,0,84.0,2.0,84.0,2062
16497,62,0,62,1,1,84.0,2.0,84.0,2062
16498,28,56,84,2,2,84.0,2.0,84.0,2062
16499,43,42,85,2,3,84.0,2.0,84.0,2062
16500,35,64,99,3,4,84.0,2.0,84.0,2062
16501,12,53,65,3,5,84.0,2.0,84.0,2062
16502,46,39,85,3,6,84.0,2.0,84.0,2062
16503,56,14,70,3,7,84.0,2.0,84.0,2062
16504,28,72,100,1,0,84.0,2.0,84.0,2063
16505,-14,85,71,1,1,84.0,2.0,84.0,2063
16506,-4,83,79,2,2,84.0,2.0,84.0,2063
16507,52,40,92,2,3,84.0,2.0,84.0,2063
16508,10,68,78,3,4,84.0,2.0,84.0,2063
16509,-35,71,36,3,5,84.0,2.0,84.0,2063
16510,-21,93,72,3,6,84.0,2.0,84.0,2063
16511,-5,79,74,3,7,84.0,2.0,84.0,2063
16512,-13,13,0,1,0,84.0,2.0,84.0,2064
16513,11,24,35,1,1,84.0,2.0,84.0,2064
16514,41,59,100,2,2,84.0,2.0,84.0,2064
16515,56,39,95,2,3,84.0,2.0,84.0,2064
16516,26,74,100,3,4,84.0,2.0,84.0,2064
16517,36,64,100,3,5,84.0,2.0,84.0,2064
16518,65,35,100,3,6,84.0,2.0,84.0,2064
16519,-100,100,0,3,7,84.0,2.0,84.0,2064
16520,-3,56,53,1,0,84.0,2.0,84.0,2065
16521,-29,90,61,1,1,84.0,2.0,84.0,2065
16522,19,46,65,2,2,84.0,2.0,84.0,2065
16523,-9,64,55,2,3,84.0,2.0,84.0,2065
16524,-6,70,64,3,4,84.0,2.0,84.0,2065
16525,50,11,61,3,5,84.0,2.0,84.0,2065
16526,15,42,57,3,6,84.0,2.0,84.0,2065
16527,-4,62,58,3,7,84.0,2.0,84.0,2065
16528,100,0,100,1,0,84.0,2.0,84.0,2066
16529,52,48,100,1,1,84.0,2.0,84.0,2066
16530,0,100,100,2,2,84.0,2.0,84.0,2066
16531,50,50,100,2,3,84.0,2.0,84.0,2066
16532,0,100,100,3,4,84.0,2.0,84.0,2066
16533,36,64,100,3,5,84.0,2.0,84.0,2066
16534,100,0,100,3,6,84.0,2.0,84.0,2066
16535,76,24,100,3,7,84.0,2.0,84.0,2066
16536,24,2,26,1,0,84.0,2.0,84.0,2067
16537,-10,77,67,1,1,84.0,2.0,84.0,2067
16538,-14,79,65,2,2,84.0,2.0,84.0,2067
16539,0,100,100,2,3,84.0,2.0,84.0,2067
16540,-1,69,68,3,4,84.0,2.0,84.0,2067
16541,-1,50,49,3,5,84.0,2.0,84.0,2067
16542,-2,33,31,3,6,84.0,2.0,84.0,2067
16543,-14,50,36,3,7,84.0,2.0,84.0,2067
16544,32,18,50,1,0,84.0,2.0,84.0,2068
16545,22,70,92,1,1,84.0,2.0,84.0,2068
16546,-6,73,67,2,2,84.0,2.0,84.0,2068
16547,35,65,100,2,3,84.0,2.0,84.0,2068
16548,33,67,100,3,4,84.0,2.0,84.0,2068
16549,73,27,100,3,5,84.0,2.0,84.0,2068
16550,56,44,100,3,6,84.0,2.0,84.0,2068
16551,8,0,8,3,7,84.0,2.0,84.0,2068
16552,27,50,77,1,0,84.0,2.0,84.0,2069
16553,12,64,76,1,1,84.0,2.0,84.0,2069
16554,25,50,75,2,2,84.0,2.0,84.0,2069
16555,31,50,81,2,3,84.0,2.0,84.0,2069
16556,37,31,68,3,4,84.0,2.0,84.0,2069
16557,27,50,77,3,5,84.0,2.0,84.0,2069
16558,70,0,70,3,6,84.0,2.0,84.0,2069
16559,29,59,88,3,7,84.0,2.0,84.0,2069
16560,7,25,32,1,0,84.0,2.0,84.0,2070
16561,-3,46,43,1,1,84.0,2.0,84.0,2070
16562,0,100,100,2,2,84.0,2.0,84.0,2070
16563,0,100,100,2,3,84.0,2.0,84.0,2070
16564,0,100,100,3,4,84.0,2.0,84.0,2070
16565,8,50,58,3,5,84.0,2.0,84.0,2070
16566,16,24,40,3,6,84.0,2.0,84.0,2070
16567,14,24,38,3,7,84.0,2.0,84.0,2070
16568,-21,21,0,1,0,84.0,2.0,84.0,2071
16569,-1,1,0,1,1,84.0,2.0,84.0,2071
16570,0,100,100,2,2,84.0,2.0,84.0,2071
16571,0,0,0,2,3,84.0,2.0,84.0,2071
16572,-43,65,22,3,4,84.0,2.0,84.0,2071
16573,-3,26,23,3,5,84.0,2.0,84.0,2071
16574,4,59,63,3,6,84.0,2.0,84.0,2071
16575,6,0,6,3,7,84.0,2.0,84.0,2071
16576,-1,86,85,1,0,84.0,2.0,84.0,2072
16577,-3,91,88,1,1,84.0,2.0,84.0,2072
16578,-11,100,89,2,2,84.0,2.0,84.0,2072
16579,10,81,91,2,3,84.0,2.0,84.0,2072
16580,-22,97,75,3,4,84.0,2.0,84.0,2072
16581,7,82,89,3,5,84.0,2.0,84.0,2072
16582,3,84,87,3,6,84.0,2.0,84.0,2072
16583,1,87,88,3,7,84.0,2.0,84.0,2072
16584,5,24,29,1,0,84.0,2.0,84.0,2073
16585,-50,65,15,1,1,84.0,2.0,84.0,2073
16586,17,8,25,2,2,84.0,2.0,84.0,2073
16587,2,62,64,2,3,84.0,2.0,84.0,2073
16588,-1,61,60,3,4,84.0,2.0,84.0,2073
16589,16,57,73,3,5,84.0,2.0,84.0,2073
16590,-1,41,40,3,6,84.0,2.0,84.0,2073
16591,-31,55,24,3,7,84.0,2.0,84.0,2073
16592,0,10,10,1,0,85.0,2.0,85.0,2074
16593,0,0,0,1,1,85.0,2.0,85.0,2074
16594,0,75,75,2,2,85.0,2.0,85.0,2074
16595,-1,76,75,2,3,85.0,2.0,85.0,2074
16596,1,84,85,3,4,85.0,2.0,85.0,2074
16597,27,50,77,3,5,85.0,2.0,85.0,2074
16598,0,75,75,3,6,85.0,2.0,85.0,2074
16599,0,10,10,3,7,85.0,2.0,85.0,2074
16600,-3,14,11,1,0,85.0,2.0,85.0,2075
16601,-2,41,39,1,1,85.0,2.0,85.0,2075
16602,12,50,62,2,2,85.0,2.0,85.0,2075
16603,2,15,17,2,3,85.0,2.0,85.0,2075
16604,-4,68,64,3,4,85.0,2.0,85.0,2075
16605,2,38,40,3,5,85.0,2.0,85.0,2075
16606,0,50,50,3,6,85.0,2.0,85.0,2075
16607,5,22,27,3,7,85.0,2.0,85.0,2075
16608,24,0,24,1,0,85.0,2.0,85.0,2076
16609,-8,8,0,1,1,85.0,2.0,85.0,2076
16610,17,83,100,2,2,85.0,2.0,85.0,2076
16611,0,100,100,2,3,85.0,2.0,85.0,2076
16612,72,28,100,3,4,85.0,2.0,85.0,2076
16613,-7,34,27,3,5,85.0,2.0,85.0,2076
16614,0,100,100,3,6,85.0,2.0,85.0,2076
16615,35,0,35,3,7,85.0,2.0,85.0,2076
16616,17,83,100,1,0,85.0,2.0,85.0,2077
16617,-1,79,78,1,1,85.0,2.0,85.0,2077
16618,45,23,68,2,2,85.0,2.0,85.0,2077
16619,-22,100,78,2,3,85.0,2.0,85.0,2077
16620,7,71,78,3,4,85.0,2.0,85.0,2077
16621,-7,79,72,3,5,85.0,2.0,85.0,2077
16622,27,73,100,3,6,85.0,2.0,85.0,2077
16623,64,6,70,3,7,85.0,2.0,85.0,2077
16624,89,0,89,1,0,85.0,2.0,85.0,2078
16625,79,8,87,1,1,85.0,2.0,85.0,2078
16626,13,69,82,2,2,85.0,2.0,85.0,2078
16627,76,5,81,2,3,85.0,2.0,85.0,2078
16628,71,20,91,3,4,85.0,2.0,85.0,2078
16629,75,12,87,3,5,85.0,2.0,85.0,2078
16630,85,0,85,3,6,85.0,2.0,85.0,2078
16631,50,23,73,3,7,85.0,2.0,85.0,2078
16632,54,25,79,1,0,85.0,2.0,85.0,2079
16633,64,30,94,1,1,85.0,2.0,85.0,2079
16634,45,55,100,2,2,85.0,2.0,85.0,2079
16635,-4,90,86,2,3,85.0,2.0,85.0,2079
16636,53,40,93,3,4,85.0,2.0,85.0,2079
16637,-18,56,38,3,5,85.0,2.0,85.0,2079
16638,28,65,93,3,6,85.0,2.0,85.0,2079
16639,-26,35,9,3,7,85.0,2.0,85.0,2079
16640,2,42,44,1,0,85.0,2.0,85.0,2080
16641,0,70,70,1,1,85.0,2.0,85.0,2080
16642,-9,40,31,2,2,85.0,2.0,85.0,2080
16643,15,21,36,2,3,85.0,2.0,85.0,2080
16644,-15,77,62,3,4,85.0,2.0,85.0,2080
16645,18,22,40,3,5,85.0,2.0,85.0,2080
16646,10,29,39,3,6,85.0,2.0,85.0,2080
16647,-30,75,45,3,7,85.0,2.0,85.0,2080
16648,60,33,93,1,0,85.0,2.0,85.0,2081
16649,67,24,91,1,1,85.0,2.0,85.0,2081
16650,26,74,100,2,2,85.0,2.0,85.0,2081
16651,0,100,100,2,3,85.0,2.0,85.0,2081
16652,22,78,100,3,4,85.0,2.0,85.0,2081
16653,92,7,99,3,5,85.0,2.0,85.0,2081
16654,65,35,100,3,6,85.0,2.0,85.0,2081
16655,41,59,100,3,7,85.0,2.0,85.0,2081
16656,76,3,79,1,0,85.0,2.0,85.0,2082
16657,3,0,3,1,1,85.0,2.0,85.0,2082
16658,18,80,98,2,2,85.0,2.0,85.0,2082
16659,34,0,34,2,3,85.0,2.0,85.0,2082
16660,20,47,67,3,4,85.0,2.0,85.0,2082
16661,13,2,15,3,5,85.0,2.0,85.0,2082
16662,-4,8,4,3,6,85.0,2.0,85.0,2082
16663,3,7,10,3,7,85.0,2.0,85.0,2082
16664,-16,50,34,1,0,85.0,2.0,85.0,2083
16665,-15,17,2,1,1,85.0,2.0,85.0,2083
16666,18,82,100,2,2,85.0,2.0,85.0,2083
16667,50,0,50,2,3,85.0,2.0,85.0,2083
16668,-5,41,36,3,4,85.0,2.0,85.0,2083
16669,25,50,75,3,5,85.0,2.0,85.0,2083
16670,0,100,100,3,6,85.0,2.0,85.0,2083
16671,38,34,72,3,7,85.0,2.0,85.0,2083
16672,0,0,0,1,0,85.0,2.0,85.0,2084
16673,0,0,0,1,1,85.0,2.0,85.0,2084
16674,0,100,100,2,2,85.0,2.0,85.0,2084
16675,8,74,82,2,3,85.0,2.0,85.0,2084
16676,-1,24,23,3,4,85.0,2.0,85.0,2084
16677,8,3,11,3,5,85.0,2.0,85.0,2084
16678,6,20,26,3,6,85.0,2.0,85.0,2084
16679,0,0,0,3,7,85.0,2.0,85.0,2084
16680,65,0,65,1,0,85.0,2.0,85.0,2085
16681,40,50,90,1,1,85.0,2.0,85.0,2085
16682,0,100,100,2,2,85.0,2.0,85.0,2085
16683,0,100,100,2,3,85.0,2.0,85.0,2085
16684,25,50,75,3,4,85.0,2.0,85.0,2085
16685,100,0,100,3,5,85.0,2.0,85.0,2085
16686,50,0,50,3,6,85.0,2.0,85.0,2085
16687,75,0,75,3,7,85.0,2.0,85.0,2085
16688,100,0,100,1,0,85.0,2.0,85.0,2086
16689,-16,36,20,1,1,85.0,2.0,85.0,2086
16690,-43,69,26,2,2,85.0,2.0,85.0,2086
16691,75,9,84,2,3,85.0,2.0,85.0,2086
16692,54,46,100,3,4,85.0,2.0,85.0,2086
16693,-100,100,0,3,5,85.0,2.0,85.0,2086
16694,14,86,100,3,6,85.0,2.0,85.0,2086
16695,20,0,20,3,7,85.0,2.0,85.0,2086
16696,5,19,24,1,0,85.0,2.0,85.0,2087
16697,14,80,94,1,1,85.0,2.0,85.0,2087
16698,11,89,100,2,2,85.0,2.0,85.0,2087
16699,0,100,100,2,3,85.0,2.0,85.0,2087
16700,-5,5,0,3,4,85.0,2.0,85.0,2087
16701,80,10,90,3,5,85.0,2.0,85.0,2087
16702,0,50,50,3,6,85.0,2.0,85.0,2087
16703,11,6,17,3,7,85.0,2.0,85.0,2087
16704,54,3,57,1,0,85.0,2.0,85.0,2088
16705,45,1,46,1,1,85.0,2.0,85.0,2088
16706,-2,97,95,2,2,85.0,2.0,85.0,2088
16707,3,97,100,2,3,85.0,2.0,85.0,2088
16708,2,62,64,3,4,85.0,2.0,85.0,2088
16709,7,48,55,3,5,85.0,2.0,85.0,2088
16710,4,8,12,3,6,85.0,2.0,85.0,2088
16711,47,11,58,3,7,85.0,2.0,85.0,2088
16712,43,42,85,1,0,85.0,2.0,85.0,2089
16713,40,38,78,1,1,85.0,2.0,85.0,2089
16714,13,87,100,2,2,85.0,2.0,85.0,2089
16715,0,100,100,2,3,85.0,2.0,85.0,2089
16716,25,67,92,3,4,85.0,2.0,85.0,2089
16717,63,28,91,3,5,85.0,2.0,85.0,2089
16718,31,68,99,3,6,85.0,2.0,85.0,2089
16719,67,21,88,3,7,85.0,2.0,85.0,2089
16720,-1,86,85,1,0,85.0,2.0,85.0,2090
16721,-60,79,19,1,1,85.0,2.0,85.0,2090
16722,2,84,86,2,2,85.0,2.0,85.0,2090
16723,-1,84,83,2,3,85.0,2.0,85.0,2090
16724,1,84,85,3,4,85.0,2.0,85.0,2090
16725,6,85,91,3,5,85.0,2.0,85.0,2090
16726,-5,86,81,3,6,85.0,2.0,85.0,2090
16727,0,84,84,3,7,85.0,2.0,85.0,2090
16728,70,0,70,1,0,85.0,2.0,85.0,2091
16729,30,40,70,1,1,85.0,2.0,85.0,2091
16730,10,90,100,2,2,85.0,2.0,85.0,2091
16731,0,100,100,2,3,85.0,2.0,85.0,2091
16732,76,24,100,3,4,85.0,2.0,85.0,2091
16733,90,10,100,3,5,85.0,2.0,85.0,2091
16734,62,38,100,3,6,85.0,2.0,85.0,2091
16735,30,0,30,3,7,85.0,2.0,85.0,2091
16736,90,2,92,1,0,85.0,2.0,85.0,2092
16737,79,8,87,1,1,85.0,2.0,85.0,2092
16738,9,5,14,2,2,85.0,2.0,85.0,2092
16739,70,20,90,2,3,85.0,2.0,85.0,2092
16740,82,4,86,3,4,85.0,2.0,85.0,2092
16741,7,6,13,3,5,85.0,2.0,85.0,2092
16742,5,4,9,3,6,85.0,2.0,85.0,2092
16743,5,6,11,3,7,85.0,2.0,85.0,2092
16744,-6,40,34,1,0,85.0,2.0,85.0,2093
16745,-19,51,32,1,1,85.0,2.0,85.0,2093
16746,-2,37,35,2,2,85.0,2.0,85.0,2093
16747,-7,49,42,2,3,85.0,2.0,85.0,2093
16748,6,44,50,3,4,85.0,2.0,85.0,2093
16749,10,50,60,3,5,85.0,2.0,85.0,2093
16750,-10,38,28,3,6,85.0,2.0,85.0,2093
16751,6,39,45,3,7,85.0,2.0,85.0,2093
16752,5,61,66,1,0,86.0,2.0,86.0,2094
16753,0,31,31,1,1,86.0,2.0,86.0,2094
16754,42,23,65,2,2,86.0,2.0,86.0,2094
16755,6,78,84,2,3,86.0,2.0,86.0,2094
16756,-4,80,76,3,4,86.0,2.0,86.0,2094
16757,1,38,39,3,5,86.0,2.0,86.0,2094
16758,12,66,78,3,6,86.0,2.0,86.0,2094
16759,58,5,63,3,7,86.0,2.0,86.0,2094
16760,4,0,4,1,0,86.0,2.0,86.0,2095
16761,0,0,0,1,1,86.0,2.0,86.0,2095
16762,5,76,81,2,2,86.0,2.0,86.0,2095
16763,89,0,89,2,3,86.0,2.0,86.0,2095
16764,-1,58,57,3,4,86.0,2.0,86.0,2095
16765,37,17,54,3,5,86.0,2.0,86.0,2095
16766,11,9,20,3,6,86.0,2.0,86.0,2095
16767,-10,38,28,3,7,86.0,2.0,86.0,2095
16768,3,33,36,1,0,86.0,2.0,86.0,2096
16769,31,50,81,1,1,86.0,2.0,86.0,2096
16770,4,32,36,2,2,86.0,2.0,86.0,2096
16771,0,49,49,2,3,86.0,2.0,86.0,2096
16772,-6,57,51,3,4,86.0,2.0,86.0,2096
16773,43,36,79,3,5,86.0,2.0,86.0,2096
16774,-13,49,36,3,6,86.0,2.0,86.0,2096
16775,51,33,84,3,7,86.0,2.0,86.0,2096
16776,-1,1,0,1,0,86.0,2.0,86.0,2097
16777,0,0,0,1,1,86.0,2.0,86.0,2097
16778,0,50,50,2,2,86.0,2.0,86.0,2097
16779,50,50,100,2,3,86.0,2.0,86.0,2097
16780,50,50,100,3,4,86.0,2.0,86.0,2097
16781,50,50,100,3,5,86.0,2.0,86.0,2097
16782,50,50,100,3,6,86.0,2.0,86.0,2097
16783,50,50,100,3,7,86.0,2.0,86.0,2097
16784,42,43,85,1,0,86.0,2.0,86.0,2098
16785,9,83,92,1,1,86.0,2.0,86.0,2098
16786,64,24,88,2,2,86.0,2.0,86.0,2098
16787,45,32,77,2,3,86.0,2.0,86.0,2098
16788,45,47,92,3,4,86.0,2.0,86.0,2098
16789,5,58,63,3,5,86.0,2.0,86.0,2098
16790,10,83,93,3,6,86.0,2.0,86.0,2098
16791,-8,25,17,3,7,86.0,2.0,86.0,2098
16792,-62,81,19,1,0,86.0,2.0,86.0,2099
16793,-1,17,16,1,1,86.0,2.0,86.0,2099
16794,-11,35,24,2,2,86.0,2.0,86.0,2099
16795,-52,75,23,2,3,86.0,2.0,86.0,2099
16796,8,83,91,3,4,86.0,2.0,86.0,2099
16797,16,19,35,3,5,86.0,2.0,86.0,2099
16798,4,39,43,3,6,86.0,2.0,86.0,2099
16799,6,14,20,3,7,86.0,2.0,86.0,2099
16800,100,0,100,1,0,86.0,2.0,86.0,2100
16801,89,0,89,1,1,86.0,2.0,86.0,2100
16802,89,0,89,2,2,86.0,2.0,86.0,2100
16803,0,0,0,2,3,86.0,2.0,86.0,2100
16804,100,0,100,3,4,86.0,2.0,86.0,2100
16805,100,0,100,3,5,86.0,2.0,86.0,2100
16806,12,88,100,3,6,86.0,2.0,86.0,2100
16807,100,0,100,3,7,86.0,2.0,86.0,2100
16808,-57,78,21,1,0,86.0,2.0,86.0,2101
16809,10,79,89,1,1,86.0,2.0,86.0,2101
16810,-1,20,19,2,2,86.0,2.0,86.0,2101
16811,-5,81,76,2,3,86.0,2.0,86.0,2101
16812,-3,84,81,3,4,86.0,2.0,86.0,2101
16813,-5,23,18,3,5,86.0,2.0,86.0,2101
16814,-13,18,5,3,6,86.0,2.0,86.0,2101
16815,0,16,16,3,7,86.0,2.0,86.0,2101
16816,-59,85,26,1,0,86.0,2.0,86.0,2102
16817,57,26,83,1,1,86.0,2.0,86.0,2102
16818,-6,85,79,2,2,86.0,2.0,86.0,2102
16819,-4,84,80,2,3,86.0,2.0,86.0,2102
16820,-4,81,77,3,4,86.0,2.0,86.0,2102
16821,-54,80,26,3,5,86.0,2.0,86.0,2102
16822,8,78,86,3,6,86.0,2.0,86.0,2102
16823,-5,87,82,3,7,86.0,2.0,86.0,2102
16824,39,61,100,1,0,86.0,2.0,86.0,2103
16825,9,91,100,1,1,86.0,2.0,86.0,2103
16826,56,44,100,2,2,86.0,2.0,86.0,2103
16827,23,63,86,2,3,86.0,2.0,86.0,2103
16828,34,64,98,3,4,86.0,2.0,86.0,2103
16829,67,25,92,3,5,86.0,2.0,86.0,2103
16830,63,37,100,3,6,86.0,2.0,86.0,2103
16831,8,17,25,3,7,86.0,2.0,86.0,2103
16832,0,0,0,1,0,86.0,2.0,86.0,2104
16833,-10,10,0,1,1,86.0,2.0,86.0,2104
16834,-4,49,45,2,2,86.0,2.0,86.0,2104
16835,-5,5,0,2,3,86.0,2.0,86.0,2104
16836,-27,27,0,3,4,86.0,2.0,86.0,2104
16837,37,16,53,3,5,86.0,2.0,86.0,2104
16838,0,100,100,3,6,86.0,2.0,86.0,2104
16839,2,50,52,3,7,86.0,2.0,86.0,2104
16840,64,15,79,1,0,86.0,2.0,86.0,2105
16841,2,78,80,1,1,86.0,2.0,86.0,2105
16842,76,6,82,2,2,86.0,2.0,86.0,2105
16843,30,52,82,2,3,86.0,2.0,86.0,2105
16844,14,80,94,3,4,86.0,2.0,86.0,2105
16845,28,49,77,3,5,86.0,2.0,86.0,2105
16846,69,21,90,3,6,86.0,2.0,86.0,2105
16847,63,5,68,3,7,86.0,2.0,86.0,2105
16848,11,0,11,1,0,86.0,2.0,86.0,2106
16849,0,37,37,1,1,86.0,2.0,86.0,2106
16850,-9,73,64,2,2,86.0,2.0,86.0,2106
16851,3,80,83,2,3,86.0,2.0,86.0,2106
16852,6,94,100,3,4,86.0,2.0,86.0,2106
16853,-29,29,0,3,5,86.0,2.0,86.0,2106
16854,-12,12,0,3,6,86.0,2.0,86.0,2106
16855,-3,14,11,3,7,86.0,2.0,86.0,2106
16856,0,0,0,1,0,86.0,2.0,86.0,2107
16857,-2,48,46,1,1,86.0,2.0,86.0,2107
16858,-23,95,72,2,2,86.0,2.0,86.0,2107
16859,-7,79,72,2,3,86.0,2.0,86.0,2107
16860,1,55,56,3,4,86.0,2.0,86.0,2107
16861,14,48,62,3,5,86.0,2.0,86.0,2107
16862,6,37,43,3,6,86.0,2.0,86.0,2107
16863,7,31,38,3,7,86.0,2.0,86.0,2107
16864,-15,95,80,1,0,86.0,2.0,86.0,2108
16865,-10,95,85,1,1,86.0,2.0,86.0,2108
16866,10,87,97,2,2,86.0,2.0,86.0,2108
16867,-5,92,87,2,3,86.0,2.0,86.0,2108
16868,-16,95,79,3,4,86.0,2.0,86.0,2108
16869,2,91,93,3,5,86.0,2.0,86.0,2108
16870,-7,93,86,3,6,86.0,2.0,86.0,2108
16871,-7,90,83,3,7,86.0,2.0,86.0,2108
16872,-13,49,36,1,0,86.0,2.0,86.0,2109
16873,-85,97,12,1,1,86.0,2.0,86.0,2109
16874,12,62,74,2,2,86.0,2.0,86.0,2109
16875,-100,100,0,2,3,86.0,2.0,86.0,2109
16876,-2,66,64,3,4,86.0,2.0,86.0,2109
16877,4,49,53,3,5,86.0,2.0,86.0,2109
16878,34,29,63,3,6,86.0,2.0,86.0,2109
16879,29,2,31,3,7,86.0,2.0,86.0,2109
16880,75,23,98,1,0,86.0,2.0,86.0,2110
16881,6,94,100,1,1,86.0,2.0,86.0,2110
16882,8,92,100,2,2,86.0,2.0,86.0,2110
16883,16,84,100,2,3,86.0,2.0,86.0,2110
16884,46,54,100,3,4,86.0,2.0,86.0,2110
16885,57,43,100,3,5,86.0,2.0,86.0,2110
16886,8,92,100,3,6,86.0,2.0,86.0,2110
16887,71,29,100,3,7,86.0,2.0,86.0,2110
16888,28,67,95,1,0,86.0,2.0,86.0,2111
16889,26,48,74,1,1,86.0,2.0,86.0,2111
16890,32,45,77,2,2,86.0,2.0,86.0,2111
16891,-4,89,85,2,3,86.0,2.0,86.0,2111
16892,36,63,99,3,4,86.0,2.0,86.0,2111
16893,32,68,100,3,5,86.0,2.0,86.0,2111
16894,-39,68,29,3,6,86.0,2.0,86.0,2111
16895,36,64,100,3,7,86.0,2.0,86.0,2111
16896,-9,93,84,1,0,86.0,2.0,86.0,2112
16897,-1,84,83,1,1,86.0,2.0,86.0,2112
16898,-2,86,84,2,2,86.0,2.0,86.0,2112
16899,-5,91,86,2,3,86.0,2.0,86.0,2112
16900,3,83,86,3,4,86.0,2.0,86.0,2112
16901,-3,77,74,3,5,86.0,2.0,86.0,2112
16902,5,78,83,3,6,86.0,2.0,86.0,2112
16903,-7,89,82,3,7,86.0,2.0,86.0,2112
16904,63,26,89,1,0,86.0,2.0,86.0,2113
16905,-2,88,86,1,1,86.0,2.0,86.0,2113
16906,17,72,89,2,2,86.0,2.0,86.0,2113
16907,-1,69,68,2,3,86.0,2.0,86.0,2113
16908,2,76,78,3,4,86.0,2.0,86.0,2113
16909,-44,71,27,3,5,86.0,2.0,86.0,2113
16910,-8,74,66,3,6,86.0,2.0,86.0,2113
16911,-1,27,26,3,7,86.0,2.0,86.0,2113
16912,3,76,79,1,0,86.0,2.0,86.0,2114
16913,-8,12,4,1,1,86.0,2.0,86.0,2114
16914,38,50,88,2,2,86.0,2.0,86.0,2114
16915,76,24,100,2,3,86.0,2.0,86.0,2114
16916,34,43,77,3,4,86.0,2.0,86.0,2114
16917,54,46,100,3,5,86.0,2.0,86.0,2114
16918,72,28,100,3,6,86.0,2.0,86.0,2114
16919,16,50,66,3,7,86.0,2.0,86.0,2114
16920,47,32,79,1,0,86.0,2.0,86.0,2115
16921,47,27,74,1,1,86.0,2.0,86.0,2115
16922,33,42,75,2,2,86.0,2.0,86.0,2115
16923,54,19,73,2,3,86.0,2.0,86.0,2115
16924,25,57,82,3,4,86.0,2.0,86.0,2115
16925,30,40,70,3,5,86.0,2.0,86.0,2115
16926,40,36,76,3,6,86.0,2.0,86.0,2115
16927,39,34,73,3,7,86.0,2.0,86.0,2115
16928,60,30,90,1,0,86.0,2.0,86.0,2116
16929,34,61,95,1,1,86.0,2.0,86.0,2116
16930,4,96,100,2,2,86.0,2.0,86.0,2116
16931,13,87,100,2,3,86.0,2.0,86.0,2116
16932,39,61,100,3,4,86.0,2.0,86.0,2116
16933,42,58,100,3,5,86.0,2.0,86.0,2116
16934,52,48,100,3,6,86.0,2.0,86.0,2116
16935,72,17,89,3,7,86.0,2.0,86.0,2116
16936,16,0,16,1,0,87.0,2.0,87.0,2117
16937,-58,58,0,1,1,87.0,2.0,87.0,2117
16938,-45,70,25,2,2,87.0,2.0,87.0,2117
16939,-21,87,66,2,3,87.0,2.0,87.0,2117
16940,10,50,60,3,4,87.0,2.0,87.0,2117
16941,33,30,63,3,5,87.0,2.0,87.0,2117
16942,0,100,100,3,6,87.0,2.0,87.0,2117
16943,13,1,14,3,7,87.0,2.0,87.0,2117
16944,0,0,0,1,0,87.0,2.0,87.0,2118
16945,-68,93,25,1,1,87.0,2.0,87.0,2118
16946,-3,28,25,2,2,87.0,2.0,87.0,2118
16947,100,0,100,2,3,87.0,2.0,87.0,2118
16948,-6,31,25,3,4,87.0,2.0,87.0,2118
16949,-1,21,20,3,5,87.0,2.0,87.0,2118
16950,-3,90,87,3,6,87.0,2.0,87.0,2118
16951,0,0,0,3,7,87.0,2.0,87.0,2118
16952,4,18,22,1,0,87.0,2.0,87.0,2119
16953,18,75,93,1,1,87.0,2.0,87.0,2119
16954,-58,73,15,2,2,87.0,2.0,87.0,2119
16955,-5,19,14,2,3,87.0,2.0,87.0,2119
16956,-8,23,15,3,4,87.0,2.0,87.0,2119
16957,-4,15,11,3,5,87.0,2.0,87.0,2119
16958,-53,67,14,3,6,87.0,2.0,87.0,2119
16959,-18,27,9,3,7,87.0,2.0,87.0,2119
16960,85,15,100,1,0,87.0,2.0,87.0,2120
16961,100,0,100,1,1,87.0,2.0,87.0,2120
16962,0,100,100,2,2,87.0,2.0,87.0,2120
16963,-100,100,0,2,3,87.0,2.0,87.0,2120
16964,23,77,100,3,4,87.0,2.0,87.0,2120
16965,50,50,100,3,5,87.0,2.0,87.0,2120
16966,100,0,100,3,6,87.0,2.0,87.0,2120
16967,40,60,100,3,7,87.0,2.0,87.0,2120
16968,0,16,16,1,0,87.0,2.0,87.0,2121
16969,55,19,74,1,1,87.0,2.0,87.0,2121
16970,-9,87,78,2,2,87.0,2.0,87.0,2121
16971,7,13,20,2,3,87.0,2.0,87.0,2121
16972,7,30,37,3,4,87.0,2.0,87.0,2121
16973,45,38,83,3,5,87.0,2.0,87.0,2121
16974,-24,54,30,3,6,87.0,2.0,87.0,2121
16975,-12,39,27,3,7,87.0,2.0,87.0,2121
16976,100,0,100,1,0,87.0,2.0,87.0,2122
16977,69,31,100,1,1,87.0,2.0,87.0,2122
16978,15,85,100,2,2,87.0,2.0,87.0,2122
16979,99,1,100,2,3,87.0,2.0,87.0,2122
16980,30,70,100,3,4,87.0,2.0,87.0,2122
16981,40,60,100,3,5,87.0,2.0,87.0,2122
16982,90,10,100,3,6,87.0,2.0,87.0,2122
16983,84,16,100,3,7,87.0,2.0,87.0,2122
16984,10,83,93,1,0,87.0,2.0,87.0,2123
16985,-72,82,10,1,1,87.0,2.0,87.0,2123
16986,7,91,98,2,2,87.0,2.0,87.0,2123
16987,90,0,90,2,3,87.0,2.0,87.0,2123
16988,5,82,87,3,4,87.0,2.0,87.0,2123
16989,-20,99,79,3,5,87.0,2.0,87.0,2123
16990,6,85,91,3,6,87.0,2.0,87.0,2123
16991,43,36,79,3,7,87.0,2.0,87.0,2123
16992,100,0,100,1,0,88.0,2.0,88.0,2124
16993,100,0,100,1,1,88.0,2.0,88.0,2124
16994,21,79,100,2,2,88.0,2.0,88.0,2124
16995,100,0,100,2,3,88.0,2.0,88.0,2124
16996,60,40,100,3,4,88.0,2.0,88.0,2124
16997,65,34,99,3,5,88.0,2.0,88.0,2124
16998,25,75,100,3,6,88.0,2.0,88.0,2124
16999,-6,100,94,3,7,88.0,2.0,88.0,2124
17000,0,0,0,1,0,88.0,2.0,88.0,2125
17001,100,0,100,1,1,88.0,2.0,88.0,2125
17002,40,0,40,2,2,88.0,2.0,88.0,2125
17003,100,0,100,2,3,88.0,2.0,88.0,2125
17004,-26,53,27,3,4,88.0,2.0,88.0,2125
17005,5,75,80,3,5,88.0,2.0,88.0,2125
17006,0,0,0,3,6,88.0,2.0,88.0,2125
17007,0,0,0,3,7,88.0,2.0,88.0,2125
17008,10,0,10,1,0,88.0,2.0,88.0,2126
17009,-3,11,8,1,1,88.0,2.0,88.0,2126
17010,13,50,63,2,2,88.0,2.0,88.0,2126
17011,0,100,100,2,3,88.0,2.0,88.0,2126
17012,5,60,65,3,4,88.0,2.0,88.0,2126
17013,10,51,61,3,5,88.0,2.0,88.0,2126
17014,-2,43,41,3,6,88.0,2.0,88.0,2126
17015,-16,23,7,3,7,88.0,2.0,88.0,2126
17016,43,18,61,1,0,88.0,2.0,88.0,2127
17017,74,5,79,1,1,88.0,2.0,88.0,2127
17018,12,88,100,2,2,88.0,2.0,88.0,2127
17019,80,20,100,2,3,88.0,2.0,88.0,2127
17020,29,71,100,3,4,88.0,2.0,88.0,2127
17021,83,17,100,3,5,88.0,2.0,88.0,2127
17022,37,63,100,3,6,88.0,2.0,88.0,2127
17023,-3,26,23,3,7,88.0,2.0,88.0,2127
17024,73,23,96,1,0,88.0,2.0,88.0,2128
17025,-43,45,2,1,1,88.0,2.0,88.0,2128
17026,50,50,100,2,2,88.0,2.0,88.0,2128
17027,31,69,100,2,3,88.0,2.0,88.0,2128
17028,50,48,98,3,4,88.0,2.0,88.0,2128
17029,67,33,100,3,5,88.0,2.0,88.0,2128
17030,34,66,100,3,6,88.0,2.0,88.0,2128
17031,64,31,95,3,7,88.0,2.0,88.0,2128
17032,50,0,50,1,0,88.0,2.0,88.0,2129
17033,7,14,21,1,1,88.0,2.0,88.0,2129
17034,12,53,65,2,2,88.0,2.0,88.0,2129
17035,24,38,62,2,3,88.0,2.0,88.0,2129
17036,-1,72,71,3,4,88.0,2.0,88.0,2129
17037,17,0,17,3,5,88.0,2.0,88.0,2129
17038,19,69,88,3,6,88.0,2.0,88.0,2129
17039,35,3,38,3,7,88.0,2.0,88.0,2129
17040,1,83,84,1,0,88.0,2.0,88.0,2130
17041,3,77,80,1,1,88.0,2.0,88.0,2130
17042,6,79,85,2,2,88.0,2.0,88.0,2130
17043,1,88,89,2,3,88.0,2.0,88.0,2130
17044,5,81,86,3,4,88.0,2.0,88.0,2130
17045,-4,87,83,3,5,88.0,2.0,88.0,2130
17046,-33,74,41,3,6,88.0,2.0,88.0,2130
17047,4,63,67,3,7,88.0,2.0,88.0,2130
17048,40,41,81,1,0,89.0,2.0,89.0,2131
17049,21,69,90,1,1,89.0,2.0,89.0,2131
17050,22,67,89,2,2,89.0,2.0,89.0,2131
17051,-3,92,89,2,3,89.0,2.0,89.0,2131
17052,40,50,90,3,4,89.0,2.0,89.0,2131
17053,39,50,89,3,5,89.0,2.0,89.0,2131
17054,62,38,100,3,6,89.0,2.0,89.0,2131
17055,64,25,89,3,7,89.0,2.0,89.0,2131
17056,-3,3,0,1,0,89.0,2.0,89.0,2132
17057,100,0,100,1,1,89.0,2.0,89.0,2132
17058,-50,50,0,2,2,89.0,2.0,89.0,2132
17059,72,28,100,2,3,89.0,2.0,89.0,2132
17060,0,100,100,3,4,89.0,2.0,89.0,2132
17061,100,0,100,3,5,89.0,2.0,89.0,2132
17062,-100,100,0,3,6,89.0,2.0,89.0,2132
17063,14,86,100,3,7,89.0,2.0,89.0,2132
17064,7,0,7,1,0,89.0,2.0,89.0,2133
17065,5,86,91,1,1,89.0,2.0,89.0,2133
17066,-13,15,2,2,2,89.0,2.0,89.0,2133
17067,2,90,92,2,3,89.0,2.0,89.0,2133
17068,-8,16,8,3,4,89.0,2.0,89.0,2133
17069,-7,10,3,3,5,89.0,2.0,89.0,2133
17070,-8,15,7,3,6,89.0,2.0,89.0,2133
17071,-8,10,2,3,7,89.0,2.0,89.0,2133
17072,36,24,60,1,0,89.0,2.0,89.0,2134
17073,15,44,59,1,1,89.0,2.0,89.0,2134
17074,30,59,89,2,2,89.0,2.0,89.0,2134
17075,20,74,94,2,3,89.0,2.0,89.0,2134
17076,24,50,74,3,4,89.0,2.0,89.0,2134
17077,29,47,76,3,5,89.0,2.0,89.0,2134
17078,60,29,89,3,6,89.0,2.0,89.0,2134
17079,43,27,70,3,7,89.0,2.0,89.0,2134
17080,7,88,95,1,0,89.0,2.0,89.0,2135
17081,5,87,92,1,1,89.0,2.0,89.0,2135
17082,-2,92,90,2,2,89.0,2.0,89.0,2135
17083,2,90,92,2,3,89.0,2.0,89.0,2135
17084,-26,91,65,3,4,89.0,2.0,89.0,2135
17085,-7,91,84,3,5,89.0,2.0,89.0,2135
17086,-3,95,92,3,6,89.0,2.0,89.0,2135
17087,-6,94,88,3,7,89.0,2.0,89.0,2135
17088,-53,82,29,1,0,89.0,2.0,89.0,2136
17089,24,57,81,1,1,89.0,2.0,89.0,2136
17090,-66,90,24,2,2,89.0,2.0,89.0,2136
17091,-6,27,21,2,3,89.0,2.0,89.0,2136
17092,-4,29,25,3,4,89.0,2.0,89.0,2136
17093,7,91,98,3,5,89.0,2.0,89.0,2136
17094,-18,89,71,3,6,89.0,2.0,89.0,2136
17095,0,81,81,3,7,89.0,2.0,89.0,2136
17096,-4,30,26,1,0,89.0,2.0,89.0,2137
17097,-6,27,21,1,1,89.0,2.0,89.0,2137
17098,-13,29,16,2,2,89.0,2.0,89.0,2137
17099,21,71,92,2,3,89.0,2.0,89.0,2137
17100,-3,30,27,3,4,89.0,2.0,89.0,2137
17101,21,70,91,3,5,89.0,2.0,89.0,2137
17102,-1,100,99,3,6,89.0,2.0,89.0,2137
17103,-1,30,29,3,7,89.0,2.0,89.0,2137
17104,28,56,84,1,0,89.0,2.0,89.0,2138
17105,16,70,86,1,1,89.0,2.0,89.0,2138
17106,23,56,79,2,2,89.0,2.0,89.0,2138
17107,65,10,75,2,3,89.0,2.0,89.0,2138
17108,70,16,86,3,4,89.0,2.0,89.0,2138
17109,79,0,79,3,5,89.0,2.0,89.0,2138
17110,76,24,100,3,6,89.0,2.0,89.0,2138
17111,48,32,80,3,7,89.0,2.0,89.0,2138
17112,16,18,34,1,0,89.0,2.0,89.0,2139
17113,-47,73,26,1,1,89.0,2.0,89.0,2139
17114,-3,23,20,2,2,89.0,2.0,89.0,2139
17115,21,12,33,2,3,89.0,2.0,89.0,2139
17116,23,0,23,3,4,89.0,2.0,89.0,2139
17117,72,17,89,3,5,89.0,2.0,89.0,2139
17118,6,16,22,3,6,89.0,2.0,89.0,2139
17119,72,28,100,3,7,89.0,2.0,89.0,2139
17120,0,0,0,1,0,90.0,2.0,90.0,2140
17121,45,5,50,1,1,90.0,2.0,90.0,2140
17122,90,0,90,2,2,90.0,2.0,90.0,2140
17123,25,75,100,2,3,90.0,2.0,90.0,2140
17124,10,90,100,3,4,90.0,2.0,90.0,2140
17125,100,0,100,3,5,90.0,2.0,90.0,2140
17126,75,25,100,3,6,90.0,2.0,90.0,2140
17127,90,0,90,3,7,90.0,2.0,90.0,2140
17128,93,7,100,1,0,90.0,2.0,90.0,2141
17129,95,5,100,1,1,90.0,2.0,90.0,2141
17130,38,62,100,2,2,90.0,2.0,90.0,2141
17131,89,11,100,2,3,90.0,2.0,90.0,2141
17132,23,77,100,3,4,90.0,2.0,90.0,2141
17133,90,10,100,3,5,90.0,2.0,90.0,2141
17134,86,14,100,3,6,90.0,2.0,90.0,2141
17135,98,2,100,3,7,90.0,2.0,90.0,2141
17136,40,10,50,1,0,90.0,2.0,90.0,2142
17137,0,0,0,1,1,90.0,2.0,90.0,2142
17138,50,0,50,2,2,90.0,2.0,90.0,2142
17139,0,90,90,2,3,90.0,2.0,90.0,2142
17140,15,75,90,3,4,90.0,2.0,90.0,2142
17141,40,50,90,3,5,90.0,2.0,90.0,2142
17142,0,99,99,3,6,90.0,2.0,90.0,2142
17143,50,0,50,3,7,90.0,2.0,90.0,2142
17144,0,0,0,1,0,90.0,2.0,90.0,2143
17145,14,2,16,1,1,90.0,2.0,90.0,2143
17146,13,35,48,2,2,90.0,2.0,90.0,2143
17147,6,86,92,2,3,90.0,2.0,90.0,2143
17148,14,40,54,3,4,90.0,2.0,90.0,2143
17149,27,31,58,3,5,90.0,2.0,90.0,2143
17150,22,67,89,3,6,90.0,2.0,90.0,2143
17151,9,19,28,3,7,90.0,2.0,90.0,2143
17152,100,0,100,1,0,90.0,2.0,90.0,2144
17153,100,0,100,1,1,90.0,2.0,90.0,2144
17154,25,75,100,2,2,90.0,2.0,90.0,2144
17155,-100,100,0,2,3,90.0,2.0,90.0,2144
17156,50,50,100,3,4,90.0,2.0,90.0,2144
17157,50,50,100,3,5,90.0,2.0,90.0,2144
17158,90,10,100,3,6,90.0,2.0,90.0,2144
17159,100,0,100,3,7,90.0,2.0,90.0,2144
17160,39,61,100,1,0,90.0,2.0,90.0,2145
17161,0,100,100,1,1,90.0,2.0,90.0,2145
17162,-33,43,10,2,2,90.0,2.0,90.0,2145
17163,20,80,100,2,3,90.0,2.0,90.0,2145
17164,42,58,100,3,4,90.0,2.0,90.0,2145
17165,56,44,100,3,5,90.0,2.0,90.0,2145
17166,36,64,100,3,6,90.0,2.0,90.0,2145
17167,64,36,100,3,7,90.0,2.0,90.0,2145
17168,0,25,25,1,0,90.0,2.0,90.0,2146
17169,0,0,0,1,1,90.0,2.0,90.0,2146
17170,40,50,90,2,2,90.0,2.0,90.0,2146
17171,0,90,90,2,3,90.0,2.0,90.0,2146
17172,15,75,90,3,4,90.0,2.0,90.0,2146
17173,40,50,90,3,5,90.0,2.0,90.0,2146
17174,-25,50,25,3,6,90.0,2.0,90.0,2146
17175,0,50,50,3,7,90.0,2.0,90.0,2146
17176,29,10,39,1,0,90.0,2.0,90.0,2147
17177,29,40,69,1,1,90.0,2.0,90.0,2147
17178,25,75,100,2,2,90.0,2.0,90.0,2147
17179,10,90,100,2,3,90.0,2.0,90.0,2147
17180,50,40,90,3,4,90.0,2.0,90.0,2147
17181,50,30,80,3,5,90.0,2.0,90.0,2147
17182,25,75,100,3,6,90.0,2.0,90.0,2147
17183,-30,70,40,3,7,90.0,2.0,90.0,2147
17184,0,0,0,1,0,90.0,2.0,90.0,2148
17185,0,0,0,1,1,90.0,2.0,90.0,2148
17186,0,90,90,2,2,90.0,2.0,90.0,2148
17187,5,90,95,2,3,90.0,2.0,90.0,2148
17188,0,40,40,3,4,90.0,2.0,90.0,2148
17189,0,50,50,3,5,90.0,2.0,90.0,2148
17190,55,25,80,3,6,90.0,2.0,90.0,2148
17191,-75,75,0,3,7,90.0,2.0,90.0,2148
17192,57,32,89,1,0,90.0,2.0,90.0,2149
17193,53,27,80,1,1,90.0,2.0,90.0,2149
17194,13,72,85,2,2,90.0,2.0,90.0,2149
17195,0,100,100,2,3,90.0,2.0,90.0,2149
17196,49,37,86,3,4,90.0,2.0,90.0,2149
17197,65,29,94,3,5,90.0,2.0,90.0,2149
17198,59,41,100,3,6,90.0,2.0,90.0,2149
17199,72,11,83,3,7,90.0,2.0,90.0,2149
17200,6,4,10,1,0,90.0,2.0,90.0,2150
17201,0,0,0,1,1,90.0,2.0,90.0,2150
17202,20,80,100,2,2,90.0,2.0,90.0,2150
17203,0,100,100,2,3,90.0,2.0,90.0,2150
17204,0,82,82,3,4,90.0,2.0,90.0,2150
17205,35,65,100,3,5,90.0,2.0,90.0,2150
17206,22,0,22,3,6,90.0,2.0,90.0,2150
17207,30,30,60,3,7,90.0,2.0,90.0,2150
17208,0,0,0,1,0,90.0,2.0,90.0,2151
17209,0,0,0,1,1,90.0,2.0,90.0,2151
17210,50,50,100,2,2,90.0,2.0,90.0,2151
17211,0,100,100,2,3,90.0,2.0,90.0,2151
17212,-4,18,14,3,4,90.0,2.0,90.0,2151
17213,23,27,50,3,5,90.0,2.0,90.0,2151
17214,-7,32,25,3,6,90.0,2.0,90.0,2151
17215,25,0,25,3,7,90.0,2.0,90.0,2151
17216,73,27,100,1,0,90.0,2.0,90.0,2152
17217,15,85,100,1,1,90.0,2.0,90.0,2152
17218,40,60,100,2,2,90.0,2.0,90.0,2152
17219,100,0,100,2,3,90.0,2.0,90.0,2152
17220,79,21,100,3,4,90.0,2.0,90.0,2152
17221,100,0,100,3,5,90.0,2.0,90.0,2152
17222,100,0,100,3,6,90.0,2.0,90.0,2152
17223,84,16,100,3,7,90.0,2.0,90.0,2152
17224,80,20,100,1,0,90.0,2.0,90.0,2153
17225,60,40,100,1,1,90.0,2.0,90.0,2153
17226,30,70,100,2,2,90.0,2.0,90.0,2153
17227,-50,50,0,2,3,90.0,2.0,90.0,2153
17228,55,45,100,3,4,90.0,2.0,90.0,2153
17229,65,35,100,3,5,90.0,2.0,90.0,2153
17230,65,35,100,3,6,90.0,2.0,90.0,2153
17231,10,90,100,3,7,90.0,2.0,90.0,2153
17232,1,37,38,1,0,90.0,2.0,90.0,2154
17233,47,33,80,1,1,90.0,2.0,90.0,2154
17234,-48,80,32,2,2,90.0,2.0,90.0,2154
17235,3,1,4,2,3,90.0,2.0,90.0,2154
17236,2,87,89,3,4,90.0,2.0,90.0,2154
17237,12,66,78,3,5,90.0,2.0,90.0,2154
17238,8,17,25,3,6,90.0,2.0,90.0,2154
17239,-21,36,15,3,7,90.0,2.0,90.0,2154
17240,-7,69,62,1,0,90.0,2.0,90.0,2155
17241,-32,64,32,1,1,90.0,2.0,90.0,2155
17242,41,19,60,2,2,90.0,2.0,90.0,2155
17243,-13,75,62,2,3,90.0,2.0,90.0,2155
17244,0,72,72,3,4,90.0,2.0,90.0,2155
17245,-14,78,64,3,5,90.0,2.0,90.0,2155
17246,-29,68,39,3,6,90.0,2.0,90.0,2155
17247,40,30,70,3,7,90.0,2.0,90.0,2155
17248,0,50,50,1,0,90.0,2.0,90.0,2156
17249,-29,79,50,1,1,90.0,2.0,90.0,2156
17250,42,50,92,2,2,90.0,2.0,90.0,2156
17251,-1,96,95,2,3,90.0,2.0,90.0,2156
17252,8,36,44,3,4,90.0,2.0,90.0,2156
17253,17,64,81,3,5,90.0,2.0,90.0,2156
17254,0,50,50,3,6,90.0,2.0,90.0,2156
17255,11,70,81,3,7,90.0,2.0,90.0,2156
17256,69,31,100,1,0,90.0,2.0,90.0,2157
17257,65,35,100,1,1,90.0,2.0,90.0,2157
17258,10,90,100,2,2,90.0,2.0,90.0,2157
17259,5,95,100,2,3,90.0,2.0,90.0,2157
17260,71,29,100,3,4,90.0,2.0,90.0,2157
17261,40,60,100,3,5,90.0,2.0,90.0,2157
17262,-25,25,0,3,6,90.0,2.0,90.0,2157
17263,90,10,100,3,7,90.0,2.0,90.0,2157
17264,40,0,40,1,0,90.0,2.0,90.0,2158
17265,60,0,60,1,1,90.0,2.0,90.0,2158
17266,0,100,100,2,2,90.0,2.0,90.0,2158
17267,0,100,100,2,3,90.0,2.0,90.0,2158
17268,60,40,100,3,4,90.0,2.0,90.0,2158
17269,80,20,100,3,5,90.0,2.0,90.0,2158
17270,65,30,95,3,6,90.0,2.0,90.0,2158
17271,80,0,80,3,7,90.0,2.0,90.0,2158
17272,7,0,7,1,0,90.0,2.0,90.0,2159
17273,-5,75,70,1,1,90.0,2.0,90.0,2159
17274,9,86,95,2,2,90.0,2.0,90.0,2159
17275,-39,96,57,2,3,90.0,2.0,90.0,2159
17276,12,74,86,3,4,90.0,2.0,90.0,2159
17277,0,53,53,3,5,90.0,2.0,90.0,2159
17278,5,95,100,3,6,90.0,2.0,90.0,2159
17279,-28,59,31,3,7,90.0,2.0,90.0,2159
17280,5,68,73,1,0,90.0,2.0,90.0,2160
17281,13,66,79,1,1,90.0,2.0,90.0,2160
17282,4,76,80,2,2,90.0,2.0,90.0,2160
17283,11,74,85,2,3,90.0,2.0,90.0,2160
17284,14,82,96,3,4,90.0,2.0,90.0,2160
17285,21,61,82,3,5,90.0,2.0,90.0,2160
17286,25,75,100,3,6,90.0,2.0,90.0,2160
17287,5,69,74,3,7,90.0,2.0,90.0,2160
17288,17,10,27,1,0,90.0,2.0,90.0,2161
17289,9,4,13,1,1,90.0,2.0,90.0,2161
17290,14,86,100,2,2,90.0,2.0,90.0,2161
17291,2,98,100,2,3,90.0,2.0,90.0,2161
17292,12,65,77,3,4,90.0,2.0,90.0,2161
17293,43,14,57,3,5,90.0,2.0,90.0,2161
17294,34,16,50,3,6,90.0,2.0,90.0,2161
17295,49,8,57,3,7,90.0,2.0,90.0,2161
17296,100,0,100,1,0,90.0,2.0,90.0,2162
17297,-20,20,0,1,1,90.0,2.0,90.0,2162
17298,0,100,100,2,2,90.0,2.0,90.0,2162
17299,100,0,100,2,3,90.0,2.0,90.0,2162
17300,29,71,100,3,4,90.0,2.0,90.0,2162
17301,50,50,100,3,5,90.0,2.0,90.0,2162
17302,48,52,100,3,6,90.0,2.0,90.0,2162
17303,100,0,100,3,7,90.0,2.0,90.0,2162
17304,6,26,32,1,0,90.0,2.0,90.0,2163
17305,3,13,16,1,1,90.0,2.0,90.0,2163
17306,-5,77,72,2,2,90.0,2.0,90.0,2163
17307,0,92,92,2,3,90.0,2.0,90.0,2163
17308,4,77,81,3,4,90.0,2.0,90.0,2163
17309,23,50,73,3,5,90.0,2.0,90.0,2163
17310,27,50,77,3,6,90.0,2.0,90.0,2163
17311,17,14,31,3,7,90.0,2.0,90.0,2163
17312,40,10,50,1,0,90.0,2.0,90.0,2164
17313,5,5,10,1,1,90.0,2.0,90.0,2164
17314,0,95,95,2,2,90.0,2.0,90.0,2164
17315,0,100,100,2,3,90.0,2.0,90.0,2164
17316,10,65,75,3,4,90.0,2.0,90.0,2164
17317,-3,98,95,3,5,90.0,2.0,90.0,2164
17318,5,90,95,3,6,90.0,2.0,90.0,2164
17319,50,10,60,3,7,90.0,2.0,90.0,2164
17320,0,0,0,1,0,90.0,2.0,90.0,2165
17321,24,7,31,1,1,90.0,2.0,90.0,2165
17322,1,74,75,2,2,90.0,2.0,90.0,2165
17323,-8,81,73,2,3,90.0,2.0,90.0,2165
17324,-6,32,26,3,4,90.0,2.0,90.0,2165
17325,-1,21,20,3,5,90.0,2.0,90.0,2165
17326,-16,32,16,3,6,90.0,2.0,90.0,2165
17327,0,0,0,3,7,90.0,2.0,90.0,2165
17328,50,0,50,1,0,91.0,2.0,91.0,2166
17329,0,0,0,1,1,91.0,2.0,91.0,2166
17330,50,50,100,2,2,91.0,2.0,91.0,2166
17331,0,100,100,2,3,91.0,2.0,91.0,2166
17332,26,50,76,3,4,91.0,2.0,91.0,2166
17333,76,0,76,3,5,91.0,2.0,91.0,2166
17334,33,31,64,3,6,91.0,2.0,91.0,2166
17335,24,0,24,3,7,91.0,2.0,91.0,2166
17336,57,16,73,1,0,91.0,2.0,91.0,2167
17337,87,11,98,1,1,91.0,2.0,91.0,2167
17338,56,35,91,2,2,91.0,2.0,91.0,2167
17339,48,52,100,2,3,91.0,2.0,91.0,2167
17340,51,49,100,3,4,91.0,2.0,91.0,2167
17341,63,34,97,3,5,91.0,2.0,91.0,2167
17342,30,70,100,3,6,91.0,2.0,91.0,2167
17343,-15,25,10,3,7,91.0,2.0,91.0,2167
17344,0,25,25,1,0,91.0,2.0,91.0,2168
17345,7,5,12,1,1,91.0,2.0,91.0,2168
17346,25,50,75,2,2,91.0,2.0,91.0,2168
17347,11,60,71,2,3,91.0,2.0,91.0,2168
17348,6,75,81,3,4,91.0,2.0,91.0,2168
17349,0,50,50,3,5,91.0,2.0,91.0,2168
17350,27,50,77,3,6,91.0,2.0,91.0,2168
17351,75,0,75,3,7,91.0,2.0,91.0,2168
17352,32,50,82,1,0,91.0,2.0,91.0,2169
17353,14,15,29,1,1,91.0,2.0,91.0,2169
17354,-41,81,40,2,2,91.0,2.0,91.0,2169
17355,23,50,73,2,3,91.0,2.0,91.0,2169
17356,4,77,81,3,4,91.0,2.0,91.0,2169
17357,-55,86,31,3,5,91.0,2.0,91.0,2169
17358,-44,75,31,3,6,91.0,2.0,91.0,2169
17359,18,62,80,3,7,91.0,2.0,91.0,2169
17360,100,0,100,1,0,91.0,2.0,91.0,2170
17361,98,2,100,1,1,91.0,2.0,91.0,2170
17362,-2,79,77,2,2,91.0,2.0,91.0,2170
17363,73,0,73,2,3,91.0,2.0,91.0,2170
17364,83,17,100,3,4,91.0,2.0,91.0,2170
17365,66,34,100,3,5,91.0,2.0,91.0,2170
17366,0,100,100,3,6,91.0,2.0,91.0,2170
17367,100,0,100,3,7,91.0,2.0,91.0,2170
17368,0,0,0,1,0,91.0,2.0,91.0,2171
17369,6,1,7,1,1,91.0,2.0,91.0,2171
17370,-12,83,71,2,2,91.0,2.0,91.0,2171
17371,3,0,3,2,3,91.0,2.0,91.0,2171
17372,2,78,80,3,4,91.0,2.0,91.0,2171
17373,41,58,99,3,5,91.0,2.0,91.0,2171
17374,-33,33,0,3,6,91.0,2.0,91.0,2171
17375,44,39,83,3,7,91.0,2.0,91.0,2171
17376,11,0,11,1,0,91.0,2.0,91.0,2172
17377,24,0,24,1,1,91.0,2.0,91.0,2172
17378,25,75,100,2,2,91.0,2.0,91.0,2172
17379,0,100,100,2,3,91.0,2.0,91.0,2172
17380,39,37,76,3,4,91.0,2.0,91.0,2172
17381,87,0,87,3,5,91.0,2.0,91.0,2172
17382,-88,88,0,3,6,91.0,2.0,91.0,2172
17383,36,50,86,3,7,91.0,2.0,91.0,2172
17384,0,0,0,1,0,91.0,2.0,91.0,2173
17385,0,0,0,1,1,91.0,2.0,91.0,2173
17386,95,0,95,2,2,91.0,2.0,91.0,2173
17387,-100,100,0,2,3,91.0,2.0,91.0,2173
17388,-95,95,0,3,4,91.0,2.0,91.0,2173
17389,45,50,95,3,5,91.0,2.0,91.0,2173
17390,-8,13,5,3,6,91.0,2.0,91.0,2173
17391,10,0,10,3,7,91.0,2.0,91.0,2173
17392,12,19,31,1,0,91.0,2.0,91.0,2174
17393,-4,5,1,1,1,91.0,2.0,91.0,2174
17394,-35,73,38,2,2,91.0,2.0,91.0,2174
17395,31,35,66,2,3,91.0,2.0,91.0,2174
17396,24,26,50,3,4,91.0,2.0,91.0,2174
17397,0,50,50,3,5,91.0,2.0,91.0,2174
17398,12,13,25,3,6,91.0,2.0,91.0,2174
17399,1,24,25,3,7,91.0,2.0,91.0,2174
17400,100,0,100,1,0,91.0,2.0,91.0,2175
17401,-4,99,95,1,1,91.0,2.0,91.0,2175
17402,-22,72,50,2,2,91.0,2.0,91.0,2175
17403,1,99,100,2,3,91.0,2.0,91.0,2175
17404,14,86,100,3,4,91.0,2.0,91.0,2175
17405,15,73,88,3,5,91.0,2.0,91.0,2175
17406,38,62,100,3,6,91.0,2.0,91.0,2175
17407,100,0,100,3,7,91.0,2.0,91.0,2175
17408,92,4,96,1,0,91.0,2.0,91.0,2176
17409,29,70,99,1,1,91.0,2.0,91.0,2176
17410,38,60,98,2,2,91.0,2.0,91.0,2176
17411,84,15,99,2,3,91.0,2.0,91.0,2176
17412,29,70,99,3,4,91.0,2.0,91.0,2176
17413,83,17,100,3,5,91.0,2.0,91.0,2176
17414,2,97,99,3,6,91.0,2.0,91.0,2176
17415,39,60,99,3,7,91.0,2.0,91.0,2176
17416,-67,100,33,1,0,91.0,2.0,91.0,2177
17417,-1,25,24,1,1,91.0,2.0,91.0,2177
17418,23,77,100,2,2,91.0,2.0,91.0,2177
17419,-32,77,45,2,3,91.0,2.0,91.0,2177
17420,1,76,77,3,4,91.0,2.0,91.0,2177
17421,2,50,52,3,5,91.0,2.0,91.0,2177
17422,25,75,100,3,6,91.0,2.0,91.0,2177
17423,-1,25,24,3,7,91.0,2.0,91.0,2177
17424,12,1,13,1,0,91.0,2.0,91.0,2178
17425,-16,35,19,1,1,91.0,2.0,91.0,2178
17426,-10,83,73,2,2,91.0,2.0,91.0,2178
17427,10,80,90,2,3,91.0,2.0,91.0,2178
17428,9,64,73,3,4,91.0,2.0,91.0,2178
17429,-1,1,0,3,5,91.0,2.0,91.0,2178
17430,1,62,63,3,6,91.0,2.0,91.0,2178
17431,11,14,25,3,7,91.0,2.0,91.0,2178
17432,40,10,50,1,0,91.0,2.0,91.0,2179
17433,13,80,93,1,1,91.0,2.0,91.0,2179
17434,3,91,94,2,2,91.0,2.0,91.0,2179
17435,19,75,94,2,3,91.0,2.0,91.0,2179
17436,16,75,91,3,4,91.0,2.0,91.0,2179
17437,36,55,91,3,5,91.0,2.0,91.0,2179
17438,15,80,95,3,6,91.0,2.0,91.0,2179
17439,46,4,50,3,7,91.0,2.0,91.0,2179
17440,100,0,100,1,0,91.0,2.0,91.0,2180
17441,69,31,100,1,1,91.0,2.0,91.0,2180
17442,0,100,100,2,2,91.0,2.0,91.0,2180
17443,0,100,100,2,3,91.0,2.0,91.0,2180
17444,0,100,100,3,4,91.0,2.0,91.0,2180
17445,50,50,100,3,5,91.0,2.0,91.0,2180
17446,28,72,100,3,6,91.0,2.0,91.0,2180
17447,100,0,100,3,7,91.0,2.0,91.0,2180
17448,5,6,11,1,0,91.0,2.0,91.0,2181
17449,0,50,50,1,1,91.0,2.0,91.0,2181
17450,2,89,91,2,2,91.0,2.0,91.0,2181
17451,-2,66,64,2,3,91.0,2.0,91.0,2181
17452,-4,59,55,3,4,91.0,2.0,91.0,2181
17453,0,50,50,3,5,91.0,2.0,91.0,2181
17454,43,10,53,3,6,91.0,2.0,91.0,2181
17455,-1,88,87,3,7,91.0,2.0,91.0,2181
17456,54,33,87,1,0,91.0,2.0,91.0,2182
17457,9,77,86,1,1,91.0,2.0,91.0,2182
17458,19,70,89,2,2,91.0,2.0,91.0,2182
17459,6,87,93,2,3,91.0,2.0,91.0,2182
17460,26,74,100,3,4,91.0,2.0,91.0,2182
17461,67,32,99,3,5,91.0,2.0,91.0,2182
17462,12,71,83,3,6,91.0,2.0,91.0,2182
17463,15,78,93,3,7,91.0,2.0,91.0,2182
17464,31,17,48,1,0,91.0,2.0,91.0,2183
17465,35,30,65,1,1,91.0,2.0,91.0,2183
17466,-19,80,61,2,2,91.0,2.0,91.0,2183
17467,14,80,94,2,3,91.0,2.0,91.0,2183
17468,56,21,77,3,4,91.0,2.0,91.0,2183
17469,20,64,84,3,5,91.0,2.0,91.0,2183
17470,23,54,77,3,6,91.0,2.0,91.0,2183
17471,36,24,60,3,7,91.0,2.0,91.0,2183
17472,0,0,0,1,0,91.0,2.0,91.0,2184
17473,0,0,0,1,1,91.0,2.0,91.0,2184
17474,0,100,100,2,2,91.0,2.0,91.0,2184
17475,1,78,79,2,3,91.0,2.0,91.0,2184
17476,11,76,87,3,4,91.0,2.0,91.0,2184
17477,47,27,74,3,5,91.0,2.0,91.0,2184
17478,100,0,100,3,6,91.0,2.0,91.0,2184
17479,-4,7,3,3,7,91.0,2.0,91.0,2184
17480,-1,27,26,1,0,92.0,2.0,92.0,2185
17481,3,14,17,1,1,92.0,2.0,92.0,2185
17482,0,50,50,2,2,92.0,2.0,92.0,2185
17483,-1,89,88,2,3,92.0,2.0,92.0,2185
17484,-2,50,48,3,4,92.0,2.0,92.0,2185
17485,-1,50,49,3,5,92.0,2.0,92.0,2185
17486,2,49,51,3,6,92.0,2.0,92.0,2185
17487,-2,84,82,3,7,92.0,2.0,92.0,2185
17488,0,0,0,1,0,92.0,2.0,92.0,2186
17489,0,0,0,1,1,92.0,2.0,92.0,2186
17490,51,49,100,2,2,92.0,2.0,92.0,2186
17491,0,0,0,2,3,92.0,2.0,92.0,2186
17492,-2,99,97,3,4,92.0,2.0,92.0,2186
17493,38,11,49,3,5,92.0,2.0,92.0,2186
17494,-1,49,48,3,6,92.0,2.0,92.0,2186
17495,-11,11,0,3,7,92.0,2.0,92.0,2186
17496,5,84,89,1,0,92.0,2.0,92.0,2187
17497,-2,90,88,1,1,92.0,2.0,92.0,2187
17498,-12,78,66,2,2,92.0,2.0,92.0,2187
17499,29,69,98,2,3,92.0,2.0,92.0,2187
17500,3,87,90,3,4,92.0,2.0,92.0,2187
17501,-2,93,91,3,5,92.0,2.0,92.0,2187
17502,7,83,90,3,6,92.0,2.0,92.0,2187
17503,3,77,80,3,7,92.0,2.0,92.0,2187
17504,-3,82,79,1,0,92.0,2.0,92.0,2188
17505,-26,100,74,1,1,92.0,2.0,92.0,2188
17506,7,78,85,2,2,92.0,2.0,92.0,2188
17507,-30,95,65,2,3,92.0,2.0,92.0,2188
17508,1,77,78,3,4,92.0,2.0,92.0,2188
17509,-14,100,86,3,5,92.0,2.0,92.0,2188
17510,-44,94,50,3,6,92.0,2.0,92.0,2188
17511,-7,97,90,3,7,92.0,2.0,92.0,2188
17512,16,64,80,1,0,92.0,2.0,92.0,2189
17513,3,94,97,1,1,92.0,2.0,92.0,2189
17514,17,54,71,2,2,92.0,2.0,92.0,2189
17515,-2,73,71,2,3,92.0,2.0,92.0,2189
17516,5,83,88,3,4,92.0,2.0,92.0,2189
17517,-17,32,15,3,5,92.0,2.0,92.0,2189
17518,21,25,46,3,6,92.0,2.0,92.0,2189
17519,35,44,79,3,7,92.0,2.0,92.0,2189
17520,62,0,62,1,0,92.0,2.0,92.0,2190
17521,14,75,89,1,1,92.0,2.0,92.0,2190
17522,0,100,100,2,2,92.0,2.0,92.0,2190
17523,0,100,100,2,3,92.0,2.0,92.0,2190
17524,11,65,76,3,4,92.0,2.0,92.0,2190
17525,-23,74,51,3,5,92.0,2.0,92.0,2190
17526,48,52,100,3,6,92.0,2.0,92.0,2190
17527,-36,95,59,3,7,92.0,2.0,92.0,2190
17528,43,0,43,1,0,92.0,2.0,92.0,2191
17529,19,61,80,1,1,92.0,2.0,92.0,2191
17530,0,100,100,2,2,92.0,2.0,92.0,2191
17531,11,89,100,2,3,92.0,2.0,92.0,2191
17532,30,63,93,3,4,92.0,2.0,92.0,2191
17533,50,43,93,3,5,92.0,2.0,92.0,2191
17534,87,13,100,3,6,92.0,2.0,92.0,2191
17535,38,43,81,3,7,92.0,2.0,92.0,2191
17536,100,0,100,1,0,92.0,2.0,92.0,2192
17537,22,78,100,1,1,92.0,2.0,92.0,2192
17538,49,50,99,2,2,92.0,2.0,92.0,2192
17539,1,99,100,2,3,92.0,2.0,92.0,2192
17540,9,90,99,3,4,92.0,2.0,92.0,2192
17541,50,50,100,3,5,92.0,2.0,92.0,2192
17542,0,100,100,3,6,92.0,2.0,92.0,2192
17543,78,22,100,3,7,92.0,2.0,92.0,2192
17544,-3,99,96,1,0,92.0,2.0,92.0,2193
17545,-7,99,92,1,1,92.0,2.0,92.0,2193
17546,-7,96,89,2,2,92.0,2.0,92.0,2193
17547,7,89,96,2,3,92.0,2.0,92.0,2193
17548,-6,94,88,3,4,92.0,2.0,92.0,2193
17549,12,88,100,3,5,92.0,2.0,92.0,2193
17550,-7,98,91,3,6,92.0,2.0,92.0,2193
17551,5,89,94,3,7,92.0,2.0,92.0,2193
17552,0,0,0,1,0,92.0,2.0,92.0,2194
17553,1,74,75,1,1,92.0,2.0,92.0,2194
17554,0,100,100,2,2,92.0,2.0,92.0,2194
17555,0,0,0,2,3,92.0,2.0,92.0,2194
17556,-5,95,90,3,4,92.0,2.0,92.0,2194
17557,0,10,10,3,5,92.0,2.0,92.0,2194
17558,-2,5,3,3,6,92.0,2.0,92.0,2194
17559,0,5,5,3,7,92.0,2.0,92.0,2194
17560,5,6,11,1,0,92.0,2.0,92.0,2195
17561,9,4,13,1,1,92.0,2.0,92.0,2195
17562,-15,99,84,2,2,92.0,2.0,92.0,2195
17563,-2,100,98,2,3,92.0,2.0,92.0,2195
17564,4,61,65,3,4,92.0,2.0,92.0,2195
17565,10,24,34,3,5,92.0,2.0,92.0,2195
17566,-7,24,17,3,6,92.0,2.0,92.0,2195
17567,-9,27,18,3,7,92.0,2.0,92.0,2195
17568,0,100,100,1,0,93.0,2.0,93.0,2196
17569,0,100,100,1,1,93.0,2.0,93.0,2196
17570,-13,20,7,2,2,93.0,2.0,93.0,2196
17571,-2,83,81,2,3,93.0,2.0,93.0,2196
17572,12,86,98,3,4,93.0,2.0,93.0,2196
17573,0,50,50,3,5,93.0,2.0,93.0,2196
17574,4,86,90,3,6,93.0,2.0,93.0,2196
17575,0,3,3,3,7,93.0,2.0,93.0,2196
17576,100,0,100,1,0,93.0,2.0,93.0,2197
17577,7,93,100,1,1,93.0,2.0,93.0,2197
17578,-5,88,83,2,2,93.0,2.0,93.0,2197
17579,-9,82,73,2,3,93.0,2.0,93.0,2197
17580,6,94,100,3,4,93.0,2.0,93.0,2197
17581,41,59,100,3,5,93.0,2.0,93.0,2197
17582,28,72,100,3,6,93.0,2.0,93.0,2197
17583,93,6,99,3,7,93.0,2.0,93.0,2197
17584,-12,37,25,1,0,93.0,2.0,93.0,2198
17585,0,100,100,1,1,93.0,2.0,93.0,2198
17586,40,26,66,2,2,93.0,2.0,93.0,2198
17587,-57,70,13,2,3,93.0,2.0,93.0,2198
17588,-3,35,32,3,4,93.0,2.0,93.0,2198
17589,-6,36,30,3,5,93.0,2.0,93.0,2198
17590,13,62,75,3,6,93.0,2.0,93.0,2198
17591,-19,27,8,3,7,93.0,2.0,93.0,2198
17592,100,0,100,1,0,93.0,2.0,93.0,2199
17593,0,0,0,1,1,93.0,2.0,93.0,2199
17594,11,89,100,2,2,93.0,2.0,93.0,2199
17595,0,100,100,2,3,93.0,2.0,93.0,2199
17596,37,63,100,3,4,93.0,2.0,93.0,2199
17597,100,0,100,3,5,93.0,2.0,93.0,2199
17598,-8,21,13,3,6,93.0,2.0,93.0,2199
17599,0,0,0,3,7,93.0,2.0,93.0,2199
17600,1,0,1,1,0,93.0,2.0,93.0,2200
17601,53,23,76,1,1,93.0,2.0,93.0,2200
17602,-20,41,21,2,2,93.0,2.0,93.0,2200
17603,82,0,82,2,3,93.0,2.0,93.0,2200
17604,18,82,100,3,4,93.0,2.0,93.0,2200
17605,80,9,89,3,5,93.0,2.0,93.0,2200
17606,71,13,84,3,6,93.0,2.0,93.0,2200
17607,20,2,22,3,7,93.0,2.0,93.0,2200
17608,56,0,56,1,0,93.0,2.0,93.0,2201
17609,21,0,21,1,1,93.0,2.0,93.0,2201
17610,0,100,100,2,2,93.0,2.0,93.0,2201
17611,0,100,100,2,3,93.0,2.0,93.0,2201
17612,51,16,67,3,4,93.0,2.0,93.0,2201
17613,100,0,100,3,5,93.0,2.0,93.0,2201
17614,22,78,100,3,6,93.0,2.0,93.0,2201
17615,62,0,62,3,7,93.0,2.0,93.0,2201
17616,100,0,100,1,0,93.0,2.0,93.0,2202
17617,74,23,97,1,1,93.0,2.0,93.0,2202
17618,-57,80,23,2,2,93.0,2.0,93.0,2202
17619,83,17,100,2,3,93.0,2.0,93.0,2202
17620,97,3,100,3,4,93.0,2.0,93.0,2202
17621,28,72,100,3,5,93.0,2.0,93.0,2202
17622,80,20,100,3,6,93.0,2.0,93.0,2202
17623,75,25,100,3,7,93.0,2.0,93.0,2202
17624,34,66,100,1,0,93.0,2.0,93.0,2203
17625,44,27,71,1,1,93.0,2.0,93.0,2203
17626,17,83,100,2,2,93.0,2.0,93.0,2203
17627,0,100,100,2,3,93.0,2.0,93.0,2203
17628,-51,66,15,3,4,93.0,2.0,93.0,2203
17629,58,42,100,3,5,93.0,2.0,93.0,2203
17630,77,23,100,3,6,93.0,2.0,93.0,2203
17631,95,5,100,3,7,93.0,2.0,93.0,2203
17632,0,2,2,1,0,93.0,2.0,93.0,2204
17633,68,8,76,1,1,93.0,2.0,93.0,2204
17634,2,92,94,2,2,93.0,2.0,93.0,2204
17635,83,0,83,2,3,93.0,2.0,93.0,2204
17636,29,50,79,3,4,93.0,2.0,93.0,2204
17637,35,15,50,3,5,93.0,2.0,93.0,2204
17638,0,50,50,3,6,93.0,2.0,93.0,2204
17639,46,15,61,3,7,93.0,2.0,93.0,2204
17640,18,0,18,1,0,93.0,2.0,93.0,2205
17641,2,57,59,1,1,93.0,2.0,93.0,2205
17642,-20,90,70,2,2,93.0,2.0,93.0,2205
17643,-24,77,53,2,3,93.0,2.0,93.0,2205
17644,58,20,78,3,4,93.0,2.0,93.0,2205
17645,12,27,39,3,5,93.0,2.0,93.0,2205
17646,28,47,75,3,6,93.0,2.0,93.0,2205
17647,10,3,13,3,7,93.0,2.0,93.0,2205
17648,28,72,100,1,0,93.0,2.0,93.0,2206
17649,22,78,100,1,1,93.0,2.0,93.0,2206
17650,82,18,100,2,2,93.0,2.0,93.0,2206
17651,63,37,100,2,3,93.0,2.0,93.0,2206
17652,39,61,100,3,4,93.0,2.0,93.0,2206
17653,68,32,100,3,5,93.0,2.0,93.0,2206
17654,69,31,100,3,6,93.0,2.0,93.0,2206
17655,50,50,100,3,7,93.0,2.0,93.0,2206
17656,-1,95,94,1,0,93.0,2.0,93.0,2207
17657,0,6,6,1,1,93.0,2.0,93.0,2207
17658,2,4,6,2,2,93.0,2.0,93.0,2207
17659,-3,8,5,2,3,93.0,2.0,93.0,2207
17660,5,6,11,3,4,93.0,2.0,93.0,2207
17661,4,6,10,3,5,93.0,2.0,93.0,2207
17662,1,3,4,3,6,93.0,2.0,93.0,2207
17663,-2,9,7,3,7,93.0,2.0,93.0,2207
17664,97,3,100,1,0,93.0,2.0,93.0,2208
17665,0,100,100,1,1,93.0,2.0,93.0,2208
17666,89,11,100,2,2,93.0,2.0,93.0,2208
17667,87,13,100,2,3,93.0,2.0,93.0,2208
17668,0,100,100,3,4,93.0,2.0,93.0,2208
17669,78,22,100,3,5,93.0,2.0,93.0,2208
17670,83,17,100,3,6,93.0,2.0,93.0,2208
17671,98,2,100,3,7,93.0,2.0,93.0,2208
17672,0,0,0,1,0,93.0,2.0,93.0,2209
17673,0,0,0,1,1,93.0,2.0,93.0,2209
17674,0,100,100,2,2,93.0,2.0,93.0,2209
17675,0,100,100,2,3,93.0,2.0,93.0,2209
17676,1,99,100,3,4,93.0,2.0,93.0,2209
17677,0,50,50,3,5,93.0,2.0,93.0,2209
17678,0,100,100,3,6,93.0,2.0,93.0,2209
17679,47,0,47,3,7,93.0,2.0,93.0,2209
17680,97,3,100,1,0,94.0,2.0,94.0,2210
17681,99,0,99,1,1,94.0,2.0,94.0,2210
17682,71,29,100,2,2,94.0,2.0,94.0,2210
17683,18,82,100,2,3,94.0,2.0,94.0,2210
17684,25,75,100,3,4,94.0,2.0,94.0,2210
17685,90,10,100,3,5,94.0,2.0,94.0,2210
17686,0,100,100,3,6,94.0,2.0,94.0,2210
17687,76,24,100,3,7,94.0,2.0,94.0,2210
17688,88,12,100,1,0,94.0,2.0,94.0,2211
17689,44,56,100,1,1,94.0,2.0,94.0,2211
17690,27,68,95,2,2,94.0,2.0,94.0,2211
17691,10,83,93,2,3,94.0,2.0,94.0,2211
17692,22,73,95,3,4,94.0,2.0,94.0,2211
17693,40,60,100,3,5,94.0,2.0,94.0,2211
17694,67,26,93,3,6,94.0,2.0,94.0,2211
17695,-6,15,9,3,7,94.0,2.0,94.0,2211
17696,-6,16,10,1,0,94.0,2.0,94.0,2212
17697,0,0,0,1,1,94.0,2.0,94.0,2212
17698,13,87,100,2,2,94.0,2.0,94.0,2212
17699,0,100,100,2,3,94.0,2.0,94.0,2212
17700,13,27,40,3,4,94.0,2.0,94.0,2212
17701,69,0,69,3,5,94.0,2.0,94.0,2212
17702,3,91,94,3,6,94.0,2.0,94.0,2212
17703,9,0,9,3,7,94.0,2.0,94.0,2212
17704,100,0,100,1,0,94.0,2.0,94.0,2213
17705,83,17,100,1,1,94.0,2.0,94.0,2213
17706,30,70,100,2,2,94.0,2.0,94.0,2213
17707,89,11,100,2,3,94.0,2.0,94.0,2213
17708,60,40,100,3,4,94.0,2.0,94.0,2213
17709,80,20,100,3,5,94.0,2.0,94.0,2213
17710,66,34,100,3,6,94.0,2.0,94.0,2213
17711,86,14,100,3,7,94.0,2.0,94.0,2213
17712,90,10,100,1,0,94.0,2.0,94.0,2214
17713,99,0,99,1,1,94.0,2.0,94.0,2214
17714,16,84,100,2,2,94.0,2.0,94.0,2214
17715,0,100,100,2,3,94.0,2.0,94.0,2214
17716,5,95,100,3,4,94.0,2.0,94.0,2214
17717,41,59,100,3,5,94.0,2.0,94.0,2214
17718,86,14,100,3,6,94.0,2.0,94.0,2214
17719,61,39,100,3,7,94.0,2.0,94.0,2214
17720,15,16,31,1,0,94.0,2.0,94.0,2215
17721,32,24,56,1,1,94.0,2.0,94.0,2215
17722,9,65,74,2,2,94.0,2.0,94.0,2215
17723,24,58,82,2,3,94.0,2.0,94.0,2215
17724,19,55,74,3,4,94.0,2.0,94.0,2215
17725,34,42,76,3,5,94.0,2.0,94.0,2215
17726,34,34,68,3,6,94.0,2.0,94.0,2215
17727,61,16,77,3,7,94.0,2.0,94.0,2215
17728,-7,92,85,1,0,94.0,2.0,94.0,2216
17729,-4,95,91,1,1,94.0,2.0,94.0,2216
17730,-4,93,89,2,2,94.0,2.0,94.0,2216
17731,4,88,92,2,3,94.0,2.0,94.0,2216
17732,-8,99,91,3,4,94.0,2.0,94.0,2216
17733,0,90,90,3,5,94.0,2.0,94.0,2216
17734,0,92,92,3,6,94.0,2.0,94.0,2216
17735,-16,99,83,3,7,94.0,2.0,94.0,2216
17736,-20,30,10,1,0,94.0,2.0,94.0,2217
17737,9,15,24,1,1,94.0,2.0,94.0,2217
17738,34,60,94,2,2,94.0,2.0,94.0,2217
17739,-5,88,83,2,3,94.0,2.0,94.0,2217
17740,14,68,82,3,4,94.0,2.0,94.0,2217
17741,-20,74,54,3,5,94.0,2.0,94.0,2217
17742,46,39,85,3,6,94.0,2.0,94.0,2217
17743,9,73,82,3,7,94.0,2.0,94.0,2217
17744,100,0,100,1,0,94.0,2.0,94.0,2218
17745,0,100,100,1,1,94.0,2.0,94.0,2218
17746,0,100,100,2,2,94.0,2.0,94.0,2218
17747,0,100,100,2,3,94.0,2.0,94.0,2218
17748,10,90,100,3,4,94.0,2.0,94.0,2218
17749,49,51,100,3,5,94.0,2.0,94.0,2218
17750,50,50,100,3,6,94.0,2.0,94.0,2218
17751,100,0,100,3,7,94.0,2.0,94.0,2218
17752,14,45,59,1,0,94.0,2.0,94.0,2219
17753,43,0,43,1,1,94.0,2.0,94.0,2219
17754,0,100,100,2,2,94.0,2.0,94.0,2219
17755,0,100,100,2,3,94.0,2.0,94.0,2219
17756,20,54,74,3,4,94.0,2.0,94.0,2219
17757,91,0,91,3,5,94.0,2.0,94.0,2219
17758,64,36,100,3,6,94.0,2.0,94.0,2219
17759,18,0,18,3,7,94.0,2.0,94.0,2219
17760,-19,96,77,1,0,94.0,2.0,94.0,2220
17761,5,88,93,1,1,94.0,2.0,94.0,2220
17762,-6,91,85,2,2,94.0,2.0,94.0,2220
17763,-1,94,93,2,3,94.0,2.0,94.0,2220
17764,-12,100,88,3,4,94.0,2.0,94.0,2220
17765,8,87,95,3,5,94.0,2.0,94.0,2220
17766,-10,97,87,3,6,94.0,2.0,94.0,2220
17767,-5,86,81,3,7,94.0,2.0,94.0,2220
17768,24,0,24,1,0,94.0,2.0,94.0,2221
17769,0,0,0,1,1,94.0,2.0,94.0,2221
17770,47,53,100,2,2,94.0,2.0,94.0,2221
17771,0,100,100,2,3,94.0,2.0,94.0,2221
17772,3,53,56,3,4,94.0,2.0,94.0,2221
17773,15,47,62,3,5,94.0,2.0,94.0,2221
17774,54,46,100,3,6,94.0,2.0,94.0,2221
17775,56,0,56,3,7,94.0,2.0,94.0,2221
17776,49,8,57,1,0,94.0,2.0,94.0,2222
17777,6,51,57,1,1,94.0,2.0,94.0,2222
17778,4,88,92,2,2,94.0,2.0,94.0,2222
17779,-2,89,87,2,3,94.0,2.0,94.0,2222
17780,1,90,91,3,4,94.0,2.0,94.0,2222
17781,25,35,60,3,5,94.0,2.0,94.0,2222
17782,-6,59,53,3,6,94.0,2.0,94.0,2222
17783,40,50,90,3,7,94.0,2.0,94.0,2222
17784,62,0,62,1,0,94.0,2.0,94.0,2223
17785,28,0,28,1,1,94.0,2.0,94.0,2223
17786,0,100,100,2,2,94.0,2.0,94.0,2223
17787,65,0,65,2,3,94.0,2.0,94.0,2223
17788,12,88,100,3,4,94.0,2.0,94.0,2223
17789,85,0,85,3,5,94.0,2.0,94.0,2223
17790,43,0,43,3,6,94.0,2.0,94.0,2223
17791,69,0,69,3,7,94.0,2.0,94.0,2223
17792,69,10,79,1,0,94.0,2.0,94.0,2224
17793,71,10,81,1,1,94.0,2.0,94.0,2224
17794,1,90,91,2,2,94.0,2.0,94.0,2224
17795,80,0,80,2,3,94.0,2.0,94.0,2224
17796,-42,61,19,3,4,94.0,2.0,94.0,2224
17797,20,71,91,3,5,94.0,2.0,94.0,2224
17798,3,90,93,3,6,94.0,2.0,94.0,2224
17799,53,18,71,3,7,94.0,2.0,94.0,2224
17800,88,12,100,1,0,94.0,2.0,94.0,2225
17801,-2,88,86,1,1,94.0,2.0,94.0,2225
17802,0,100,100,2,2,94.0,2.0,94.0,2225
17803,0,100,100,2,3,94.0,2.0,94.0,2225
17804,6,85,91,3,4,94.0,2.0,94.0,2225
17805,-50,50,0,3,5,94.0,2.0,94.0,2225
17806,-87,87,0,3,6,94.0,2.0,94.0,2225
17807,-4,4,0,3,7,94.0,2.0,94.0,2225
17808,38,2,40,1,0,95.0,2.0,95.0,2226
17809,42,8,50,1,1,95.0,2.0,95.0,2226
17810,0,50,50,2,2,95.0,2.0,95.0,2226
17811,3,40,43,2,3,95.0,2.0,95.0,2226
17812,-25,89,64,3,4,95.0,2.0,95.0,2226
17813,42,37,79,3,5,95.0,2.0,95.0,2226
17814,16,34,50,3,6,95.0,2.0,95.0,2226
17815,50,18,68,3,7,95.0,2.0,95.0,2226
17816,63,24,87,1,0,95.0,2.0,95.0,2227
17817,12,76,88,1,1,95.0,2.0,95.0,2227
17818,11,76,87,2,2,95.0,2.0,95.0,2227
17819,-7,92,85,2,3,95.0,2.0,95.0,2227
17820,40,50,90,3,4,95.0,2.0,95.0,2227
17821,42,32,74,3,5,95.0,2.0,95.0,2227
17822,4,90,94,3,6,95.0,2.0,95.0,2227
17823,-17,50,33,3,7,95.0,2.0,95.0,2227
17824,0,0,0,1,0,95.0,2.0,95.0,2228
17825,0,0,0,1,1,95.0,2.0,95.0,2228
17826,-90,90,0,2,2,95.0,2.0,95.0,2228
17827,100,0,100,2,3,95.0,2.0,95.0,2228
17828,-5,76,71,3,4,95.0,2.0,95.0,2228
17829,-5,10,5,3,5,95.0,2.0,95.0,2228
17830,0,100,100,3,6,95.0,2.0,95.0,2228
17831,0,0,0,3,7,95.0,2.0,95.0,2228
17832,16,84,100,1,0,95.0,2.0,95.0,2229
17833,77,23,100,1,1,95.0,2.0,95.0,2229
17834,41,45,86,2,2,95.0,2.0,95.0,2229
17835,34,63,97,2,3,95.0,2.0,95.0,2229
17836,8,92,100,3,4,95.0,2.0,95.0,2229
17837,79,21,100,3,5,95.0,2.0,95.0,2229
17838,32,68,100,3,6,95.0,2.0,95.0,2229
17839,-61,70,9,3,7,95.0,2.0,95.0,2229
17840,86,0,86,1,0,95.0,2.0,95.0,2230
17841,14,70,84,1,1,95.0,2.0,95.0,2230
17842,39,50,89,2,2,95.0,2.0,95.0,2230
17843,86,0,86,2,3,95.0,2.0,95.0,2230
17844,70,25,95,3,4,95.0,2.0,95.0,2230
17845,-27,50,23,3,5,95.0,2.0,95.0,2230
17846,-11,100,89,3,6,95.0,2.0,95.0,2230
17847,-27,39,12,3,7,95.0,2.0,95.0,2230
17848,91,0,91,1,0,95.0,2.0,95.0,2231
17849,92,0,92,1,1,95.0,2.0,95.0,2231
17850,17,81,98,2,2,95.0,2.0,95.0,2231
17851,-12,96,84,2,3,95.0,2.0,95.0,2231
17852,6,94,100,3,4,95.0,2.0,95.0,2231
17853,43,50,93,3,5,95.0,2.0,95.0,2231
17854,18,82,100,3,6,95.0,2.0,95.0,2231
17855,82,1,83,3,7,95.0,2.0,95.0,2231
17856,15,10,25,1,0,95.0,2.0,95.0,2232
17857,0,0,0,1,1,95.0,2.0,95.0,2232
17858,15,70,85,2,2,95.0,2.0,95.0,2232
17859,0,100,100,2,3,95.0,2.0,95.0,2232
17860,9,91,100,3,4,95.0,2.0,95.0,2232
17861,95,5,100,3,5,95.0,2.0,95.0,2232
17862,1,99,100,3,6,95.0,2.0,95.0,2232
17863,90,0,90,3,7,95.0,2.0,95.0,2232
17864,0,0,0,1,0,95.0,2.0,95.0,2233
17865,10,0,10,1,1,95.0,2.0,95.0,2233
17866,-5,90,85,2,2,95.0,2.0,95.0,2233
17867,10,50,60,2,3,95.0,2.0,95.0,2233
17868,10,90,100,3,4,95.0,2.0,95.0,2233
17869,-5,75,70,3,5,95.0,2.0,95.0,2233
17870,61,10,71,3,6,95.0,2.0,95.0,2233
17871,15,5,20,3,7,95.0,2.0,95.0,2233
17872,73,27,100,1,0,95.0,2.0,95.0,2234
17873,20,0,20,1,1,95.0,2.0,95.0,2234
17874,65,35,100,2,2,95.0,2.0,95.0,2234
17875,6,94,100,2,3,95.0,2.0,95.0,2234
17876,58,42,100,3,4,95.0,2.0,95.0,2234
17877,66,7,73,3,5,95.0,2.0,95.0,2234
17878,77,23,100,3,6,95.0,2.0,95.0,2234
17879,-4,4,0,3,7,95.0,2.0,95.0,2234
17880,11,67,78,1,0,95.0,2.0,95.0,2235
17881,9,79,88,1,1,95.0,2.0,95.0,2235
17882,-61,100,39,2,2,95.0,2.0,95.0,2235
17883,13,14,27,2,3,95.0,2.0,95.0,2235
17884,-31,61,30,3,4,95.0,2.0,95.0,2235
17885,45,33,78,3,5,95.0,2.0,95.0,2235
17886,-10,100,90,3,6,95.0,2.0,95.0,2235
17887,74,0,74,3,7,95.0,2.0,95.0,2235
17888,100,0,100,1,0,95.0,2.0,95.0,2236
17889,100,0,100,1,1,95.0,2.0,95.0,2236
17890,0,100,100,2,2,95.0,2.0,95.0,2236
17891,23,77,100,2,3,95.0,2.0,95.0,2236
17892,75,25,100,3,4,95.0,2.0,95.0,2236
17893,29,23,52,3,5,95.0,2.0,95.0,2236
17894,8,92,100,3,6,95.0,2.0,95.0,2236
17895,100,0,100,3,7,95.0,2.0,95.0,2236
17896,11,0,11,1,0,95.0,2.0,95.0,2237
17897,6,0,6,1,1,95.0,2.0,95.0,2237
17898,-4,100,96,2,2,95.0,2.0,95.0,2237
17899,5,92,97,2,3,95.0,2.0,95.0,2237
17900,-4,95,91,3,4,95.0,2.0,95.0,2237
17901,8,68,76,3,5,95.0,2.0,95.0,2237
17902,0,100,100,3,6,95.0,2.0,95.0,2237
17903,13,23,36,3,7,95.0,2.0,95.0,2237
17904,3,12,15,1,0,95.0,2.0,95.0,2238
17905,-80,90,10,1,1,95.0,2.0,95.0,2238
17906,0,97,97,2,2,95.0,2.0,95.0,2238
17907,24,6,30,2,3,95.0,2.0,95.0,2238
17908,-3,27,24,3,4,95.0,2.0,95.0,2238
17909,0,50,50,3,5,95.0,2.0,95.0,2238
17910,-3,79,76,3,6,95.0,2.0,95.0,2238
17911,8,2,10,3,7,95.0,2.0,95.0,2238
17912,7,0,7,1,0,95.0,2.0,95.0,2239
17913,5,1,6,1,1,95.0,2.0,95.0,2239
17914,-10,100,90,2,2,95.0,2.0,95.0,2239
17915,0,100,100,2,3,95.0,2.0,95.0,2239
17916,11,53,64,3,4,95.0,2.0,95.0,2239
17917,8,50,58,3,5,95.0,2.0,95.0,2239
17918,16,40,56,3,6,95.0,2.0,95.0,2239
17919,0,50,50,3,7,95.0,2.0,95.0,2239
17920,0,0,0,1,0,96.0,2.0,96.0,2240
17921,16,0,16,1,1,96.0,2.0,96.0,2240
17922,10,90,100,2,2,96.0,2.0,96.0,2240
17923,0,0,0,2,3,96.0,2.0,96.0,2240
17924,10,90,100,3,4,96.0,2.0,96.0,2240
17925,50,50,100,3,5,96.0,2.0,96.0,2240
17926,5,0,5,3,6,96.0,2.0,96.0,2240
17927,23,0,23,3,7,96.0,2.0,96.0,2240
17928,0,2,2,1,0,96.0,2.0,96.0,2241
17929,8,3,11,1,1,96.0,2.0,96.0,2241
17930,35,61,96,2,2,96.0,2.0,96.0,2241
17931,23,3,26,2,3,96.0,2.0,96.0,2241
17932,35,54,89,3,4,96.0,2.0,96.0,2241
17933,46,54,100,3,5,96.0,2.0,96.0,2241
17934,-37,47,10,3,6,96.0,2.0,96.0,2241
17935,-12,52,40,3,7,96.0,2.0,96.0,2241
17936,62,38,100,1,0,96.0,2.0,96.0,2242
17937,-5,47,42,1,1,96.0,2.0,96.0,2242
17938,50,50,100,2,2,96.0,2.0,96.0,2242
17939,35,65,100,2,3,96.0,2.0,96.0,2242
17940,50,50,100,3,4,96.0,2.0,96.0,2242
17941,16,34,50,3,5,96.0,2.0,96.0,2242
17942,50,50,100,3,6,96.0,2.0,96.0,2242
17943,95,0,95,3,7,96.0,2.0,96.0,2242
17944,-6,29,23,1,0,96.0,2.0,96.0,2243
17945,-3,12,9,1,1,96.0,2.0,96.0,2243
17946,-5,100,95,2,2,96.0,2.0,96.0,2243
17947,7,93,100,2,3,96.0,2.0,96.0,2243
17948,1,90,91,3,4,96.0,2.0,96.0,2243
17949,44,31,75,3,5,96.0,2.0,96.0,2243
17950,0,100,100,3,6,96.0,2.0,96.0,2243
17951,61,21,82,3,7,96.0,2.0,96.0,2243
17952,-5,75,70,1,0,96.0,2.0,96.0,2244
17953,23,65,88,1,1,96.0,2.0,96.0,2244
17954,1,87,88,2,2,96.0,2.0,96.0,2244
17955,-3,55,52,2,3,96.0,2.0,96.0,2244
17956,16,77,93,3,4,96.0,2.0,96.0,2244
17957,32,52,84,3,5,96.0,2.0,96.0,2244
17958,15,38,53,3,6,96.0,2.0,96.0,2244
17959,58,15,73,3,7,96.0,2.0,96.0,2244
17960,-8,8,0,1,0,97.0,2.0,97.0,2245
17961,0,100,100,1,1,97.0,2.0,97.0,2245
17962,0,100,100,2,2,97.0,2.0,97.0,2245
17963,0,0,0,2,3,97.0,2.0,97.0,2245
17964,-20,20,0,3,4,97.0,2.0,97.0,2245
17965,16,84,100,3,5,97.0,2.0,97.0,2245
17966,-21,21,0,3,6,97.0,2.0,97.0,2245
17967,0,0,0,3,7,97.0,2.0,97.0,2245
17968,-12,92,80,1,0,97.0,2.0,97.0,2246
17969,0,0,0,1,1,97.0,2.0,97.0,2246
17970,-5,7,2,2,2,97.0,2.0,97.0,2246
17971,-1,1,0,2,3,97.0,2.0,97.0,2246
17972,2,98,100,3,4,97.0,2.0,97.0,2246
17973,7,68,75,3,5,97.0,2.0,97.0,2246
17974,-1,1,0,3,6,97.0,2.0,97.0,2246
17975,-7,9,2,3,7,97.0,2.0,97.0,2246
17976,0,100,100,1,0,98.0,2.0,98.0,2247
17977,0,100,100,1,1,98.0,2.0,98.0,2247
17978,-20,56,36,2,2,98.0,2.0,98.0,2247
17979,0,0,0,2,3,98.0,2.0,98.0,2247
17980,20,44,64,3,4,98.0,2.0,98.0,2247
17981,17,54,71,3,5,98.0,2.0,98.0,2247
17982,22,31,53,3,6,98.0,2.0,98.0,2247
17983,20,25,45,3,7,98.0,2.0,98.0,2247
17984,-19,19,0,1,0,98.0,2.0,98.0,2248
17985,13,37,50,1,1,98.0,2.0,98.0,2248
17986,14,86,100,2,2,98.0,2.0,98.0,2248
17987,-2,100,98,2,3,98.0,2.0,98.0,2248
17988,50,50,100,3,4,98.0,2.0,98.0,2248
17989,69,31,100,3,5,98.0,2.0,98.0,2248
17990,33,67,100,3,6,98.0,2.0,98.0,2248
17991,0,100,100,3,7,98.0,2.0,98.0,2248
17992,50,50,100,1,0,98.0,2.0,98.0,2249
17993,20,77,97,1,1,98.0,2.0,98.0,2249
17994,7,85,92,2,2,98.0,2.0,98.0,2249
17995,79,11,90,2,3,98.0,2.0,98.0,2249
17996,10,90,100,3,4,98.0,2.0,98.0,2249
17997,50,50,100,3,5,98.0,2.0,98.0,2249
17998,0,11,11,3,6,98.0,2.0,98.0,2249
17999,33,64,97,3,7,98.0,2.0,98.0,2249
18000,97,3,100,1,0,98.0,2.0,98.0,2250
18001,95,5,100,1,1,98.0,2.0,98.0,2250
18002,-38,38,0,2,2,98.0,2.0,98.0,2250
18003,9,91,100,2,3,98.0,2.0,98.0,2250
18004,-32,32,0,3,4,98.0,2.0,98.0,2250
18005,-19,19,0,3,5,98.0,2.0,98.0,2250
18006,75,25,100,3,6,98.0,2.0,98.0,2250
18007,68,32,100,3,7,98.0,2.0,98.0,2250
18008,0,100,100,1,0,98.0,2.0,98.0,2251
18009,0,100,100,1,1,98.0,2.0,98.0,2251
18010,-13,100,87,2,2,98.0,2.0,98.0,2251
18011,14,68,82,2,3,98.0,2.0,98.0,2251
18012,4,93,97,3,4,98.0,2.0,98.0,2251
18013,-3,99,96,3,5,98.0,2.0,98.0,2251
18014,-7,100,93,3,6,98.0,2.0,98.0,2251
18015,-7,99,92,3,7,98.0,2.0,98.0,2251
18016,94,6,100,1,0,98.0,2.0,98.0,2252
18017,100,0,100,1,1,98.0,2.0,98.0,2252
18018,0,100,100,2,2,98.0,2.0,98.0,2252
18019,0,100,100,2,3,98.0,2.0,98.0,2252
18020,40,60,100,3,4,98.0,2.0,98.0,2252
18021,50,50,100,3,5,98.0,2.0,98.0,2252
18022,61,39,100,3,6,98.0,2.0,98.0,2252
18023,100,0,100,3,7,98.0,2.0,98.0,2252
18024,10,90,100,1,0,98.0,2.0,98.0,2253
18025,12,86,98,1,1,98.0,2.0,98.0,2253
18026,2,86,88,2,2,98.0,2.0,98.0,2253
18027,-2,95,93,2,3,98.0,2.0,98.0,2253
18028,23,76,99,3,4,98.0,2.0,98.0,2253
18029,1,74,75,3,5,98.0,2.0,98.0,2253
18030,-16,96,80,3,6,98.0,2.0,98.0,2253
18031,-7,96,89,3,7,98.0,2.0,98.0,2253
18032,100,0,100,1,0,99.0,2.0,99.0,2254
18033,88,12,100,1,1,99.0,2.0,99.0,2254
18034,24,76,100,2,2,99.0,2.0,99.0,2254
18035,-10,81,71,2,3,99.0,2.0,99.0,2254
18036,9,91,100,3,4,99.0,2.0,99.0,2254
18037,0,0,0,3,5,99.0,2.0,99.0,2254
18038,65,35,100,3,6,99.0,2.0,99.0,2254
18039,-11,11,0,3,7,99.0,2.0,99.0,2254
18040,45,22,67,1,0,99.0,2.0,99.0,2255
18041,51,25,76,1,1,99.0,2.0,99.0,2255
18042,35,41,76,2,2,99.0,2.0,99.0,2255
18043,11,64,75,2,3,99.0,2.0,99.0,2255
18044,46,30,76,3,4,99.0,2.0,99.0,2255
18045,43,32,75,3,5,99.0,2.0,99.0,2255
18046,42,31,73,3,6,99.0,2.0,99.0,2255
18047,59,23,82,3,7,99.0,2.0,99.0,2255
18048,5,0,5,1,0,99.0,2.0,99.0,2256
18049,0,0,0,1,1,99.0,2.0,99.0,2256
18050,-7,48,41,2,2,99.0,2.0,99.0,2256
18051,-10,10,0,2,3,99.0,2.0,99.0,2256
18052,-4,34,30,3,4,99.0,2.0,99.0,2256
18053,-1,51,50,3,5,99.0,2.0,99.0,2256
18054,-12,48,36,3,6,99.0,2.0,99.0,2256
18055,-12,28,16,3,7,99.0,2.0,99.0,2256
18056,11,0,11,1,0,99.0,2.0,99.0,2257
18057,46,4,50,1,1,99.0,2.0,99.0,2257
18058,0,100,100,2,2,99.0,2.0,99.0,2257
18059,0,100,100,2,3,99.0,2.0,99.0,2257
18060,22,60,82,3,4,99.0,2.0,99.0,2257
18061,23,50,73,3,5,99.0,2.0,99.0,2257
18062,-1,100,99,3,6,99.0,2.0,99.0,2257
18063,16,34,50,3,7,99.0,2.0,99.0,2257
18064,76,22,98,1,0,99.0,2.0,99.0,2258
18065,86,14,100,1,1,99.0,2.0,99.0,2258
18066,-100,100,0,2,2,99.0,2.0,99.0,2258
18067,9,90,99,2,3,99.0,2.0,99.0,2258
18068,68,30,98,3,4,99.0,2.0,99.0,2258
18069,89,10,99,3,5,99.0,2.0,99.0,2258
18070,90,8,98,3,6,99.0,2.0,99.0,2258
18071,-24,24,0,3,7,99.0,2.0,99.0,2258
18072,11,89,100,1,0,99.0,2.0,99.0,2259
18073,-19,19,0,1,1,99.0,2.0,99.0,2259
18074,75,25,100,2,2,99.0,2.0,99.0,2259
18075,-14,83,69,2,3,99.0,2.0,99.0,2259
18076,22,78,100,3,4,99.0,2.0,99.0,2259
18077,0,0,0,3,5,99.0,2.0,99.0,2259
18078,13,87,100,3,6,99.0,2.0,99.0,2259
18079,19,81,100,3,7,99.0,2.0,99.0,2259
18080,95,5,100,1,0,99.0,2.0,99.0,2260
18081,47,15,62,1,1,99.0,2.0,99.0,2260
18082,0,100,100,2,2,99.0,2.0,99.0,2260
18083,70,1,71,2,3,99.0,2.0,99.0,2260
18084,45,54,99,3,4,99.0,2.0,99.0,2260
18085,-16,30,14,3,5,99.0,2.0,99.0,2260
18086,0,100,100,3,6,99.0,2.0,99.0,2260
18087,69,0,69,3,7,99.0,2.0,99.0,2260
18088,82,0,82,1,0,99.0,2.0,99.0,2261
18089,31,51,82,1,1,99.0,2.0,99.0,2261
18090,35,51,86,2,2,99.0,2.0,99.0,2261
18091,19,74,93,2,3,99.0,2.0,99.0,2261
18092,65,23,88,3,4,99.0,2.0,99.0,2261
18093,18,70,88,3,5,99.0,2.0,99.0,2261
18094,33,53,86,3,6,99.0,2.0,99.0,2261
18095,7,13,20,3,7,99.0,2.0,99.0,2261
18096,0,50,50,1,0,99.0,2.0,99.0,2262
18097,1,17,18,1,1,99.0,2.0,99.0,2262
18098,-11,100,89,2,2,99.0,2.0,99.0,2262
18099,10,90,100,2,3,99.0,2.0,99.0,2262
18100,24,61,85,3,4,99.0,2.0,99.0,2262
18101,26,50,76,3,5,99.0,2.0,99.0,2262
18102,35,55,90,3,6,99.0,2.0,99.0,2262
18103,15,7,22,3,7,99.0,2.0,99.0,2262
18104,90,0,90,1,0,99.0,2.0,99.0,2263
18105,4,0,4,1,1,99.0,2.0,99.0,2263
18106,-4,99,95,2,2,99.0,2.0,99.0,2263
18107,7,89,96,2,3,99.0,2.0,99.0,2263
18108,43,49,92,3,4,99.0,2.0,99.0,2263
18109,41,49,90,3,5,99.0,2.0,99.0,2263
18110,38,51,89,3,6,99.0,2.0,99.0,2263
18111,11,1,12,3,7,99.0,2.0,99.0,2263
18112,58,0,58,1,0,100.0,2.0,100.0,2264
18113,70,0,70,1,1,100.0,2.0,100.0,2264
18114,73,0,73,2,2,100.0,2.0,100.0,2264
18115,11,50,61,2,3,100.0,2.0,100.0,2264
18116,1,85,86,3,4,100.0,2.0,100.0,2264
18117,71,0,71,3,5,100.0,2.0,100.0,2264
18118,-2,90,88,3,6,100.0,2.0,100.0,2264
18119,40,0,40,3,7,100.0,2.0,100.0,2264
18120,-44,76,32,1,0,100.0,2.0,100.0,2265
18121,-41,72,31,1,1,100.0,2.0,100.0,2265
18122,37,28,65,2,2,100.0,2.0,100.0,2265
18123,-1,68,67,2,3,100.0,2.0,100.0,2265
18124,5,71,76,3,4,100.0,2.0,100.0,2265
18125,-43,68,25,3,5,100.0,2.0,100.0,2265
18126,-36,68,32,3,6,100.0,2.0,100.0,2265
18127,-41,72,31,3,7,100.0,2.0,100.0,2265
18128,0,0,0,1,0,100.0,2.0,100.0,2266
18129,-69,69,0,1,1,100.0,2.0,100.0,2266
18130,-86,100,14,2,2,100.0,2.0,100.0,2266
18131,-76,100,24,2,3,100.0,2.0,100.0,2266
18132,-23,100,77,3,4,100.0,2.0,100.0,2266
18133,0,23,23,3,5,100.0,2.0,100.0,2266
18134,0,100,100,3,6,100.0,2.0,100.0,2266
18135,13,0,13,3,7,100.0,2.0,100.0,2266
18136,100,0,100,1,0,100.0,2.0,100.0,2267
18137,100,0,100,1,1,100.0,2.0,100.0,2267
18138,0,100,100,2,2,100.0,2.0,100.0,2267
18139,0,100,100,2,3,100.0,2.0,100.0,2267
18140,50,50,100,3,4,100.0,2.0,100.0,2267
18141,50,50,100,3,5,100.0,2.0,100.0,2267
18142,50,50,100,3,6,100.0,2.0,100.0,2267
18143,50,50,100,3,7,100.0,2.0,100.0,2267
18144,56,12,68,1,0,100.0,2.0,100.0,2268
18145,55,27,82,1,1,100.0,2.0,100.0,2268
18146,-15,77,62,2,2,100.0,2.0,100.0,2268
18147,62,2,64,2,3,100.0,2.0,100.0,2268
18148,51,36,87,3,4,100.0,2.0,100.0,2268
18149,51,29,80,3,5,100.0,2.0,100.0,2268
18150,23,50,73,3,6,100.0,2.0,100.0,2268
18151,25,25,50,3,7,100.0,2.0,100.0,2268
18152,57,27,84,1,0,100.0,2.0,100.0,2269
18153,88,12,100,1,1,100.0,2.0,100.0,2269
18154,6,61,67,2,2,100.0,2.0,100.0,2269
18155,87,0,87,2,3,100.0,2.0,100.0,2269
18156,29,37,66,3,4,100.0,2.0,100.0,2269
18157,52,36,88,3,5,100.0,2.0,100.0,2269
18158,100,0,100,3,6,100.0,2.0,100.0,2269
18159,-8,27,19,3,7,100.0,2.0,100.0,2269
18160,0,0,0,1,0,100.0,2.0,100.0,2270
18161,0,0,0,1,1,100.0,2.0,100.0,2270
18162,0,100,100,2,2,100.0,2.0,100.0,2270
18163,0,0,0,2,3,100.0,2.0,100.0,2270
18164,1,90,91,3,4,100.0,2.0,100.0,2270
18165,0,50,50,3,5,100.0,2.0,100.0,2270
18166,-2,50,48,3,6,100.0,2.0,100.0,2270
18167,0,50,50,3,7,100.0,2.0,100.0,2270
18168,13,87,100,1,0,100.0,2.0,100.0,2271
18169,90,0,90,1,1,100.0,2.0,100.0,2271
18170,4,83,87,2,2,100.0,2.0,100.0,2271
18171,42,23,65,2,3,100.0,2.0,100.0,2271
18172,95,0,95,3,4,100.0,2.0,100.0,2271
18173,54,46,100,3,5,100.0,2.0,100.0,2271
18174,86,0,86,3,6,100.0,2.0,100.0,2271
18175,94,0,94,3,7,100.0,2.0,100.0,2271
18176,0,0,0,1,0,100.0,2.0,100.0,2272
18177,0,0,0,1,1,100.0,2.0,100.0,2272
18178,50,50,100,2,2,100.0,2.0,100.0,2272
18179,0,100,100,2,3,100.0,2.0,100.0,2272
18180,0,100,100,3,4,100.0,2.0,100.0,2272
18181,1,49,50,3,5,100.0,2.0,100.0,2272
18182,0,100,100,3,6,100.0,2.0,100.0,2272
18183,0,0,0,3,7,100.0,2.0,100.0,2272
18184,0,100,100,1,0,100.0,2.0,100.0,2273
18185,0,100,100,1,1,100.0,2.0,100.0,2273
18186,-51,51,0,2,2,100.0,2.0,100.0,2273
18187,0,100,100,2,3,100.0,2.0,100.0,2273
18188,23,77,100,3,4,100.0,2.0,100.0,2273
18189,-68,68,0,3,5,100.0,2.0,100.0,2273
18190,14,86,100,3,6,100.0,2.0,100.0,2273
18191,-20,20,0,3,7,100.0,2.0,100.0,2273
18192,2,0,2,1,0,100.0,2.0,100.0,2274
18193,0,100,100,1,1,100.0,2.0,100.0,2274
18194,-11,100,89,2,2,100.0,2.0,100.0,2274
18195,0,100,100,2,3,100.0,2.0,100.0,2274
18196,-21,50,29,3,4,100.0,2.0,100.0,2274
18197,44,19,63,3,5,100.0,2.0,100.0,2274
18198,-8,100,92,3,6,100.0,2.0,100.0,2274
18199,1,1,2,3,7,100.0,2.0,100.0,2274
18200,0,0,0,1,0,100.0,2.0,100.0,2275
18201,0,0,0,1,1,100.0,2.0,100.0,2275
18202,-34,50,16,2,2,100.0,2.0,100.0,2275
18203,-42,42,0,2,3,100.0,2.0,100.0,2275
18204,-28,88,60,3,4,100.0,2.0,100.0,2275
18205,-24,70,46,3,5,100.0,2.0,100.0,2275
18206,-4,50,46,3,6,100.0,2.0,100.0,2275
18207,-25,31,6,3,7,100.0,2.0,100.0,2275
18208,91,9,100,1,0,100.0,2.0,100.0,2276
18209,87,2,89,1,1,100.0,2.0,100.0,2276
18210,88,9,97,2,2,100.0,2.0,100.0,2276
18211,82,12,94,2,3,100.0,2.0,100.0,2276
18212,85,15,100,3,4,100.0,2.0,100.0,2276
18213,84,12,96,3,5,100.0,2.0,100.0,2276
18214,94,4,98,3,6,100.0,2.0,100.0,2276
18215,81,4,85,3,7,100.0,2.0,100.0,2276
18216,0,0,0,1,0,100.0,2.0,100.0,2277
18217,0,100,100,1,1,100.0,2.0,100.0,2277
18218,-51,51,0,2,2,100.0,2.0,100.0,2277
18219,0,0,0,2,3,100.0,2.0,100.0,2277
18220,0,100,100,3,4,100.0,2.0,100.0,2277
18221,0,0,0,3,5,100.0,2.0,100.0,2277
18222,0,100,100,3,6,100.0,2.0,100.0,2277
18223,0,0,0,3,7,100.0,2.0,100.0,2277
18224,75,2,77,1,0,100.0,2.0,100.0,2278
18225,60,10,70,1,1,100.0,2.0,100.0,2278
18226,23,49,72,2,2,100.0,2.0,100.0,2278
18227,9,61,70,2,3,100.0,2.0,100.0,2278
18228,37,52,89,3,4,100.0,2.0,100.0,2278
18229,29,45,74,3,5,100.0,2.0,100.0,2278
18230,47,33,80,3,6,100.0,2.0,100.0,2278
18231,1,43,44,3,7,100.0,2.0,100.0,2278
18232,53,39,92,1,0,100.0,2.0,100.0,2279
18233,-32,41,9,1,1,100.0,2.0,100.0,2279
18234,46,41,87,2,2,100.0,2.0,100.0,2279
18235,49,41,90,2,3,100.0,2.0,100.0,2279
18236,31,38,69,3,4,100.0,2.0,100.0,2279
18237,76,22,98,3,5,100.0,2.0,100.0,2279
18238,14,79,93,3,6,100.0,2.0,100.0,2279
18239,-4,20,16,3,7,100.0,2.0,100.0,2279
18240,0,0,0,1,0,100.0,2.0,100.0,2280
18241,0,100,100,1,1,100.0,2.0,100.0,2280
18242,-44,100,56,2,2,100.0,2.0,100.0,2280
18243,0,0,0,2,3,100.0,2.0,100.0,2280
18244,-1,35,34,3,4,100.0,2.0,100.0,2280
18245,0,0,0,3,5,100.0,2.0,100.0,2280
18246,14,0,14,3,6,100.0,2.0,100.0,2280
18247,-12,12,0,3,7,100.0,2.0,100.0,2280
18248,21,61,82,1,0,100.0,2.0,100.0,2281
18249,1,80,81,1,1,100.0,2.0,100.0,2281
18250,52,31,83,2,2,100.0,2.0,100.0,2281
18251,-25,100,75,2,3,100.0,2.0,100.0,2281
18252,16,84,100,3,4,100.0,2.0,100.0,2281
18253,21,73,94,3,5,100.0,2.0,100.0,2281
18254,2,72,74,3,6,100.0,2.0,100.0,2281
18255,-54,89,35,3,7,100.0,2.0,100.0,2281
18256,98,0,98,1,0,100.0,2.0,100.0,2282
18257,98,0,98,1,1,100.0,2.0,100.0,2282
18258,14,76,90,2,2,100.0,2.0,100.0,2282
18259,7,90,97,2,3,100.0,2.0,100.0,2282
18260,5,95,100,3,4,100.0,2.0,100.0,2282
18261,95,0,95,3,5,100.0,2.0,100.0,2282
18262,2,97,99,3,6,100.0,2.0,100.0,2282
18263,97,0,97,3,7,100.0,2.0,100.0,2282
18264,29,0,29,1,0,100.0,2.0,100.0,2283
18265,52,25,77,1,1,100.0,2.0,100.0,2283
18266,64,14,78,2,2,100.0,2.0,100.0,2283
18267,-75,91,16,2,3,100.0,2.0,100.0,2283
18268,22,62,84,3,4,100.0,2.0,100.0,2283
18269,77,0,77,3,5,100.0,2.0,100.0,2283
18270,56,31,87,3,6,100.0,2.0,100.0,2283
18271,79,0,79,3,7,100.0,2.0,100.0,2283
18272,74,0,74,1,0,100.0,2.0,100.0,2284
18273,-6,6,0,1,1,100.0,2.0,100.0,2284
18274,21,0,21,2,2,100.0,2.0,100.0,2284
18275,-15,82,67,2,3,100.0,2.0,100.0,2284
18276,4,91,95,3,4,100.0,2.0,100.0,2284
18277,0,0,0,3,5,100.0,2.0,100.0,2284
18278,-14,36,22,3,6,100.0,2.0,100.0,2284
18279,71,0,71,3,7,100.0,2.0,100.0,2284
18280,48,50,98,1,0,100.0,2.0,100.0,2285
18281,-9,11,2,1,1,100.0,2.0,100.0,2285
18282,0,50,50,2,2,100.0,2.0,100.0,2285
18283,-50,50,0,2,3,100.0,2.0,100.0,2285
18284,50,50,100,3,4,100.0,2.0,100.0,2285
18285,0,50,50,3,5,100.0,2.0,100.0,2285
18286,0,50,50,3,6,100.0,2.0,100.0,2285
18287,0,1,1,3,7,100.0,2.0,100.0,2285
18288,15,67,82,1,0,100.0,2.0,100.0,2286
18289,4,72,76,1,1,100.0,2.0,100.0,2286
18290,-13,85,72,2,2,100.0,2.0,100.0,2286
18291,8,71,79,2,3,100.0,2.0,100.0,2286
18292,8,66,74,3,4,100.0,2.0,100.0,2286
18293,-51,64,13,3,5,100.0,2.0,100.0,2286
18294,32,37,69,3,6,100.0,2.0,100.0,2286
18295,-9,69,60,3,7,100.0,2.0,100.0,2286
18296,63,12,75,1,0,100.0,2.0,100.0,2287
18297,64,24,88,1,1,100.0,2.0,100.0,2287
18298,39,50,89,2,2,100.0,2.0,100.0,2287
18299,46,5,51,2,3,100.0,2.0,100.0,2287
18300,50,50,100,3,4,100.0,2.0,100.0,2287
18301,74,26,100,3,5,100.0,2.0,100.0,2287
18302,75,25,100,3,6,100.0,2.0,100.0,2287
18303,79,0,79,3,7,100.0,2.0,100.0,2287
18304,-33,100,67,1,0,100.0,2.0,100.0,2288
18305,0,100,100,1,1,100.0,2.0,100.0,2288
18306,0,100,100,2,2,100.0,2.0,100.0,2288
18307,0,100,100,2,3,100.0,2.0,100.0,2288
18308,0,100,100,3,4,100.0,2.0,100.0,2288
18309,0,100,100,3,5,100.0,2.0,100.0,2288
18310,0,100,100,3,6,100.0,2.0,100.0,2288
18311,0,100,100,3,7,100.0,2.0,100.0,2288
18312,0,0,0,1,0,100.0,2.0,100.0,2289
18313,9,76,85,1,1,100.0,2.0,100.0,2289
18314,27,36,63,2,2,100.0,2.0,100.0,2289
18315,0,100,100,2,3,100.0,2.0,100.0,2289
18316,-11,53,42,3,4,100.0,2.0,100.0,2289
18317,5,64,69,3,5,100.0,2.0,100.0,2289
18318,4,53,57,3,6,100.0,2.0,100.0,2289
18319,0,0,0,3,7,100.0,2.0,100.0,2289
18320,35,15,50,1,0,100.0,2.0,100.0,2290
18321,36,39,75,1,1,100.0,2.0,100.0,2290
18322,35,37,72,2,2,100.0,2.0,100.0,2290
18323,18,56,74,2,3,100.0,2.0,100.0,2290
18324,29,59,88,3,4,100.0,2.0,100.0,2290
18325,47,38,85,3,5,100.0,2.0,100.0,2290
18326,56,27,83,3,6,100.0,2.0,100.0,2290
18327,54,7,61,3,7,100.0,2.0,100.0,2290
18328,27,23,50,1,0,100.0,2.0,100.0,2291
18329,30,15,45,1,1,100.0,2.0,100.0,2291
18330,26,46,72,2,2,100.0,2.0,100.0,2291
18331,-3,80,77,2,3,100.0,2.0,100.0,2291
18332,3,47,50,3,4,100.0,2.0,100.0,2291
18333,13,50,63,3,5,100.0,2.0,100.0,2291
18334,19,42,61,3,6,100.0,2.0,100.0,2291
18335,30,25,55,3,7,100.0,2.0,100.0,2291
18336,0,0,0,1,0,100.0,2.0,100.0,2292
18337,-3,3,0,1,1,100.0,2.0,100.0,2292
18338,25,67,92,2,2,100.0,2.0,100.0,2292
18339,14,86,100,2,3,100.0,2.0,100.0,2292
18340,28,40,68,3,4,100.0,2.0,100.0,2292
18341,32,28,60,3,5,100.0,2.0,100.0,2292
18342,51,49,100,3,6,100.0,2.0,100.0,2292
18343,0,50,50,3,7,100.0,2.0,100.0,2292
18344,-1,1,0,1,0,100.0,2.0,100.0,2293
18345,0,0,0,1,1,100.0,2.0,100.0,2293
18346,-100,100,0,2,2,100.0,2.0,100.0,2293
18347,0,100,100,2,3,100.0,2.0,100.0,2293
18348,0,100,100,3,4,100.0,2.0,100.0,2293
18349,0,0,0,3,5,100.0,2.0,100.0,2293
18350,0,0,0,3,6,100.0,2.0,100.0,2293
18351,0,0,0,3,7,100.0,2.0,100.0,2293
18352,39,50,89,1,0,100.0,2.0,100.0,2294
18353,39,38,77,1,1,100.0,2.0,100.0,2294
18354,33,37,70,2,2,100.0,2.0,100.0,2294
18355,13,50,63,2,3,100.0,2.0,100.0,2294
18356,-5,69,64,3,4,100.0,2.0,100.0,2294
18357,66,5,71,3,5,100.0,2.0,100.0,2294
18358,50,50,100,3,6,100.0,2.0,100.0,2294
18359,65,17,82,3,7,100.0,2.0,100.0,2294
18360,0,0,0,1,0,100.0,2.0,100.0,2295
18361,0,0,0,1,1,100.0,2.0,100.0,2295
18362,68,32,100,2,2,100.0,2.0,100.0,2295
18363,0,0,0,2,3,100.0,2.0,100.0,2295
18364,12,88,100,3,4,100.0,2.0,100.0,2295
18365,100,0,100,3,5,100.0,2.0,100.0,2295
18366,0,0,0,3,6,100.0,2.0,100.0,2295
18367,92,8,100,3,7,100.0,2.0,100.0,2295
18368,-3,3,0,1,0,100.0,2.0,100.0,2296
18369,-1,1,0,1,1,100.0,2.0,100.0,2296
18370,10,90,100,2,2,100.0,2.0,100.0,2296
18371,100,0,100,2,3,100.0,2.0,100.0,2296
18372,35,50,85,3,4,100.0,2.0,100.0,2296
18373,1,49,50,3,5,100.0,2.0,100.0,2296
18374,4,96,100,3,6,100.0,2.0,100.0,2296
18375,64,11,75,3,7,100.0,2.0,100.0,2296
18376,-3,10,7,1,0,100.0,2.0,100.0,2297
18377,-6,99,93,1,1,100.0,2.0,100.0,2297
18378,59,22,81,2,2,100.0,2.0,100.0,2297
18379,65,18,83,2,3,100.0,2.0,100.0,2297
18380,-6,35,29,3,4,100.0,2.0,100.0,2297
18381,6,5,11,3,5,100.0,2.0,100.0,2297
18382,-13,20,7,3,6,100.0,2.0,100.0,2297
18383,-1,5,4,3,7,100.0,2.0,100.0,2297
18384,0,0,0,1,0,100.0,2.0,100.0,2298
18385,0,0,0,1,1,100.0,2.0,100.0,2298
18386,47,53,100,2,2,100.0,2.0,100.0,2298
18387,0,100,100,2,3,100.0,2.0,100.0,2298
18388,0,100,100,3,4,100.0,2.0,100.0,2298
18389,0,100,100,3,5,100.0,2.0,100.0,2298
18390,0,100,100,3,6,100.0,2.0,100.0,2298
18391,-4,53,49,3,7,100.0,2.0,100.0,2298
18392,0,0,0,1,0,100.0,2.0,100.0,2299
18393,0,100,100,1,1,100.0,2.0,100.0,2299
18394,1,50,51,2,2,100.0,2.0,100.0,2299
18395,-100,100,0,2,3,100.0,2.0,100.0,2299
18396,100,0,100,3,4,100.0,2.0,100.0,2299
18397,-12,12,0,3,5,100.0,2.0,100.0,2299
18398,0,0,0,3,6,100.0,2.0,100.0,2299
18399,0,0,0,3,7,100.0,2.0,100.0,2299
18400,100,0,100,1,0,100.0,2.0,100.0,2300
18401,100,0,100,1,1,100.0,2.0,100.0,2300
18402,0,100,100,2,2,100.0,2.0,100.0,2300
18403,0,0,0,2,3,100.0,2.0,100.0,2300
18404,50,50,100,3,4,100.0,2.0,100.0,2300
18405,10,90,100,3,5,100.0,2.0,100.0,2300
18406,100,0,100,3,6,100.0,2.0,100.0,2300
18407,100,0,100,3,7,100.0,2.0,100.0,2300
18408,77,23,100,1,0,100.0,2.0,100.0,2301
18409,60,40,100,1,1,100.0,2.0,100.0,2301
18410,52,48,100,2,2,100.0,2.0,100.0,2301
18411,50,50,100,2,3,100.0,2.0,100.0,2301
18412,58,42,100,3,4,100.0,2.0,100.0,2301
18413,55,45,100,3,5,100.0,2.0,100.0,2301
18414,82,18,100,3,6,100.0,2.0,100.0,2301
18415,-17,17,0,3,7,100.0,2.0,100.0,2301
18416,10,8,18,1,0,100.0,2.0,100.0,2302
18417,15,72,87,1,1,100.0,2.0,100.0,2302
18418,61,21,82,2,2,100.0,2.0,100.0,2302
18419,-12,83,71,2,3,100.0,2.0,100.0,2302
18420,-8,100,92,3,4,100.0,2.0,100.0,2302
18421,-2,90,88,3,5,100.0,2.0,100.0,2302
18422,-5,11,6,3,6,100.0,2.0,100.0,2302
18423,-7,16,9,3,7,100.0,2.0,100.0,2302
18424,87,13,100,1,0,100.0,2.0,100.0,2303
18425,99,1,100,1,1,100.0,2.0,100.0,2303
18426,0,100,100,2,2,100.0,2.0,100.0,2303
18427,28,72,100,2,3,100.0,2.0,100.0,2303
18428,27,73,100,3,4,100.0,2.0,100.0,2303
18429,96,4,100,3,5,100.0,2.0,100.0,2303
18430,93,7,100,3,6,100.0,2.0,100.0,2303
18431,98,2,100,3,7,100.0,2.0,100.0,2303
18432,50,0,50,1,0,100.0,2.0,100.0,2304
18433,24,0,24,1,1,100.0,2.0,100.0,2304
18434,41,50,91,2,2,100.0,2.0,100.0,2304
18435,-31,100,69,2,3,100.0,2.0,100.0,2304
18436,49,50,99,3,4,100.0,2.0,100.0,2304
18437,26,24,50,3,5,100.0,2.0,100.0,2304
18438,41,50,91,3,6,100.0,2.0,100.0,2304
18439,39,50,89,3,7,100.0,2.0,100.0,2304
18440,90,0,90,1,0,100.0,2.0,100.0,2305
18441,25,0,25,1,1,100.0,2.0,100.0,2305
18442,-9,80,71,2,2,100.0,2.0,100.0,2305
18443,-78,100,22,2,3,100.0,2.0,100.0,2305
18444,39,58,97,3,4,100.0,2.0,100.0,2305
18445,-3,93,90,3,5,100.0,2.0,100.0,2305
18446,-16,81,65,3,6,100.0,2.0,100.0,2305
18447,15,0,15,3,7,100.0,2.0,100.0,2305
18448,70,0,70,1,0,100.0,2.0,100.0,2306
18449,34,52,86,1,1,100.0,2.0,100.0,2306
18450,-2,100,98,2,2,100.0,2.0,100.0,2306
18451,-84,100,16,2,3,100.0,2.0,100.0,2306
18452,-5,100,95,3,4,100.0,2.0,100.0,2306
18453,91,1,92,3,5,100.0,2.0,100.0,2306
18454,-36,45,9,3,6,100.0,2.0,100.0,2306
18455,40,51,91,3,7,100.0,2.0,100.0,2306
18456,55,0,55,1,0,100.0,2.0,100.0,2307
18457,80,11,91,1,1,100.0,2.0,100.0,2307
18458,25,75,100,2,2,100.0,2.0,100.0,2307
18459,0,100,100,2,3,100.0,2.0,100.0,2307
18460,19,78,97,3,4,100.0,2.0,100.0,2307
18461,100,0,100,3,5,100.0,2.0,100.0,2307
18462,27,2,29,3,6,100.0,2.0,100.0,2307
18463,50,50,100,3,7,100.0,2.0,100.0,2307
18464,0,0,0,1,0,100.0,2.0,100.0,2308
18465,2,25,27,1,1,100.0,2.0,100.0,2308
18466,76,0,76,2,2,100.0,2.0,100.0,2308
18467,-5,100,95,2,3,100.0,2.0,100.0,2308
18468,60,33,93,3,4,100.0,2.0,100.0,2308
18469,64,24,88,3,5,100.0,2.0,100.0,2308
18470,100,0,100,3,6,100.0,2.0,100.0,2308
18471,80,0,80,3,7,100.0,2.0,100.0,2308
18472,50,50,100,1,0,100.0,2.0,100.0,2309
18473,0,100,100,1,1,100.0,2.0,100.0,2309
18474,50,50,100,2,2,100.0,2.0,100.0,2309
18475,50,50,100,2,3,100.0,2.0,100.0,2309
18476,61,39,100,3,4,100.0,2.0,100.0,2309
18477,50,50,100,3,5,100.0,2.0,100.0,2309
18478,0,100,100,3,6,100.0,2.0,100.0,2309
18479,-15,15,0,3,7,100.0,2.0,100.0,2309
18480,0,0,0,1,0,100.0,2.0,100.0,2310
18481,50,50,100,1,1,100.0,2.0,100.0,2310
18482,-69,69,0,2,2,100.0,2.0,100.0,2310
18483,100,0,100,2,3,100.0,2.0,100.0,2310
18484,11,0,11,3,4,100.0,2.0,100.0,2310
18485,-2,2,0,3,5,100.0,2.0,100.0,2310
18486,5,22,27,3,6,100.0,2.0,100.0,2310
18487,-2,4,2,3,7,100.0,2.0,100.0,2310
18488,-1,1,0,1,0,100.0,2.0,100.0,2311
18489,0,0,0,1,1,100.0,2.0,100.0,2311
18490,100,0,100,2,2,100.0,2.0,100.0,2311
18491,0,0,0,2,3,100.0,2.0,100.0,2311
18492,0,100,100,3,4,100.0,2.0,100.0,2311
18493,18,0,18,3,5,100.0,2.0,100.0,2311
18494,0,0,0,3,6,100.0,2.0,100.0,2311
18495,26,1,27,3,7,100.0,2.0,100.0,2311
18496,0,100,100,1,0,100.0,2.0,100.0,2312
18497,0,100,100,1,1,100.0,2.0,100.0,2312
18498,100,0,100,2,2,100.0,2.0,100.0,2312
18499,0,0,0,2,3,100.0,2.0,100.0,2312
18500,0,100,100,3,4,100.0,2.0,100.0,2312
18501,42,58,100,3,5,100.0,2.0,100.0,2312
18502,0,100,100,3,6,100.0,2.0,100.0,2312
18503,0,100,100,3,7,100.0,2.0,100.0,2312
18504,85,0,85,1,0,100.0,2.0,100.0,2313
18505,51,25,76,1,1,100.0,2.0,100.0,2313
18506,-32,100,68,2,2,100.0,2.0,100.0,2313
18507,-50,78,28,2,3,100.0,2.0,100.0,2313
18508,50,25,75,3,4,100.0,2.0,100.0,2313
18509,55,23,78,3,5,100.0,2.0,100.0,2313
18510,38,38,76,3,6,100.0,2.0,100.0,2313
18511,33,38,71,3,7,100.0,2.0,100.0,2313
18512,-50,50,0,1,0,100.0,2.0,100.0,2314
18513,0,0,0,1,1,100.0,2.0,100.0,2314
18514,50,50,100,2,2,100.0,2.0,100.0,2314
18515,50,50,100,2,3,100.0,2.0,100.0,2314
18516,20,80,100,3,4,100.0,2.0,100.0,2314
18517,50,50,100,3,5,100.0,2.0,100.0,2314
18518,5,45,50,3,6,100.0,2.0,100.0,2314
18519,75,25,100,3,7,100.0,2.0,100.0,2314
18520,0,0,0,1,0,100.0,2.0,100.0,2315
18521,0,0,0,1,1,100.0,2.0,100.0,2315
18522,0,100,100,2,2,100.0,2.0,100.0,2315
18523,0,0,0,2,3,100.0,2.0,100.0,2315
18524,3,97,100,3,4,100.0,2.0,100.0,2315
18525,0,50,50,3,5,100.0,2.0,100.0,2315
18526,0,50,50,3,6,100.0,2.0,100.0,2315
18527,22,0,22,3,7,100.0,2.0,100.0,2315
18528,-74,74,0,1,0,100.0,2.0,100.0,2316
18529,0,0,0,1,1,100.0,2.0,100.0,2316
18530,0,100,100,2,2,100.0,2.0,100.0,2316
18531,0,0,0,2,3,100.0,2.0,100.0,2316
18532,19,81,100,3,4,100.0,2.0,100.0,2316
18533,12,50,62,3,5,100.0,2.0,100.0,2316
18534,-2,40,38,3,6,100.0,2.0,100.0,2316
18535,-48,69,21,3,7,100.0,2.0,100.0,2316
18536,0,0,0,1,0,100.0,2.0,100.0,2317
18537,0,0,0,1,1,100.0,2.0,100.0,2317
18538,100,0,100,2,2,100.0,2.0,100.0,2317
18539,0,100,100,2,3,100.0,2.0,100.0,2317
18540,-9,100,91,3,4,100.0,2.0,100.0,2317
18541,100,0,100,3,5,100.0,2.0,100.0,2317
18542,0,0,0,3,6,100.0,2.0,100.0,2317
18543,0,0,0,3,7,100.0,2.0,100.0,2317
18544,99,1,100,1,0,100.0,2.0,100.0,2318
18545,100,0,100,1,1,100.0,2.0,100.0,2318
18546,49,51,100,2,2,100.0,2.0,100.0,2318
18547,0,100,100,2,3,100.0,2.0,100.0,2318
18548,0,100,100,3,4,100.0,2.0,100.0,2318
18549,50,50,100,3,5,100.0,2.0,100.0,2318
18550,0,100,100,3,6,100.0,2.0,100.0,2318
18551,97,3,100,3,7,100.0,2.0,100.0,2318
18552,100,0,100,1,0,100.0,2.0,100.0,2319
18553,76,24,100,1,1,100.0,2.0,100.0,2319
18554,0,100,100,2,2,100.0,2.0,100.0,2319
18555,50,50,100,2,3,100.0,2.0,100.0,2319
18556,21,79,100,3,4,100.0,2.0,100.0,2319
18557,62,38,100,3,5,100.0,2.0,100.0,2319
18558,50,50,100,3,6,100.0,2.0,100.0,2319
18559,0,100,100,3,7,100.0,2.0,100.0,2319
18560,-3,16,13,1,0,100.0,2.0,100.0,2320
18561,-7,10,3,1,1,100.0,2.0,100.0,2320
18562,6,90,96,2,2,100.0,2.0,100.0,2320
18563,0,100,100,2,3,100.0,2.0,100.0,2320
18564,11,70,81,3,4,100.0,2.0,100.0,2320
18565,52,25,77,3,5,100.0,2.0,100.0,2320
18566,10,78,88,3,6,100.0,2.0,100.0,2320
18567,-62,81,19,3,7,100.0,2.0,100.0,2320
18568,0,0,0,1,0,100.0,2.0,100.0,2321
18569,0,0,0,1,1,100.0,2.0,100.0,2321
18570,0,100,100,2,2,100.0,2.0,100.0,2321
18571,0,100,100,2,3,100.0,2.0,100.0,2321
18572,15,50,65,3,4,100.0,2.0,100.0,2321
18573,8,47,55,3,5,100.0,2.0,100.0,2321
18574,0,0,0,3,6,100.0,2.0,100.0,2321
18575,0,0,0,3,7,100.0,2.0,100.0,2321
18576,0,0,0,1,0,100.0,2.0,100.0,2322
18577,100,0,100,1,1,100.0,2.0,100.0,2322
18578,3,0,3,2,2,100.0,2.0,100.0,2322
18579,0,100,100,2,3,100.0,2.0,100.0,2322
18580,0,100,100,3,4,100.0,2.0,100.0,2322
18581,61,39,100,3,5,100.0,2.0,100.0,2322
18582,-100,100,0,3,6,100.0,2.0,100.0,2322
18583,0,0,0,3,7,100.0,2.0,100.0,2322
18584,50,50,100,1,0,100.0,2.0,100.0,2323
18585,100,0,100,1,1,100.0,2.0,100.0,2323
18586,100,0,100,2,2,100.0,2.0,100.0,2323
18587,50,50,100,2,3,100.0,2.0,100.0,2323
18588,50,50,100,3,4,100.0,2.0,100.0,2323
18589,50,50,100,3,5,100.0,2.0,100.0,2323
18590,50,50,100,3,6,100.0,2.0,100.0,2323
18591,100,0,100,3,7,100.0,2.0,100.0,2323
18592,50,50,100,1,0,100.0,2.0,100.0,2324
18593,10,90,100,1,1,100.0,2.0,100.0,2324
18594,62,38,100,2,2,100.0,2.0,100.0,2324
18595,14,62,76,2,3,100.0,2.0,100.0,2324
18596,8,92,100,3,4,100.0,2.0,100.0,2324
18597,23,77,100,3,5,100.0,2.0,100.0,2324
18598,0,100,100,3,6,100.0,2.0,100.0,2324
18599,0,0,0,3,7,100.0,2.0,100.0,2324
18600,16,20,36,1,0,100.0,2.0,100.0,2325
18601,-8,10,2,1,1,100.0,2.0,100.0,2325
18602,-1,81,80,2,2,100.0,2.0,100.0,2325
18603,23,77,100,2,3,100.0,2.0,100.0,2325
18604,68,30,98,3,4,100.0,2.0,100.0,2325
18605,55,40,95,3,5,100.0,2.0,100.0,2325
18606,20,80,100,3,6,100.0,2.0,100.0,2325
18607,23,71,94,3,7,100.0,2.0,100.0,2325
18608,50,50,100,1,0,100.0,2.0,100.0,2326
18609,100,0,100,1,1,100.0,2.0,100.0,2326
18610,50,50,100,2,2,100.0,2.0,100.0,2326
18611,0,100,100,2,3,100.0,2.0,100.0,2326
18612,50,50,100,3,4,100.0,2.0,100.0,2326
18613,50,50,100,3,5,100.0,2.0,100.0,2326
18614,0,100,100,3,6,100.0,2.0,100.0,2326
18615,100,0,100,3,7,100.0,2.0,100.0,2326
18616,13,0,13,1,0,100.0,2.0,100.0,2327
18617,0,0,0,1,1,100.0,2.0,100.0,2327
18618,0,100,100,2,2,100.0,2.0,100.0,2327
18619,0,0,0,2,3,100.0,2.0,100.0,2327
18620,0,100,100,3,4,100.0,2.0,100.0,2327
18621,50,50,100,3,5,100.0,2.0,100.0,2327
18622,12,0,12,3,6,100.0,2.0,100.0,2327
18623,75,0,75,3,7,100.0,2.0,100.0,2327
18624,-4,4,0,1,0,100.0,2.0,100.0,2328
18625,39,11,50,1,1,100.0,2.0,100.0,2328
18626,-7,80,73,2,2,100.0,2.0,100.0,2328
18627,0,100,100,2,3,100.0,2.0,100.0,2328
18628,16,34,50,3,4,100.0,2.0,100.0,2328
18629,0,50,50,3,5,100.0,2.0,100.0,2328
18630,8,92,100,3,6,100.0,2.0,100.0,2328
18631,0,36,36,3,7,100.0,2.0,100.0,2328
18632,0,100,100,1,0,100.0,2.0,100.0,2329
18633,0,100,100,1,1,100.0,2.0,100.0,2329
18634,100,0,100,2,2,100.0,2.0,100.0,2329
18635,0,100,100,2,3,100.0,2.0,100.0,2329
18636,64,36,100,3,4,100.0,2.0,100.0,2329
18637,75,25,100,3,5,100.0,2.0,100.0,2329
18638,78,22,100,3,6,100.0,2.0,100.0,2329
18639,99,0,99,3,7,100.0,2.0,100.0,2329
18640,0,100,100,1,0,100.0,2.0,100.0,2330
18641,-100,100,0,1,1,100.0,2.0,100.0,2330
18642,0,100,100,2,2,100.0,2.0,100.0,2330
18643,0,100,100,2,3,100.0,2.0,100.0,2330
18644,0,100,100,3,4,100.0,2.0,100.0,2330
18645,0,100,100,3,5,100.0,2.0,100.0,2330
18646,0,100,100,3,6,100.0,2.0,100.0,2330
18647,0,100,100,3,7,100.0,2.0,100.0,2330
18648,-3,3,0,1,0,100.0,2.0,100.0,2331
18649,-1,2,1,1,1,100.0,2.0,100.0,2331
18650,-9,37,28,2,2,100.0,2.0,100.0,2331
18651,-3,100,97,2,3,100.0,2.0,100.0,2331
18652,1,22,23,3,4,100.0,2.0,100.0,2331
18653,0,50,50,3,5,100.0,2.0,100.0,2331
18654,4,31,35,3,6,100.0,2.0,100.0,2331
18655,-1,82,81,3,7,100.0,2.0,100.0,2331
18656,-48,50,2,1,0,100.0,2.0,100.0,2332
18657,-7,31,24,1,1,100.0,2.0,100.0,2332
18658,-75,100,25,2,2,100.0,2.0,100.0,2332
18659,-86,99,13,2,3,100.0,2.0,100.0,2332
18660,-64,77,13,3,4,100.0,2.0,100.0,2332
18661,-1,1,0,3,5,100.0,2.0,100.0,2332
18662,100,0,100,3,6,100.0,2.0,100.0,2332
18663,0,0,0,3,7,100.0,2.0,100.0,2332
18664,-1,1,0,1,0,100.0,2.0,100.0,2333
18665,0,0,0,1,1,100.0,2.0,100.0,2333
18666,80,20,100,2,2,100.0,2.0,100.0,2333
18667,-98,98,0,2,3,100.0,2.0,100.0,2333
18668,9,91,100,3,4,100.0,2.0,100.0,2333
18669,53,47,100,3,5,100.0,2.0,100.0,2333
18670,0,100,100,3,6,100.0,2.0,100.0,2333
18671,9,91,100,3,7,100.0,2.0,100.0,2333
18672,0,0,0,1,0,100.0,2.0,100.0,2334
18673,-100,100,0,1,1,100.0,2.0,100.0,2334
18674,0,0,0,2,2,100.0,2.0,100.0,2334
18675,-100,100,0,2,3,100.0,2.0,100.0,2334
18676,50,0,50,3,4,100.0,2.0,100.0,2334
18677,0,100,100,3,5,100.0,2.0,100.0,2334
18678,-50,100,50,3,6,100.0,2.0,100.0,2334
18679,0,0,0,3,7,100.0,2.0,100.0,2334
18680,0,0,0,1,0,100.0,2.0,100.0,2335
18681,0,25,25,1,1,100.0,2.0,100.0,2335
18682,0,50,50,2,2,100.0,2.0,100.0,2335
18683,0,100,100,2,3,100.0,2.0,100.0,2335
18684,4,76,80,3,4,100.0,2.0,100.0,2335
18685,0,0,0,3,5,100.0,2.0,100.0,2335
18686,0,100,100,3,6,100.0,2.0,100.0,2335
18687,0,50,50,3,7,100.0,2.0,100.0,2335
18688,88,12,100,1,0,100.0,2.0,100.0,2336
18689,87,13,100,1,1,100.0,2.0,100.0,2336
18690,-26,50,24,2,2,100.0,2.0,100.0,2336
18691,27,73,100,2,3,100.0,2.0,100.0,2336
18692,50,50,100,3,4,100.0,2.0,100.0,2336
18693,50,50,100,3,5,100.0,2.0,100.0,2336
18694,36,64,100,3,6,100.0,2.0,100.0,2336
18695,50,50,100,3,7,100.0,2.0,100.0,2336
18696,0,0,0,1,0,100.0,2.0,100.0,2337
18697,0,0,0,1,1,100.0,2.0,100.0,2337
18698,0,100,100,2,2,100.0,2.0,100.0,2337
18699,0,100,100,2,3,100.0,2.0,100.0,2337
18700,39,50,89,3,4,100.0,2.0,100.0,2337
18701,24,50,74,3,5,100.0,2.0,100.0,2337
18702,10,90,100,3,6,100.0,2.0,100.0,2337
18703,9,29,38,3,7,100.0,2.0,100.0,2337
18704,0,0,0,1,0,100.0,2.0,100.0,2338
18705,79,0,79,1,1,100.0,2.0,100.0,2338
18706,17,83,100,2,2,100.0,2.0,100.0,2338
18707,-100,100,0,2,3,100.0,2.0,100.0,2338
18708,23,27,50,3,4,100.0,2.0,100.0,2338
18709,22,44,66,3,5,100.0,2.0,100.0,2338
18710,0,100,100,3,6,100.0,2.0,100.0,2338
18711,0,0,0,3,7,100.0,2.0,100.0,2338
18712,-72,72,0,1,0,100.0,2.0,100.0,2339
18713,0,100,100,1,1,100.0,2.0,100.0,2339
18714,0,100,100,2,2,100.0,2.0,100.0,2339
18715,0,0,0,2,3,100.0,2.0,100.0,2339
18716,8,76,84,3,4,100.0,2.0,100.0,2339
18717,28,72,100,3,5,100.0,2.0,100.0,2339
18718,0,100,100,3,6,100.0,2.0,100.0,2339
18719,13,6,19,3,7,100.0,2.0,100.0,2339
18720,83,3,86,1,0,100.0,2.0,100.0,2340
18721,80,0,80,1,1,100.0,2.0,100.0,2340
18722,10,90,100,2,2,100.0,2.0,100.0,2340
18723,0,100,100,2,3,100.0,2.0,100.0,2340
18724,15,85,100,3,4,100.0,2.0,100.0,2340
18725,50,50,100,3,5,100.0,2.0,100.0,2340
18726,37,63,100,3,6,100.0,2.0,100.0,2340
18727,51,36,87,3,7,100.0,2.0,100.0,2340
18728,100,0,100,1,0,100.0,2.0,100.0,2341
18729,1,0,1,1,1,100.0,2.0,100.0,2341
18730,27,50,77,2,2,100.0,2.0,100.0,2341
18731,0,89,89,2,3,100.0,2.0,100.0,2341
18732,26,64,90,3,4,100.0,2.0,100.0,2341
18733,0,50,50,3,5,100.0,2.0,100.0,2341
18734,0,50,50,3,6,100.0,2.0,100.0,2341
18735,50,0,50,3,7,100.0,2.0,100.0,2341
18736,0,0,0,1,0,100.0,2.0,100.0,2342
18737,53,0,53,1,1,100.0,2.0,100.0,2342
18738,0,100,100,2,2,100.0,2.0,100.0,2342
18739,0,100,100,2,3,100.0,2.0,100.0,2342
18740,23,55,78,3,4,100.0,2.0,100.0,2342
18741,35,55,90,3,5,100.0,2.0,100.0,2342
18742,25,75,100,3,6,100.0,2.0,100.0,2342
18743,0,0,0,3,7,100.0,2.0,100.0,2342
18744,0,2,2,1,0,100.0,2.0,100.0,2343
18745,-1,12,11,1,1,100.0,2.0,100.0,2343
18746,11,89,100,2,2,100.0,2.0,100.0,2343
18747,1,1,2,2,3,100.0,2.0,100.0,2343
18748,0,99,99,3,4,100.0,2.0,100.0,2343
18749,40,37,77,3,5,100.0,2.0,100.0,2343
18750,-2,12,10,3,6,100.0,2.0,100.0,2343
18751,-7,10,3,3,7,100.0,2.0,100.0,2343
18752,-1,1,0,1,0,100.0,2.0,100.0,2344
18753,0,1,1,1,1,100.0,2.0,100.0,2344
18754,6,92,98,2,2,100.0,2.0,100.0,2344
18755,1,1,2,2,3,100.0,2.0,100.0,2344
18756,39,25,64,3,4,100.0,2.0,100.0,2344
18757,-4,69,65,3,5,100.0,2.0,100.0,2344
18758,-25,26,1,3,6,100.0,2.0,100.0,2344
18759,-88,89,1,3,7,100.0,2.0,100.0,2344
18760,0,0,0,1,0,100.0,2.0,100.0,2345
18761,-87,87,0,1,1,100.0,2.0,100.0,2345
18762,100,0,100,2,2,100.0,2.0,100.0,2345
18763,0,0,0,2,3,100.0,2.0,100.0,2345
18764,53,47,100,3,4,100.0,2.0,100.0,2345
18765,0,0,0,3,5,100.0,2.0,100.0,2345
18766,0,100,100,3,6,100.0,2.0,100.0,2345
18767,0,0,0,3,7,100.0,2.0,100.0,2345
18768,-1,100,99,1,0,100.0,2.0,100.0,2346
18769,0,100,100,1,1,100.0,2.0,100.0,2346
18770,0,100,100,2,2,100.0,2.0,100.0,2346
18771,0,100,100,2,3,100.0,2.0,100.0,2346
18772,0,100,100,3,4,100.0,2.0,100.0,2346
18773,0,100,100,3,5,100.0,2.0,100.0,2346
18774,2,98,100,3,6,100.0,2.0,100.0,2346
18775,0,100,100,3,7,100.0,2.0,100.0,2346
18776,100,0,100,1,0,100.0,2.0,100.0,2347
18777,90,0,90,1,1,100.0,2.0,100.0,2347
18778,20,80,100,2,2,100.0,2.0,100.0,2347
18779,0,100,100,2,3,100.0,2.0,100.0,2347
18780,75,25,100,3,4,100.0,2.0,100.0,2347
18781,50,50,100,3,5,100.0,2.0,100.0,2347
18782,80,20,100,3,6,100.0,2.0,100.0,2347
18783,100,0,100,3,7,100.0,2.0,100.0,2347
18784,100,0,100,1,0,100.0,2.0,100.0,2348
18785,100,0,100,1,1,100.0,2.0,100.0,2348
18786,-60,60,0,2,2,100.0,2.0,100.0,2348
18787,90,10,100,2,3,100.0,2.0,100.0,2348
18788,25,75,100,3,4,100.0,2.0,100.0,2348
18789,75,25,100,3,5,100.0,2.0,100.0,2348
18790,90,10,100,3,6,100.0,2.0,100.0,2348
18791,90,10,100,3,7,100.0,2.0,100.0,2348
18792,0,0,0,1,0,100.0,2.0,100.0,2349
18793,-9,9,0,1,1,100.0,2.0,100.0,2349
18794,12,88,100,2,2,100.0,2.0,100.0,2349
18795,14,86,100,2,3,100.0,2.0,100.0,2349
18796,5,95,100,3,4,100.0,2.0,100.0,2349
18797,0,50,50,3,5,100.0,2.0,100.0,2349
18798,-50,50,0,3,6,100.0,2.0,100.0,2349
18799,34,54,88,3,7,100.0,2.0,100.0,2349
18800,21,6,27,1,0,100.0,2.0,100.0,2350
18801,34,30,64,1,1,100.0,2.0,100.0,2350
18802,0,100,100,2,2,100.0,2.0,100.0,2350
18803,95,5,100,2,3,100.0,2.0,100.0,2350
18804,22,50,72,3,4,100.0,2.0,100.0,2350
18805,22,51,73,3,5,100.0,2.0,100.0,2350
18806,-22,72,50,3,6,100.0,2.0,100.0,2350
18807,36,23,59,3,7,100.0,2.0,100.0,2350
18808,0,0,0,1,0,100.0,2.0,100.0,2351
18809,6,0,6,1,1,100.0,2.0,100.0,2351
18810,92,0,92,2,2,100.0,2.0,100.0,2351
18811,-100,100,0,2,3,100.0,2.0,100.0,2351
18812,8,83,91,3,4,100.0,2.0,100.0,2351
18813,0,0,0,3,5,100.0,2.0,100.0,2351
18814,39,0,39,3,6,100.0,2.0,100.0,2351
18815,0,0,0,3,7,100.0,2.0,100.0,2351
18816,-1,70,69,1,0,100.0,2.0,100.0,2352
18817,65,4,69,1,1,100.0,2.0,100.0,2352
18818,6,26,32,2,2,100.0,2.0,100.0,2352
18819,11,66,77,2,3,100.0,2.0,100.0,2352
18820,42,38,80,3,4,100.0,2.0,100.0,2352
18821,44,27,71,3,5,100.0,2.0,100.0,2352
18822,39,35,74,3,6,100.0,2.0,100.0,2352
18823,39,26,65,3,7,100.0,2.0,100.0,2352
18824,10,0,10,1,0,100.0,2.0,100.0,2353
18825,0,0,0,1,1,100.0,2.0,100.0,2353
18826,-10,100,90,2,2,100.0,2.0,100.0,2353
18827,-91,91,0,2,3,100.0,2.0,100.0,2353
18828,1,50,51,3,4,100.0,2.0,100.0,2353
18829,41,20,61,3,5,100.0,2.0,100.0,2353
18830,9,91,100,3,6,100.0,2.0,100.0,2353
18831,23,0,23,3,7,100.0,2.0,100.0,2353
18832,100,0,100,1,0,100.0,2.0,100.0,2354
18833,95,0,95,1,1,100.0,2.0,100.0,2354
18834,96,0,96,2,2,100.0,2.0,100.0,2354
18835,10,88,98,2,3,100.0,2.0,100.0,2354
18836,74,26,100,3,4,100.0,2.0,100.0,2354
18837,71,25,96,3,5,100.0,2.0,100.0,2354
18838,0,100,100,3,6,100.0,2.0,100.0,2354
18839,5,0,5,3,7,100.0,2.0,100.0,2354
18840,0,100,100,1,0,100.0,2.0,100.0,2355
18841,-65,81,16,1,1,100.0,2.0,100.0,2355
18842,-78,100,22,2,2,100.0,2.0,100.0,2355
18843,-90,97,7,2,3,100.0,2.0,100.0,2355
18844,-18,18,0,3,4,100.0,2.0,100.0,2355
18845,-42,96,54,3,5,100.0,2.0,100.0,2355
18846,-99,100,1,3,6,100.0,2.0,100.0,2355
18847,76,23,99,3,7,100.0,2.0,100.0,2355
18848,0,100,100,1,0,100.0,2.0,100.0,2356
18849,0,50,50,1,1,100.0,2.0,100.0,2356
18850,0,0,0,2,2,100.0,2.0,100.0,2356
18851,50,50,100,2,3,100.0,2.0,100.0,2356
18852,50,50,100,3,4,100.0,2.0,100.0,2356
18853,0,0,0,3,5,100.0,2.0,100.0,2356
18854,0,100,100,3,6,100.0,2.0,100.0,2356
18855,0,0,0,3,7,100.0,2.0,100.0,2356
18856,-3,54,51,1,0,100.0,2.0,100.0,2357
18857,1,52,53,1,1,100.0,2.0,100.0,2357
18858,-27,78,51,2,2,100.0,2.0,100.0,2357
18859,0,51,51,2,3,100.0,2.0,100.0,2357
18860,-11,12,1,3,4,100.0,2.0,100.0,2357
18861,-4,62,58,3,5,100.0,2.0,100.0,2357
18862,6,0,6,3,6,100.0,2.0,100.0,2357
18863,1,51,52,3,7,100.0,2.0,100.0,2357
18864,33,67,100,1,0,100.0,2.0,100.0,2358
18865,14,86,100,1,1,100.0,2.0,100.0,2358
18866,35,51,86,2,2,100.0,2.0,100.0,2358
18867,32,68,100,2,3,100.0,2.0,100.0,2358
18868,0,75,75,3,4,100.0,2.0,100.0,2358
18869,39,61,100,3,5,100.0,2.0,100.0,2358
18870,71,29,100,3,6,100.0,2.0,100.0,2358
18871,-37,39,2,3,7,100.0,2.0,100.0,2358
18872,0,0,0,1,0,100.0,2.0,100.0,2359
18873,0,0,0,1,1,100.0,2.0,100.0,2359
18874,0,0,0,2,2,100.0,2.0,100.0,2359
18875,0,0,0,2,3,100.0,2.0,100.0,2359
18876,0,0,0,3,4,100.0,2.0,100.0,2359
18877,0,0,0,3,5,100.0,2.0,100.0,2359
18878,0,0,0,3,6,100.0,2.0,100.0,2359
18879,0,0,0,3,7,100.0,2.0,100.0,2359
18880,50,0,50,1,0,100.0,2.0,100.0,2360
18881,0,0,0,1,1,100.0,2.0,100.0,2360
18882,0,100,100,2,2,100.0,2.0,100.0,2360
18883,0,100,100,2,3,100.0,2.0,100.0,2360
18884,0,50,50,3,4,100.0,2.0,100.0,2360
18885,0,50,50,3,5,100.0,2.0,100.0,2360
18886,0,50,50,3,6,100.0,2.0,100.0,2360
18887,0,50,50,3,7,100.0,2.0,100.0,2360
18888,0,26,26,1,0,100.0,2.0,100.0,2361
18889,69,31,100,1,1,100.0,2.0,100.0,2361
18890,0,100,100,2,2,100.0,2.0,100.0,2361
18891,55,44,99,2,3,100.0,2.0,100.0,2361
18892,0,100,100,3,4,100.0,2.0,100.0,2361
18893,69,31,100,3,5,100.0,2.0,100.0,2361
18894,25,75,100,3,6,100.0,2.0,100.0,2361
18895,-3,22,19,3,7,100.0,2.0,100.0,2361
18896,100,0,100,1,0,100.0,2.0,100.0,2362
18897,24,76,100,1,1,100.0,2.0,100.0,2362
18898,4,96,100,2,2,100.0,2.0,100.0,2362
18899,90,0,90,2,3,100.0,2.0,100.0,2362
18900,18,82,100,3,4,100.0,2.0,100.0,2362
18901,50,50,100,3,5,100.0,2.0,100.0,2362
18902,-37,37,0,3,6,100.0,2.0,100.0,2362
18903,65,35,100,3,7,100.0,2.0,100.0,2362
18904,100,0,100,1,0,100.0,2.0,100.0,2363
18905,0,0,0,1,1,100.0,2.0,100.0,2363
18906,0,100,100,2,2,100.0,2.0,100.0,2363
18907,0,100,100,2,3,100.0,2.0,100.0,2363
18908,16,84,100,3,4,100.0,2.0,100.0,2363
18909,50,50,100,3,5,100.0,2.0,100.0,2363
18910,81,19,100,3,6,100.0,2.0,100.0,2363
18911,100,0,100,3,7,100.0,2.0,100.0,2363
18912,-81,100,19,1,0,100.0,2.0,100.0,2364
18913,6,87,93,1,1,100.0,2.0,100.0,2364
18914,16,73,89,2,2,100.0,2.0,100.0,2364
18915,15,85,100,2,3,100.0,2.0,100.0,2364
18916,7,86,93,3,4,100.0,2.0,100.0,2364
18917,0,100,100,3,5,100.0,2.0,100.0,2364
18918,-70,86,16,3,6,100.0,2.0,100.0,2364
18919,2,98,100,3,7,100.0,2.0,100.0,2364
18920,65,13,78,1,0,100.0,2.0,100.0,2365
18921,75,0,75,1,1,100.0,2.0,100.0,2365
18922,24,76,100,2,2,100.0,2.0,100.0,2365
18923,0,100,100,2,3,100.0,2.0,100.0,2365
18924,50,50,100,3,4,100.0,2.0,100.0,2365
18925,76,24,100,3,5,100.0,2.0,100.0,2365
18926,65,35,100,3,6,100.0,2.0,100.0,2365
18927,76,0,76,3,7,100.0,2.0,100.0,2365
18928,70,0,70,1,0,100.0,2.0,100.0,2366
18929,63,0,63,1,1,100.0,2.0,100.0,2366
18930,50,50,100,2,2,100.0,2.0,100.0,2366
18931,50,50,100,2,3,100.0,2.0,100.0,2366
18932,19,80,99,3,4,100.0,2.0,100.0,2366
18933,50,50,100,3,5,100.0,2.0,100.0,2366
18934,49,51,100,3,6,100.0,2.0,100.0,2366
18935,0,0,0,3,7,100.0,2.0,100.0,2366
18936,78,22,100,1,0,100.0,2.0,100.0,2367
18937,-13,13,0,1,1,100.0,2.0,100.0,2367
18938,0,100,100,2,2,100.0,2.0,100.0,2367
18939,50,50,100,2,3,100.0,2.0,100.0,2367
18940,18,82,100,3,4,100.0,2.0,100.0,2367
18941,50,50,100,3,5,100.0,2.0,100.0,2367
18942,72,28,100,3,6,100.0,2.0,100.0,2367
18943,3,0,3,3,7,100.0,2.0,100.0,2367
18944,-50,50,0,1,0,100.0,2.0,100.0,2368
18945,0,0,0,1,1,100.0,2.0,100.0,2368
18946,-29,50,21,2,2,100.0,2.0,100.0,2368
18947,-16,100,84,2,3,100.0,2.0,100.0,2368
18948,61,13,74,3,4,100.0,2.0,100.0,2368
18949,-54,75,21,3,5,100.0,2.0,100.0,2368
18950,24,50,74,3,6,100.0,2.0,100.0,2368
18951,50,0,50,3,7,100.0,2.0,100.0,2368
18952,90,10,100,1,0,100.0,2.0,100.0,2369
18953,17,83,100,1,1,100.0,2.0,100.0,2369
18954,0,100,100,2,2,100.0,2.0,100.0,2369
18955,15,85,100,2,3,100.0,2.0,100.0,2369
18956,35,65,100,3,4,100.0,2.0,100.0,2369
18957,100,0,100,3,5,100.0,2.0,100.0,2369
18958,0,100,100,3,6,100.0,2.0,100.0,2369
18959,86,14,100,3,7,100.0,2.0,100.0,2369
18960,68,0,68,1,0,100.0,2.0,100.0,2370
18961,1,54,55,1,1,100.0,2.0,100.0,2370
18962,-24,92,68,2,2,100.0,2.0,100.0,2370
18963,17,78,95,2,3,100.0,2.0,100.0,2370
18964,48,17,65,3,4,100.0,2.0,100.0,2370
18965,24,46,70,3,5,100.0,2.0,100.0,2370
18966,-11,93,82,3,6,100.0,2.0,100.0,2370
18967,-34,100,66,3,7,100.0,2.0,100.0,2370
18968,0,0,0,1,0,100.0,2.0,100.0,2371
18969,100,0,100,1,1,100.0,2.0,100.0,2371
18970,100,0,100,2,2,100.0,2.0,100.0,2371
18971,0,0,0,2,3,100.0,2.0,100.0,2371
18972,0,100,100,3,4,100.0,2.0,100.0,2371
18973,0,0,0,3,5,100.0,2.0,100.0,2371
18974,0,53,53,3,6,100.0,2.0,100.0,2371
18975,0,0,0,3,7,100.0,2.0,100.0,2371
18976,0,0,0,1,0,100.0,2.0,100.0,2372
18977,0,0,0,1,1,100.0,2.0,100.0,2372
18978,0,100,100,2,2,100.0,2.0,100.0,2372
18979,-1,50,49,2,3,100.0,2.0,100.0,2372
18980,-3,67,64,3,4,100.0,2.0,100.0,2372
18981,0,0,0,3,5,100.0,2.0,100.0,2372
18982,0,24,24,3,6,100.0,2.0,100.0,2372
18983,0,0,0,3,7,100.0,2.0,100.0,2372
18984,0,0,0,1,0,100.0,2.0,100.0,2373
18985,0,0,0,1,1,100.0,2.0,100.0,2373
18986,0,100,100,2,2,100.0,2.0,100.0,2373
18987,0,100,100,2,3,100.0,2.0,100.0,2373
18988,0,100,100,3,4,100.0,2.0,100.0,2373
18989,0,0,0,3,5,100.0,2.0,100.0,2373
18990,0,0,0,3,6,100.0,2.0,100.0,2373
18991,0,0,0,3,7,100.0,2.0,100.0,2373
18992,0,0,0,1,0,100.0,2.0,100.0,2374
18993,-100,100,0,1,1,100.0,2.0,100.0,2374
18994,-17,100,83,2,2,100.0,2.0,100.0,2374
18995,0,100,100,2,3,100.0,2.0,100.0,2374
18996,8,79,87,3,4,100.0,2.0,100.0,2374
18997,13,50,63,3,5,100.0,2.0,100.0,2374
18998,-78,78,0,3,6,100.0,2.0,100.0,2374
18999,14,66,80,3,7,100.0,2.0,100.0,2374
19000,-20,76,56,1,0,100.0,2.0,100.0,2375
19001,27,57,84,1,1,100.0,2.0,100.0,2375
19002,-4,100,96,2,2,100.0,2.0,100.0,2375
19003,17,0,17,2,3,100.0,2.0,100.0,2375
19004,10,51,61,3,4,100.0,2.0,100.0,2375
19005,6,24,30,3,5,100.0,2.0,100.0,2375
19006,13,34,47,3,6,100.0,2.0,100.0,2375
19007,12,5,17,3,7,100.0,2.0,100.0,2375
19008,70,18,88,1,0,100.0,2.0,100.0,2376
19009,4,96,100,1,1,100.0,2.0,100.0,2376
19010,0,100,100,2,2,100.0,2.0,100.0,2376
19011,0,100,100,2,3,100.0,2.0,100.0,2376
19012,0,100,100,3,4,100.0,2.0,100.0,2376
19013,46,54,100,3,5,100.0,2.0,100.0,2376
19014,47,37,84,3,6,100.0,2.0,100.0,2376
19015,6,44,50,3,7,100.0,2.0,100.0,2376
19016,50,50,100,1,0,100.0,2.0,100.0,2377
19017,0,50,50,1,1,100.0,2.0,100.0,2377
19018,0,100,100,2,2,100.0,2.0,100.0,2377
19019,-50,100,50,2,3,100.0,2.0,100.0,2377
19020,-46,96,50,3,4,100.0,2.0,100.0,2377
19021,0,50,50,3,5,100.0,2.0,100.0,2377
19022,50,50,100,3,6,100.0,2.0,100.0,2377
19023,-50,100,50,3,7,100.0,2.0,100.0,2377
19024,0,100,100,1,0,100.0,2.0,100.0,2378
19025,0,0,0,1,1,100.0,2.0,100.0,2378
19026,0,0,0,2,2,100.0,2.0,100.0,2378
19027,0,0,0,2,3,100.0,2.0,100.0,2378
19028,0,0,0,3,4,100.0,2.0,100.0,2378
19029,0,0,0,3,5,100.0,2.0,100.0,2378
19030,0,100,100,3,6,100.0,2.0,100.0,2378
19031,0,0,0,3,7,100.0,2.0,100.0,2378
19032,0,0,0,1,0,100.0,2.0,100.0,2379
19033,0,50,50,1,1,100.0,2.0,100.0,2379
19034,-25,100,75,2,2,100.0,2.0,100.0,2379
19035,0,100,100,2,3,100.0,2.0,100.0,2379
19036,1,62,63,3,4,100.0,2.0,100.0,2379
19037,-9,77,68,3,5,100.0,2.0,100.0,2379
19038,22,36,58,3,6,100.0,2.0,100.0,2379
19039,-10,50,40,3,7,100.0,2.0,100.0,2379
19040,0,0,0,1,0,100.0,2.0,100.0,2380
19041,0,0,0,1,1,100.0,2.0,100.0,2380
19042,0,100,100,2,2,100.0,2.0,100.0,2380
19043,0,100,100,2,3,100.0,2.0,100.0,2380
19044,88,12,100,3,4,100.0,2.0,100.0,2380
19045,79,21,100,3,5,100.0,2.0,100.0,2380
19046,0,100,100,3,6,100.0,2.0,100.0,2380
19047,100,0,100,3,7,100.0,2.0,100.0,2380
19048,-18,18,0,1,0,100.0,2.0,100.0,2381
19049,0,0,0,1,1,100.0,2.0,100.0,2381
19050,0,100,100,2,2,100.0,2.0,100.0,2381
19051,1,99,100,2,3,100.0,2.0,100.0,2381
19052,18,82,100,3,4,100.0,2.0,100.0,2381
19053,-2,100,98,3,5,100.0,2.0,100.0,2381
19054,11,89,100,3,6,100.0,2.0,100.0,2381
19055,-10,10,0,3,7,100.0,2.0,100.0,2381
19056,16,0,16,1,0,100.0,2.0,100.0,2382
19057,17,0,17,1,1,100.0,2.0,100.0,2382
19058,5,91,96,2,2,100.0,2.0,100.0,2382
19059,22,77,99,2,3,100.0,2.0,100.0,2382
19060,7,50,57,3,4,100.0,2.0,100.0,2382
19061,44,17,61,3,5,100.0,2.0,100.0,2382
19062,50,50,100,3,6,100.0,2.0,100.0,2382
19063,36,0,36,3,7,100.0,2.0,100.0,2382
19064,35,15,50,1,0,100.0,2.0,100.0,2383
19065,-24,30,6,1,1,100.0,2.0,100.0,2383
19066,36,50,86,2,2,100.0,2.0,100.0,2383
19067,-50,100,50,2,3,100.0,2.0,100.0,2383
19068,92,0,92,3,4,100.0,2.0,100.0,2383
19069,-82,82,0,3,5,100.0,2.0,100.0,2383
19070,1,0,1,3,6,100.0,2.0,100.0,2383
19071,4,14,18,3,7,100.0,2.0,100.0,2383
19072,-5,5,0,1,0,100.0,2.0,100.0,2384
19073,72,0,72,1,1,100.0,2.0,100.0,2384
19074,0,100,100,2,2,100.0,2.0,100.0,2384
19075,0,100,100,2,3,100.0,2.0,100.0,2384
19076,12,88,100,3,4,100.0,2.0,100.0,2384
19077,10,78,88,3,5,100.0,2.0,100.0,2384
19078,0,100,100,3,6,100.0,2.0,100.0,2384
19079,46,34,80,3,7,100.0,2.0,100.0,2384
19080,31,19,50,1,0,100.0,2.0,100.0,2385
19081,41,0,41,1,1,100.0,2.0,100.0,2385
19082,0,100,100,2,2,100.0,2.0,100.0,2385
19083,1,99,100,2,3,100.0,2.0,100.0,2385
19084,35,42,77,3,4,100.0,2.0,100.0,2385
19085,42,50,92,3,5,100.0,2.0,100.0,2385
19086,0,100,100,3,6,100.0,2.0,100.0,2385
19087,44,11,55,3,7,100.0,2.0,100.0,2385
19088,8,50,58,1,0,100.0,2.0,100.0,2386
19089,0,100,100,1,1,100.0,2.0,100.0,2386
19090,7,93,100,2,2,100.0,2.0,100.0,2386
19091,0,100,100,2,3,100.0,2.0,100.0,2386
19092,11,89,100,3,4,100.0,2.0,100.0,2386
19093,-21,50,29,3,5,100.0,2.0,100.0,2386
19094,0,100,100,3,6,100.0,2.0,100.0,2386
19095,82,6,88,3,7,100.0,2.0,100.0,2386
19096,0,0,0,1,0,100.0,2.0,100.0,2387
19097,0,0,0,1,1,100.0,2.0,100.0,2387
19098,0,100,100,2,2,100.0,2.0,100.0,2387
19099,0,100,100,2,3,100.0,2.0,100.0,2387
19100,0,100,100,3,4,100.0,2.0,100.0,2387
19101,0,0,0,3,5,100.0,2.0,100.0,2387
19102,67,0,67,3,6,100.0,2.0,100.0,2387
19103,0,0,0,3,7,100.0,2.0,100.0,2387
19104,7,7,14,1,0,100.0,2.0,100.0,2388
19105,11,11,22,1,1,100.0,2.0,100.0,2388
19106,0,100,100,2,2,100.0,2.0,100.0,2388
19107,0,100,100,2,3,100.0,2.0,100.0,2388
19108,61,39,100,3,4,100.0,2.0,100.0,2388
19109,60,38,98,3,5,100.0,2.0,100.0,2388
19110,7,77,84,3,6,100.0,2.0,100.0,2388
19111,16,0,16,3,7,100.0,2.0,100.0,2388
19112,100,0,100,1,0,100.0,2.0,100.0,2389
19113,0,100,100,1,1,100.0,2.0,100.0,2389
19114,0,100,100,2,2,100.0,2.0,100.0,2389
19115,0,100,100,2,3,100.0,2.0,100.0,2389
19116,26,74,100,3,4,100.0,2.0,100.0,2389
19117,100,0,100,3,5,100.0,2.0,100.0,2389
19118,0,100,100,3,6,100.0,2.0,100.0,2389
19119,0,0,0,3,7,100.0,2.0,100.0,2389
19120,7,50,57,1,0,100.0,2.0,100.0,2390
19121,-46,55,9,1,1,100.0,2.0,100.0,2390
19122,50,50,100,2,2,100.0,2.0,100.0,2390
19123,61,39,100,2,3,100.0,2.0,100.0,2390
19124,13,75,88,3,4,100.0,2.0,100.0,2390
19125,7,93,100,3,5,100.0,2.0,100.0,2390
19126,0,100,100,3,6,100.0,2.0,100.0,2390
19127,20,4,24,3,7,100.0,2.0,100.0,2390
19128,-50,50,0,1,0,100.0,2.0,100.0,2391
19129,23,77,100,1,1,100.0,2.0,100.0,2391
19130,0,100,100,2,2,100.0,2.0,100.0,2391
19131,0,100,100,2,3,100.0,2.0,100.0,2391
19132,0,100,100,3,4,100.0,2.0,100.0,2391
19133,24,76,100,3,5,100.0,2.0,100.0,2391
19134,88,12,100,3,6,100.0,2.0,100.0,2391
19135,100,0,100,3,7,100.0,2.0,100.0,2391
19136,0,100,100,1,0,100.0,2.0,100.0,2392
19137,0,100,100,1,1,100.0,2.0,100.0,2392
19138,0,100,100,2,2,100.0,2.0,100.0,2392
19139,0,100,100,2,3,100.0,2.0,100.0,2392
19140,0,100,100,3,4,100.0,2.0,100.0,2392
19141,0,100,100,3,5,100.0,2.0,100.0,2392
19142,-100,100,0,3,6,100.0,2.0,100.0,2392
19143,-100,100,0,3,7,100.0,2.0,100.0,2392
19144,91,3,94,1,0,100.0,2.0,100.0,2393
19145,100,0,100,1,1,100.0,2.0,100.0,2393
19146,-44,100,56,2,2,100.0,2.0,100.0,2393
19147,98,2,100,2,3,100.0,2.0,100.0,2393
19148,16,84,100,3,4,100.0,2.0,100.0,2393
19149,79,21,100,3,5,100.0,2.0,100.0,2393
19150,19,80,99,3,6,100.0,2.0,100.0,2393
19151,76,24,100,3,7,100.0,2.0,100.0,2393
19152,22,50,72,1,0,100.0,2.0,100.0,2394
19153,-55,69,14,1,1,100.0,2.0,100.0,2394
19154,9,91,100,2,2,100.0,2.0,100.0,2394
19155,8,85,93,2,3,100.0,2.0,100.0,2394
19156,-1,90,89,3,4,100.0,2.0,100.0,2394
19157,44,50,94,3,5,100.0,2.0,100.0,2394
19158,50,50,100,3,6,100.0,2.0,100.0,2394
19159,90,1,91,3,7,100.0,2.0,100.0,2394
19160,7,17,24,1,0,100.0,2.0,100.0,2395
19161,79,21,100,1,1,100.0,2.0,100.0,2395
19162,-90,100,10,2,2,100.0,2.0,100.0,2395
19163,6,94,100,2,3,100.0,2.0,100.0,2395
19164,20,80,100,3,4,100.0,2.0,100.0,2395
19165,73,27,100,3,5,100.0,2.0,100.0,2395
19166,4,8,12,3,6,100.0,2.0,100.0,2395
19167,32,1,33,3,7,100.0,2.0,100.0,2395
19168,-13,30,17,1,0,100.0,2.0,100.0,2396
19169,-11,85,74,1,1,100.0,2.0,100.0,2396
19170,4,87,91,2,2,100.0,2.0,100.0,2396
19171,14,82,96,2,3,100.0,2.0,100.0,2396
19172,14,79,93,3,4,100.0,2.0,100.0,2396
19173,24,76,100,3,5,100.0,2.0,100.0,2396
19174,17,83,100,3,6,100.0,2.0,100.0,2396
19175,-1,18,17,3,7,100.0,2.0,100.0,2396
19176,0,0,0,1,0,100.0,2.0,100.0,2397
19177,0,0,0,1,1,100.0,2.0,100.0,2397
19178,0,100,100,2,2,100.0,2.0,100.0,2397
19179,0,100,100,2,3,100.0,2.0,100.0,2397
19180,-1,55,54,3,4,100.0,2.0,100.0,2397
19181,17,49,66,3,5,100.0,2.0,100.0,2397
19182,-53,53,0,3,6,100.0,2.0,100.0,2397
19183,-3,3,0,3,7,100.0,2.0,100.0,2397
19184,26,13,39,1,0,100.0,2.0,100.0,2398
19185,54,4,58,1,1,100.0,2.0,100.0,2398
19186,-1,100,99,2,2,100.0,2.0,100.0,2398
19187,1,99,100,2,3,100.0,2.0,100.0,2398
19188,19,57,76,3,4,100.0,2.0,100.0,2398
19189,11,54,65,3,5,100.0,2.0,100.0,2398
19190,27,23,50,3,6,100.0,2.0,100.0,2398
19191,49,26,75,3,7,100.0,2.0,100.0,2398
19192,90,10,100,1,0,100.0,2.0,100.0,2399
19193,26,74,100,1,1,100.0,2.0,100.0,2399
19194,0,100,100,2,2,100.0,2.0,100.0,2399
19195,0,100,100,2,3,100.0,2.0,100.0,2399
19196,0,100,100,3,4,100.0,2.0,100.0,2399
19197,51,49,100,3,5,100.0,2.0,100.0,2399
19198,9,91,100,3,6,100.0,2.0,100.0,2399
19199,80,20,100,3,7,100.0,2.0,100.0,2399
19200,0,0,0,1,0,100.0,2.0,100.0,2400
19201,2,85,87,1,1,100.0,2.0,100.0,2400
19202,0,100,100,2,2,100.0,2.0,100.0,2400
19203,-4,4,0,2,3,100.0,2.0,100.0,2400
19204,-6,86,80,3,4,100.0,2.0,100.0,2400
19205,7,60,67,3,5,100.0,2.0,100.0,2400
19206,-2,70,68,3,6,100.0,2.0,100.0,2400
19207,-7,17,10,3,7,100.0,2.0,100.0,2400
19208,52,12,64,1,0,100.0,2.0,100.0,2401
19209,1,49,50,1,1,100.0,2.0,100.0,2401
19210,3,97,100,2,2,100.0,2.0,100.0,2401
19211,1,98,99,2,3,100.0,2.0,100.0,2401
19212,26,74,100,3,4,100.0,2.0,100.0,2401
19213,37,40,77,3,5,100.0,2.0,100.0,2401
19214,6,94,100,3,6,100.0,2.0,100.0,2401
19215,15,12,27,3,7,100.0,2.0,100.0,2401
19216,66,0,66,1,0,100.0,2.0,100.0,2402
19217,64,0,64,1,1,100.0,2.0,100.0,2402
19218,0,100,100,2,2,100.0,2.0,100.0,2402
19219,0,100,100,2,3,100.0,2.0,100.0,2402
19220,23,77,100,3,4,100.0,2.0,100.0,2402
19221,100,0,100,3,5,100.0,2.0,100.0,2402
19222,-12,25,13,3,6,100.0,2.0,100.0,2402
19223,83,5,88,3,7,100.0,2.0,100.0,2402
19224,0,0,0,1,0,100.0,2.0,100.0,2403
19225,-100,100,0,1,1,100.0,2.0,100.0,2403
19226,1,79,80,2,2,100.0,2.0,100.0,2403
19227,0,100,100,2,3,100.0,2.0,100.0,2403
19228,29,53,82,3,4,100.0,2.0,100.0,2403
19229,25,50,75,3,5,100.0,2.0,100.0,2403
19230,3,97,100,3,6,100.0,2.0,100.0,2403
19231,0,0,0,3,7,100.0,2.0,100.0,2403
19232,50,0,50,1,0,100.0,2.0,100.0,2404
19233,25,75,100,1,1,100.0,2.0,100.0,2404
19234,0,100,100,2,2,100.0,2.0,100.0,2404
19235,0,100,100,2,3,100.0,2.0,100.0,2404
19236,50,50,100,3,4,100.0,2.0,100.0,2404
19237,100,0,100,3,5,100.0,2.0,100.0,2404
19238,100,0,100,3,6,100.0,2.0,100.0,2404
19239,0,0,0,3,7,100.0,2.0,100.0,2404
19240,29,36,65,1,0,100.0,2.0,100.0,2405
19241,-1,75,74,1,1,100.0,2.0,100.0,2405
19242,8,76,84,2,2,100.0,2.0,100.0,2405
19243,-3,76,73,2,3,100.0,2.0,100.0,2405
19244,-3,77,74,3,4,100.0,2.0,100.0,2405
19245,10,50,60,3,5,100.0,2.0,100.0,2405
19246,67,24,91,3,6,100.0,2.0,100.0,2405
19247,31,38,69,3,7,100.0,2.0,100.0,2405
19248,2,20,22,1,0,100.0,2.0,100.0,2406
19249,-92,100,8,1,1,100.0,2.0,100.0,2406
19250,-12,100,88,2,2,100.0,2.0,100.0,2406
19251,-82,100,18,2,3,100.0,2.0,100.0,2406
19252,-7,78,71,3,4,100.0,2.0,100.0,2406
19253,10,15,25,3,5,100.0,2.0,100.0,2406
19254,-17,27,10,3,6,100.0,2.0,100.0,2406
19255,-2,9,7,3,7,100.0,2.0,100.0,2406
19256,-48,90,42,1,0,100.0,2.0,100.0,2407
19257,-2,92,90,1,1,100.0,2.0,100.0,2407
19258,10,74,84,2,2,100.0,2.0,100.0,2407
19259,-30,100,70,2,3,100.0,2.0,100.0,2407
19260,5,91,96,3,4,100.0,2.0,100.0,2407
19261,-2,100,98,3,5,100.0,2.0,100.0,2407
19262,-17,100,83,3,6,100.0,2.0,100.0,2407
19263,66,23,89,3,7,100.0,2.0,100.0,2407
19264,0,50,50,1,0,100.0,2.0,100.0,2408
19265,27,62,89,1,1,100.0,2.0,100.0,2408
19266,51,49,100,2,2,100.0,2.0,100.0,2408
19267,89,0,89,2,3,100.0,2.0,100.0,2408
19268,9,84,93,3,4,100.0,2.0,100.0,2408
19269,1,48,49,3,5,100.0,2.0,100.0,2408
19270,40,49,89,3,6,100.0,2.0,100.0,2408
19271,35,49,84,3,7,100.0,2.0,100.0,2408
19272,24,2,26,1,0,100.0,2.0,100.0,2409
19273,-12,13,1,1,1,100.0,2.0,100.0,2409
19274,17,83,100,2,2,100.0,2.0,100.0,2409
19275,38,12,50,2,3,100.0,2.0,100.0,2409
19276,30,38,68,3,4,100.0,2.0,100.0,2409
19277,11,50,61,3,5,100.0,2.0,100.0,2409
19278,29,50,79,3,6,100.0,2.0,100.0,2409
19279,25,25,50,3,7,100.0,2.0,100.0,2409
19280,-6,100,94,1,0,100.0,2.0,100.0,2410
19281,0,100,100,1,1,100.0,2.0,100.0,2410
19282,0,100,100,2,2,100.0,2.0,100.0,2410
19283,0,0,0,2,3,100.0,2.0,100.0,2410
19284,0,100,100,3,4,100.0,2.0,100.0,2410
19285,-61,100,39,3,5,100.0,2.0,100.0,2410
19286,-55,100,45,3,6,100.0,2.0,100.0,2410
19287,-48,72,24,3,7,100.0,2.0,100.0,2410
19288,-6,74,68,1,0,100.0,2.0,100.0,2411
19289,16,41,57,1,1,100.0,2.0,100.0,2411
19290,0,0,0,2,2,100.0,2.0,100.0,2411
19291,-4,100,96,2,3,100.0,2.0,100.0,2411
19292,-3,82,79,3,4,100.0,2.0,100.0,2411
19293,-2,55,53,3,5,100.0,2.0,100.0,2411
19294,2,56,58,3,6,100.0,2.0,100.0,2411
19295,-30,87,57,3,7,100.0,2.0,100.0,2411
19296,75,0,75,1,0,100.0,2.0,100.0,2412
19297,20,0,20,1,1,100.0,2.0,100.0,2412
19298,-65,100,35,2,2,100.0,2.0,100.0,2412
19299,-1,100,99,2,3,100.0,2.0,100.0,2412
19300,17,68,85,3,4,100.0,2.0,100.0,2412
19301,96,0,96,3,5,100.0,2.0,100.0,2412
19302,0,100,100,3,6,100.0,2.0,100.0,2412
19303,25,0,25,3,7,100.0,2.0,100.0,2412
19304,62,2,64,1,0,100.0,2.0,100.0,2413
19305,0,0,0,1,1,100.0,2.0,100.0,2413
19306,0,100,100,2,2,100.0,2.0,100.0,2413
19307,0,100,100,2,3,100.0,2.0,100.0,2413
19308,46,51,97,3,4,100.0,2.0,100.0,2413
19309,0,0,0,3,5,100.0,2.0,100.0,2413
19310,0,100,100,3,6,100.0,2.0,100.0,2413
19311,100,0,100,3,7,100.0,2.0,100.0,2413
19312,0,100,100,1,0,100.0,2.0,100.0,2414
19313,0,100,100,1,1,100.0,2.0,100.0,2414
19314,0,100,100,2,2,100.0,2.0,100.0,2414
19315,0,100,100,2,3,100.0,2.0,100.0,2414
19316,0,100,100,3,4,100.0,2.0,100.0,2414
19317,0,100,100,3,5,100.0,2.0,100.0,2414
19318,0,100,100,3,6,100.0,2.0,100.0,2414
19319,0,100,100,3,7,100.0,2.0,100.0,2414
19320,0,100,100,1,0,100.0,2.0,100.0,2415
19321,0,100,100,1,1,100.0,2.0,100.0,2415
19322,0,100,100,2,2,100.0,2.0,100.0,2415
19323,0,100,100,2,3,100.0,2.0,100.0,2415
19324,0,100,100,3,4,100.0,2.0,100.0,2415
19325,0,100,100,3,5,100.0,2.0,100.0,2415
19326,0,100,100,3,6,100.0,2.0,100.0,2415
19327,0,100,100,3,7,100.0,2.0,100.0,2415
19328,-11,11,0,1,0,100.0,2.0,100.0,2416
19329,1,0,1,1,1,100.0,2.0,100.0,2416
19330,-13,98,85,2,2,100.0,2.0,100.0,2416
19331,-81,92,11,2,3,100.0,2.0,100.0,2416
19332,-17,24,7,3,4,100.0,2.0,100.0,2416
19333,96,4,100,3,5,100.0,2.0,100.0,2416
19334,0,0,0,3,6,100.0,2.0,100.0,2416
19335,-3,12,9,3,7,100.0,2.0,100.0,2416
19336,54,0,54,1,0,100.0,2.0,100.0,2417
19337,88,0,88,1,1,100.0,2.0,100.0,2417
19338,0,100,100,2,2,100.0,2.0,100.0,2417
19339,0,100,100,2,3,100.0,2.0,100.0,2417
19340,0,50,50,3,4,100.0,2.0,100.0,2417
19341,-20,70,50,3,5,100.0,2.0,100.0,2417
19342,0,100,100,3,6,100.0,2.0,100.0,2417
19343,88,0,88,3,7,100.0,2.0,100.0,2417
19344,100,0,100,1,0,100.0,2.0,100.0,2418
19345,0,0,0,1,1,100.0,2.0,100.0,2418
19346,0,50,50,2,2,100.0,2.0,100.0,2418
19347,0,100,100,2,3,100.0,2.0,100.0,2418
19348,66,34,100,3,4,100.0,2.0,100.0,2418
19349,50,50,100,3,5,100.0,2.0,100.0,2418
19350,100,0,100,3,6,100.0,2.0,100.0,2418
19351,94,4,98,3,7,100.0,2.0,100.0,2418
19352,85,0,85,1,0,100.0,2.0,100.0,2419
19353,66,20,86,1,1,100.0,2.0,100.0,2419
19354,-25,99,74,2,2,100.0,2.0,100.0,2419
19355,-9,98,89,2,3,100.0,2.0,100.0,2419
19356,-1,94,93,3,4,100.0,2.0,100.0,2419
19357,-8,87,79,3,5,100.0,2.0,100.0,2419
19358,2,98,100,3,6,100.0,2.0,100.0,2419
19359,4,87,91,3,7,100.0,2.0,100.0,2419
19360,0,0,0,1,0,100.0,2.0,100.0,2420
19361,0,0,0,1,1,100.0,2.0,100.0,2420
19362,0,100,100,2,2,100.0,2.0,100.0,2420
19363,0,100,100,2,3,100.0,2.0,100.0,2420
19364,0,100,100,3,4,100.0,2.0,100.0,2420
19365,0,100,100,3,5,100.0,2.0,100.0,2420
19366,0,0,0,3,6,100.0,2.0,100.0,2420
19367,0,0,0,3,7,100.0,2.0,100.0,2420
19368,0,0,0,1,0,100.0,2.0,100.0,2421
19369,5,22,27,1,1,100.0,2.0,100.0,2421
19370,0,100,100,2,2,100.0,2.0,100.0,2421
19371,0,100,100,2,3,100.0,2.0,100.0,2421
19372,-3,50,47,3,4,100.0,2.0,100.0,2421
19373,2,50,52,3,5,100.0,2.0,100.0,2421
19374,-1,32,31,3,6,100.0,2.0,100.0,2421
19375,0,28,28,3,7,100.0,2.0,100.0,2421
19376,16,14,30,1,0,100.0,2.0,100.0,2422
19377,-37,71,34,1,1,100.0,2.0,100.0,2422
19378,20,80,100,2,2,100.0,2.0,100.0,2422
19379,2,97,99,2,3,100.0,2.0,100.0,2422
19380,10,62,72,3,4,100.0,2.0,100.0,2422
19381,2,28,30,3,5,100.0,2.0,100.0,2422
19382,8,21,29,3,6,100.0,2.0,100.0,2422
19383,23,12,35,3,7,100.0,2.0,100.0,2422
19384,100,0,100,1,0,100.0,2.0,100.0,2423
19385,3,97,100,1,1,100.0,2.0,100.0,2423
19386,0,100,100,2,2,100.0,2.0,100.0,2423
19387,0,100,100,2,3,100.0,2.0,100.0,2423
19388,5,88,93,3,4,100.0,2.0,100.0,2423
19389,-25,25,0,3,5,100.0,2.0,100.0,2423
19390,0,100,100,3,6,100.0,2.0,100.0,2423
19391,7,0,7,3,7,100.0,2.0,100.0,2423
19392,75,18,93,1,0,100.0,2.0,100.0,2424
19393,99,1,100,1,1,100.0,2.0,100.0,2424
19394,-1,100,99,2,2,100.0,2.0,100.0,2424
19395,1,99,100,2,3,100.0,2.0,100.0,2424
19396,97,2,99,3,4,100.0,2.0,100.0,2424
19397,51,49,100,3,5,100.0,2.0,100.0,2424
19398,88,2,90,3,6,100.0,2.0,100.0,2424
19399,87,13,100,3,7,100.0,2.0,100.0,2424
19400,43,15,58,1,0,100.0,2.0,100.0,2425
19401,-64,82,18,1,1,100.0,2.0,100.0,2425
19402,0,100,100,2,2,100.0,2.0,100.0,2425
19403,0,100,100,2,3,100.0,2.0,100.0,2425
19404,72,28,100,3,4,100.0,2.0,100.0,2425
19405,87,13,100,3,5,100.0,2.0,100.0,2425
19406,14,71,85,3,6,100.0,2.0,100.0,2425
19407,79,21,100,3,7,100.0,2.0,100.0,2425
19408,42,58,100,1,0,100.0,2.0,100.0,2426
19409,1,99,100,1,1,100.0,2.0,100.0,2426
19410,17,83,100,2,2,100.0,2.0,100.0,2426
19411,50,50,100,2,3,100.0,2.0,100.0,2426
19412,47,50,97,3,4,100.0,2.0,100.0,2426
19413,49,50,99,3,5,100.0,2.0,100.0,2426
19414,50,50,100,3,6,100.0,2.0,100.0,2426
19415,9,50,59,3,7,100.0,2.0,100.0,2426
19416,-21,21,0,1,0,100.0,2.0,100.0,2427
19417,12,7,19,1,1,100.0,2.0,100.0,2427
19418,-18,18,0,2,2,100.0,2.0,100.0,2427
19419,-22,22,0,2,3,100.0,2.0,100.0,2427
19420,24,76,100,3,4,100.0,2.0,100.0,2427
19421,54,19,73,3,5,100.0,2.0,100.0,2427
19422,18,82,100,3,6,100.0,2.0,100.0,2427
19423,-23,23,0,3,7,100.0,2.0,100.0,2427
19424,85,0,85,1,0,100.0,2.0,100.0,2428
19425,-11,97,86,1,1,100.0,2.0,100.0,2428
19426,7,91,98,2,2,100.0,2.0,100.0,2428
19427,-3,96,93,2,3,100.0,2.0,100.0,2428
19428,13,73,86,3,4,100.0,2.0,100.0,2428
19429,92,3,95,3,5,100.0,2.0,100.0,2428
19430,5,82,87,3,6,100.0,2.0,100.0,2428
19431,73,14,87,3,7,100.0,2.0,100.0,2428
19432,50,0,50,1,0,100.0,2.0,100.0,2429
19433,-5,100,95,1,1,100.0,2.0,100.0,2429
19434,-3,100,97,2,2,100.0,2.0,100.0,2429
19435,0,100,100,2,3,100.0,2.0,100.0,2429
19436,5,95,100,3,4,100.0,2.0,100.0,2429
19437,-12,89,77,3,5,100.0,2.0,100.0,2429
19438,0,100,100,3,6,100.0,2.0,100.0,2429
19439,25,5,30,3,7,100.0,2.0,100.0,2429
19440,91,9,100,1,0,100.0,2.0,100.0,2430
19441,23,77,100,1,1,100.0,2.0,100.0,2430
19442,3,97,100,2,2,100.0,2.0,100.0,2430
19443,100,0,100,2,3,100.0,2.0,100.0,2430
19444,25,75,100,3,4,100.0,2.0,100.0,2430
19445,86,14,100,3,5,100.0,2.0,100.0,2430
19446,100,0,100,3,6,100.0,2.0,100.0,2430
19447,99,1,100,3,7,100.0,2.0,100.0,2430
19448,16,0,16,1,0,100.0,2.0,100.0,2431
19449,-4,79,75,1,1,100.0,2.0,100.0,2431
19450,0,100,100,2,2,100.0,2.0,100.0,2431
19451,-30,100,70,2,3,100.0,2.0,100.0,2431
19452,12,25,37,3,4,100.0,2.0,100.0,2431
19453,-4,64,60,3,5,100.0,2.0,100.0,2431
19454,0,100,100,3,6,100.0,2.0,100.0,2431
19455,0,0,0,3,7,100.0,2.0,100.0,2431
19456,0,0,0,1,0,100.0,2.0,100.0,2432
19457,0,0,0,1,1,100.0,2.0,100.0,2432
19458,0,100,100,2,2,100.0,2.0,100.0,2432
19459,0,100,100,2,3,100.0,2.0,100.0,2432
19460,22,78,100,3,4,100.0,2.0,100.0,2432
19461,-50,50,0,3,5,100.0,2.0,100.0,2432
19462,0,100,100,3,6,100.0,2.0,100.0,2432
19463,0,0,0,3,7,100.0,2.0,100.0,2432
19464,0,0,0,1,0,100.0,2.0,100.0,2433
19465,0,0,0,1,1,100.0,2.0,100.0,2433
19466,0,100,100,2,2,100.0,2.0,100.0,2433
19467,0,100,100,2,3,100.0,2.0,100.0,2433
19468,0,100,100,3,4,100.0,2.0,100.0,2433
19469,75,25,100,3,5,100.0,2.0,100.0,2433
19470,33,60,93,3,6,100.0,2.0,100.0,2433
19471,-60,73,13,3,7,100.0,2.0,100.0,2433
19472,100,0,100,1,0,100.0,2.0,100.0,2434
19473,100,0,100,1,1,100.0,2.0,100.0,2434
19474,-100,100,0,2,2,100.0,2.0,100.0,2434
19475,25,75,100,2,3,100.0,2.0,100.0,2434
19476,50,50,100,3,4,100.0,2.0,100.0,2434
19477,50,50,100,3,5,100.0,2.0,100.0,2434
19478,5,95,100,3,6,100.0,2.0,100.0,2434
19479,100,0,100,3,7,100.0,2.0,100.0,2434
19480,74,10,84,1,0,100.0,2.0,100.0,2435
19481,65,18,83,1,1,100.0,2.0,100.0,2435
19482,10,82,92,2,2,100.0,2.0,100.0,2435
19483,76,18,94,2,3,100.0,2.0,100.0,2435
19484,8,84,92,3,4,100.0,2.0,100.0,2435
19485,74,26,100,3,5,100.0,2.0,100.0,2435
19486,-25,25,0,3,6,100.0,2.0,100.0,2435
19487,82,12,94,3,7,100.0,2.0,100.0,2435
19488,-3,13,10,1,0,100.0,2.0,100.0,2436
19489,0,13,13,1,1,100.0,2.0,100.0,2436
19490,0,100,100,2,2,100.0,2.0,100.0,2436
19491,0,100,100,2,3,100.0,2.0,100.0,2436
19492,33,17,50,3,4,100.0,2.0,100.0,2436
19493,0,50,50,3,5,100.0,2.0,100.0,2436
19494,-49,49,0,3,6,100.0,2.0,100.0,2436
19495,0,50,50,3,7,100.0,2.0,100.0,2436
19496,8,34,42,1,0,100.0,2.0,100.0,2437
19497,0,0,0,1,1,100.0,2.0,100.0,2437
19498,-50,100,50,2,2,100.0,2.0,100.0,2437
19499,0,0,0,2,3,100.0,2.0,100.0,2437
19500,9,89,98,3,4,100.0,2.0,100.0,2437
19501,0,0,0,3,5,100.0,2.0,100.0,2437
19502,0,100,100,3,6,100.0,2.0,100.0,2437
19503,25,25,50,3,7,100.0,2.0,100.0,2437
19504,-61,72,11,1,0,100.0,2.0,100.0,2438
19505,-13,22,9,1,1,100.0,2.0,100.0,2438
19506,0,100,100,2,2,100.0,2.0,100.0,2438
19507,-14,17,3,2,3,100.0,2.0,100.0,2438
19508,-19,28,9,3,4,100.0,2.0,100.0,2438
19509,-13,13,0,3,5,100.0,2.0,100.0,2438
19510,25,75,100,3,6,100.0,2.0,100.0,2438
19511,-11,17,6,3,7,100.0,2.0,100.0,2438
19512,19,81,100,1,0,100.0,2.0,100.0,2439
19513,11,89,100,1,1,100.0,2.0,100.0,2439
19514,-97,97,0,2,2,100.0,2.0,100.0,2439
19515,0,100,100,2,3,100.0,2.0,100.0,2439
19516,44,56,100,3,4,100.0,2.0,100.0,2439
19517,43,57,100,3,5,100.0,2.0,100.0,2439
19518,-69,69,0,3,6,100.0,2.0,100.0,2439
19519,-9,9,0,3,7,100.0,2.0,100.0,2439
19520,50,20,70,1,0,100.0,2.0,100.0,2440
19521,37,63,100,1,1,100.0,2.0,100.0,2440
19522,-9,80,71,2,2,100.0,2.0,100.0,2440
19523,13,87,100,2,3,100.0,2.0,100.0,2440
19524,10,90,100,3,4,100.0,2.0,100.0,2440
19525,70,30,100,3,5,100.0,2.0,100.0,2440
19526,67,33,100,3,6,100.0,2.0,100.0,2440
19527,16,10,26,3,7,100.0,2.0,100.0,2440
19528,-25,30,5,1,0,100.0,2.0,100.0,2441
19529,-100,100,0,1,1,100.0,2.0,100.0,2441
19530,50,0,50,2,2,100.0,2.0,100.0,2441
19531,43,57,100,2,3,100.0,2.0,100.0,2441
19532,-98,100,2,3,4,100.0,2.0,100.0,2441
19533,0,0,0,3,5,100.0,2.0,100.0,2441
19534,0,100,100,3,6,100.0,2.0,100.0,2441
19535,0,100,100,3,7,100.0,2.0,100.0,2441
19536,-4,100,96,1,0,100.0,2.0,100.0,2442
19537,0,100,100,1,1,100.0,2.0,100.0,2442
19538,0,100,100,2,2,100.0,2.0,100.0,2442
19539,-68,100,32,2,3,100.0,2.0,100.0,2442
19540,0,100,100,3,4,100.0,2.0,100.0,2442
19541,-71,100,29,3,5,100.0,2.0,100.0,2442
19542,0,100,100,3,6,100.0,2.0,100.0,2442
19543,75,25,100,3,7,100.0,2.0,100.0,2442
19544,74,26,100,1,0,100.0,2.0,100.0,2443
19545,50,50,100,1,1,100.0,2.0,100.0,2443
19546,0,100,100,2,2,100.0,2.0,100.0,2443
19547,83,17,100,2,3,100.0,2.0,100.0,2443
19548,22,78,100,3,4,100.0,2.0,100.0,2443
19549,50,50,100,3,5,100.0,2.0,100.0,2443
19550,34,50,84,3,6,100.0,2.0,100.0,2443
19551,79,21,100,3,7,100.0,2.0,100.0,2443
19552,33,17,50,1,0,100.0,2.0,100.0,2444
19553,50,50,100,1,1,100.0,2.0,100.0,2444
19554,29,71,100,2,2,100.0,2.0,100.0,2444
19555,51,36,87,2,3,100.0,2.0,100.0,2444
19556,79,19,98,3,4,100.0,2.0,100.0,2444
19557,2,84,86,3,5,100.0,2.0,100.0,2444
19558,81,17,98,3,6,100.0,2.0,100.0,2444
19559,79,21,100,3,7,100.0,2.0,100.0,2444
19560,-2,2,0,1,0,100.0,2.0,100.0,2445
19561,0,0,0,1,1,100.0,2.0,100.0,2445
19562,0,100,100,2,2,100.0,2.0,100.0,2445
19563,0,100,100,2,3,100.0,2.0,100.0,2445
19564,-50,50,0,3,4,100.0,2.0,100.0,2445
19565,2,0,2,3,5,100.0,2.0,100.0,2445
19566,99,0,99,3,6,100.0,2.0,100.0,2445
19567,4,0,4,3,7,100.0,2.0,100.0,2445
19568,0,0,0,1,0,100.0,2.0,100.0,2446
19569,0,0,0,1,1,100.0,2.0,100.0,2446
19570,0,100,100,2,2,100.0,2.0,100.0,2446
19571,100,0,100,2,3,100.0,2.0,100.0,2446
19572,0,100,100,3,4,100.0,2.0,100.0,2446
19573,50,50,100,3,5,100.0,2.0,100.0,2446
19574,100,0,100,3,6,100.0,2.0,100.0,2446
19575,68,32,100,3,7,100.0,2.0,100.0,2446
19576,0,0,0,1,0,100.0,2.0,100.0,2447
19577,0,0,0,1,1,100.0,2.0,100.0,2447
19578,0,100,100,2,2,100.0,2.0,100.0,2447
19579,0,100,100,2,3,100.0,2.0,100.0,2447
19580,72,28,100,3,4,100.0,2.0,100.0,2447
19581,0,0,0,3,5,100.0,2.0,100.0,2447
19582,0,0,0,3,6,100.0,2.0,100.0,2447
19583,1,0,1,3,7,100.0,2.0,100.0,2447
19584,0,100,100,1,0,100.0,2.0,100.0,2448
19585,0,100,100,1,1,100.0,2.0,100.0,2448
19586,100,0,100,2,2,100.0,2.0,100.0,2448
19587,0,100,100,2,3,100.0,2.0,100.0,2448
19588,0,100,100,3,4,100.0,2.0,100.0,2448
19589,0,100,100,3,5,100.0,2.0,100.0,2448
19590,100,0,100,3,6,100.0,2.0,100.0,2448
19591,0,0,0,3,7,100.0,2.0,100.0,2448
19592,43,16,59,1,0,100.0,2.0,100.0,2449
19593,61,9,70,1,1,100.0,2.0,100.0,2449
19594,78,0,78,2,2,100.0,2.0,100.0,2449
19595,83,17,100,2,3,100.0,2.0,100.0,2449
19596,38,37,75,3,4,100.0,2.0,100.0,2449
19597,74,22,96,3,5,100.0,2.0,100.0,2449
19598,-42,50,8,3,6,100.0,2.0,100.0,2449
19599,77,0,77,3,7,100.0,2.0,100.0,2449
19600,0,0,0,1,0,100.0,2.0,100.0,2450
19601,100,0,100,1,1,100.0,2.0,100.0,2450
19602,0,100,100,2,2,100.0,2.0,100.0,2450
19603,24,76,100,2,3,100.0,2.0,100.0,2450
19604,0,100,100,3,4,100.0,2.0,100.0,2450
19605,100,0,100,3,5,100.0,2.0,100.0,2450
19606,0,100,100,3,6,100.0,2.0,100.0,2450
19607,100,0,100,3,7,100.0,2.0,100.0,2450
19608,77,0,77,1,0,100.0,2.0,100.0,2451
19609,-1,1,0,1,1,100.0,2.0,100.0,2451
19610,-1,99,98,2,2,100.0,2.0,100.0,2451
19611,1,99,100,2,3,100.0,2.0,100.0,2451
19612,9,90,99,3,4,100.0,2.0,100.0,2451
19613,45,55,100,3,5,100.0,2.0,100.0,2451
19614,10,90,100,3,6,100.0,2.0,100.0,2451
19615,40,60,100,3,7,100.0,2.0,100.0,2451
19616,18,17,35,1,0,100.0,2.0,100.0,2452
19617,3,63,66,1,1,100.0,2.0,100.0,2452
19618,18,15,33,2,2,100.0,2.0,100.0,2452
19619,0,0,0,2,3,100.0,2.0,100.0,2452
19620,15,37,52,3,4,100.0,2.0,100.0,2452
19621,45,13,58,3,5,100.0,2.0,100.0,2452
19622,7,93,100,3,6,100.0,2.0,100.0,2452
19623,20,12,32,3,7,100.0,2.0,100.0,2452
19624,100,0,100,1,0,100.0,2.0,100.0,2453
19625,100,0,100,1,1,100.0,2.0,100.0,2453
19626,25,75,100,2,2,100.0,2.0,100.0,2453
19627,0,100,100,2,3,100.0,2.0,100.0,2453
19628,50,50,100,3,4,100.0,2.0,100.0,2453
19629,50,50,100,3,5,100.0,2.0,100.0,2453
19630,-100,100,0,3,6,100.0,2.0,100.0,2453
19631,100,0,100,3,7,100.0,2.0,100.0,2453
19632,-1,1,0,1,0,100.0,2.0,100.0,2454
19633,0,0,0,1,1,100.0,2.0,100.0,2454
19634,0,100,100,2,2,100.0,2.0,100.0,2454
19635,0,100,100,2,3,100.0,2.0,100.0,2454
19636,7,93,100,3,4,100.0,2.0,100.0,2454
19637,0,0,0,3,5,100.0,2.0,100.0,2454
19638,100,0,100,3,6,100.0,2.0,100.0,2454
19639,0,0,0,3,7,100.0,2.0,100.0,2454
19640,0,0,0,1,0,100.0,2.0,100.0,2455
19641,-100,100,0,1,1,100.0,2.0,100.0,2455
19642,0,100,100,2,2,100.0,2.0,100.0,2455
19643,0,100,100,2,3,100.0,2.0,100.0,2455
19644,37,63,100,3,4,100.0,2.0,100.0,2455
19645,45,55,100,3,5,100.0,2.0,100.0,2455
19646,61,27,88,3,6,100.0,2.0,100.0,2455
19647,88,0,88,3,7,100.0,2.0,100.0,2455
19648,-2,39,37,1,0,100.0,2.0,100.0,2456
19649,19,81,100,1,1,100.0,2.0,100.0,2456
19650,-34,100,66,2,2,100.0,2.0,100.0,2456
19651,1,1,2,2,3,100.0,2.0,100.0,2456
19652,2,31,33,3,4,100.0,2.0,100.0,2456
19653,11,89,100,3,5,100.0,2.0,100.0,2456
19654,-7,46,39,3,6,100.0,2.0,100.0,2456
19655,15,26,41,3,7,100.0,2.0,100.0,2456
19656,0,0,0,1,0,100.0,2.0,100.0,2457
19657,0,0,0,1,1,100.0,2.0,100.0,2457
19658,0,100,100,2,2,100.0,2.0,100.0,2457
19659,0,100,100,2,3,100.0,2.0,100.0,2457
19660,0,100,100,3,4,100.0,2.0,100.0,2457
19661,0,50,50,3,5,100.0,2.0,100.0,2457
19662,0,50,50,3,6,100.0,2.0,100.0,2457
19663,0,0,0,3,7,100.0,2.0,100.0,2457
19664,0,0,0,1,0,100.0,2.0,100.0,2458
19665,0,0,0,1,1,100.0,2.0,100.0,2458
19666,0,0,0,2,2,100.0,2.0,100.0,2458
19667,35,65,100,2,3,100.0,2.0,100.0,2458
19668,-64,64,0,3,4,100.0,2.0,100.0,2458
19669,-58,58,0,3,5,100.0,2.0,100.0,2458
19670,100,0,100,3,6,100.0,2.0,100.0,2458
19671,100,0,100,3,7,100.0,2.0,100.0,2458
19672,-20,58,38,1,0,100.0,2.0,100.0,2459
19673,41,30,71,1,1,100.0,2.0,100.0,2459
19674,2,26,28,2,2,100.0,2.0,100.0,2459
19675,-31,65,34,2,3,100.0,2.0,100.0,2459
19676,-1,78,77,3,4,100.0,2.0,100.0,2459
19677,-2,29,27,3,5,100.0,2.0,100.0,2459
19678,-5,26,21,3,6,100.0,2.0,100.0,2459
19679,0,0,0,3,7,100.0,2.0,100.0,2459
